PokerStars Hand #157570955733: Tournament #1641817020, $7.50+$7.50+$1.50 USD Hold'em No Limit - Level XLIX (35000/70000) - 2016/08/21 17:00:44 ET
Table '1641817020 92' 9-max Seat #1 is the button
Seat 1: madtimm (804713 in chips) 
Seat 2: zugmoraes (3362321 in chips) 
Seat 3: Hulkyyyy (971969 in chips) 
Seat 4: hawkx1984 (1141326 in chips) 
Seat 5: Wealthiest1 (1998814 in chips) 
Seat 6: xeD_ox_es (1866412 in chips) 
Seat 7: reijomo (3835006 in chips) 
Seat 9: jareth3542 (4519439 in chips) 
madtimm: posts the ante 11000
zugmoraes: posts the ante 11000
Hulkyyyy: posts the ante 11000
hawkx1984: posts the ante 11000
Wealthiest1: posts the ante 11000
xeD_ox_es: posts the ante 11000
reijomo: posts the ante 11000
jareth3542: posts the ante 11000
zugmoraes: posts small blind 35000
Hulkyyyy: posts big blind 70000
*** HOLE CARDS ***
hawkx1984: raises 84000 to 154000
Wealthiest1: folds 
xeD_ox_es: folds 
reijomo: folds 
jareth3542: folds 
madtimm: folds 
zugmoraes: folds 
Hulkyyyy: folds 
Uncalled bet (84000) returned to hawkx1984
hawkx1984 collected 263000 from pot
hawkx1984: doesn't show hand 
*** SUMMARY ***
Total pot 263000 | Rake 0 
Seat 1: madtimm (button) folded before Flop (didn't bet)
Seat 2: zugmoraes (small blind) folded before Flop
Seat 3: Hulkyyyy (big blind) folded before Flop
Seat 4: hawkx1984 collected (263000)
Seat 5: Wealthiest1 folded before Flop (didn't bet)
Seat 6: xeD_ox_es folded before Flop (didn't bet)
Seat 7: reijomo folded before Flop (didn't bet)
Seat 9: jareth3542 folded before Flop (didn't bet)



PokerStars Hand #157570992855: Tournament #1641817020, $7.50+$7.50+$1.50 USD Hold'em No Limit - Level XLIX (35000/70000) - 2016/08/21 17:01:36 ET
Table '1641817020 92' 9-max Seat #2 is the button
Seat 1: madtimm (793713 in chips) 
Seat 2: zugmoraes (3316321 in chips) 
Seat 3: Hulkyyyy (890969 in chips) 
Seat 4: hawkx1984 (1323326 in chips) 
Seat 5: Wealthiest1 (1987814 in chips) 
Seat 6: xeD_ox_es (1855412 in chips) 
Seat 7: reijomo (3824006 in chips) 
Seat 9: jareth3542 (4508439 in chips) 
madtimm: posts the ante 11000
zugmoraes: posts the ante 11000
Hulkyyyy: posts the ante 11000
hawkx1984: posts the ante 11000
Wealthiest1: posts the ante 11000
xeD_ox_es: posts the ante 11000
reijomo: posts the ante 11000
jareth3542: posts the ante 11000
Hulkyyyy: posts small blind 35000
hawkx1984: posts big blind 70000
*** HOLE CARDS ***
Wealthiest1: folds 
xeD_ox_es: folds 
reijomo: folds 
jareth3542: raises 70000 to 140000
madtimm: folds 
zugmoraes: folds 
Hulkyyyy: folds 
hawkx1984: folds 
Uncalled bet (70000) returned to jareth3542
jareth3542 collected 263000 from pot
*** SUMMARY ***
Total pot 263000 | Rake 0 
Seat 1: madtimm folded before Flop (didn't bet)
Seat 2: zugmoraes (button) folded before Flop (didn't bet)
Seat 3: Hulkyyyy (small blind) folded before Flop
Seat 4: hawkx1984 (big blind) folded before Flop
Seat 5: Wealthiest1 folded before Flop (didn't bet)
Seat 6: xeD_ox_es folded before Flop (didn't bet)
Seat 7: reijomo folded before Flop (didn't bet)
Seat 9: jareth3542 collected (263000)



PokerStars Hand #157571017877: Tournament #1641817020, $7.50+$7.50+$1.50 USD Hold'em No Limit - Level L (40000/80000) - 2016/08/21 17:02:09 ET
Table '1641817020 92' 9-max Seat #3 is the button
Seat 1: madtimm (782713 in chips) 
Seat 2: zugmoraes (3305321 in chips) 
Seat 3: Hulkyyyy (844969 in chips) 
Seat 4: hawkx1984 (1242326 in chips) 
Seat 5: Wealthiest1 (1976814 in chips) 
Seat 6: xeD_ox_es (1844412 in chips) 
Seat 7: reijomo (3813006 in chips) 
Seat 9: jareth3542 (4690439 in chips) 
madtimm: posts the ante 12000
zugmoraes: posts the ante 12000
Hulkyyyy: posts the ante 12000
hawkx1984: posts the ante 12000
Wealthiest1: posts the ante 12000
xeD_ox_es: posts the ante 12000
reijomo: posts the ante 12000
jareth3542: posts the ante 12000
hawkx1984: posts small blind 40000
Wealthiest1: posts big blind 80000
*** HOLE CARDS ***
xeD_ox_es: folds 
reijomo: folds 
jareth3542: raises 80000 to 160000
madtimm: folds 
zugmoraes: calls 160000
Hulkyyyy: folds 
hawkx1984: folds 
Wealthiest1: calls 80000
*** FLOP *** [3h 5c 6s]
Wealthiest1: checks 
jareth3542: checks 
zugmoraes: bets 264880
Wealthiest1: folds 
jareth3542: folds 
Uncalled bet (264880) returned to zugmoraes
zugmoraes collected 616000 from pot
zugmoraes: doesn't show hand 
*** SUMMARY ***
Total pot 616000 | Rake 0 
Board [3h 5c 6s]
Seat 1: madtimm folded before Flop (didn't bet)
Seat 2: zugmoraes collected (616000)
Seat 3: Hulkyyyy (button) folded before Flop (didn't bet)
Seat 4: hawkx1984 (small blind) folded before Flop
Seat 5: Wealthiest1 (big blind) folded on the Flop
Seat 6: xeD_ox_es folded before Flop (didn't bet)
Seat 7: reijomo folded before Flop (didn't bet)
Seat 9: jareth3542 folded on the Flop



PokerStars Hand #157571053640: Tournament #1641817020, $7.50+$7.50+$1.50 USD Hold'em No Limit - Level L (40000/80000) - 2016/08/21 17:02:53 ET
Table '1641817020 92' 9-max Seat #4 is the button
Seat 1: madtimm (770713 in chips) 
Seat 2: zugmoraes (3749321 in chips) 
Seat 3: Hulkyyyy (832969 in chips) 
Seat 4: hawkx1984 (1190326 in chips) 
Seat 5: Wealthiest1 (1804814 in chips) 
Seat 6: xeD_ox_es (1832412 in chips) 
Seat 7: reijomo (3801006 in chips) 
Seat 9: jareth3542 (4518439 in chips) 
madtimm: posts the ante 12000
zugmoraes: posts the ante 12000
Hulkyyyy: posts the ante 12000
hawkx1984: posts the ante 12000
Wealthiest1: posts the ante 12000
xeD_ox_es: posts the ante 12000
reijomo: posts the ante 12000
jareth3542: posts the ante 12000
Wealthiest1: posts small blind 40000
xeD_ox_es: posts big blind 80000
*** HOLE CARDS ***
reijomo: folds 
jareth3542: folds 
madtimm: folds 
zugmoraes: folds 
Hulkyyyy: folds 
hawkx1984: folds 
Wealthiest1: calls 40000
xeD_ox_es: raises 138505 to 218505
Wealthiest1: folds 
Uncalled bet (138505) returned to xeD_ox_es
xeD_ox_es collected 256000 from pot
xeD_ox_es: doesn't show hand 
*** SUMMARY ***
Total pot 256000 | Rake 0 
Seat 1: madtimm folded before Flop (didn't bet)
Seat 2: zugmoraes folded before Flop (didn't bet)
Seat 3: Hulkyyyy folded before Flop (didn't bet)
Seat 4: hawkx1984 (button) folded before Flop (didn't bet)
Seat 5: Wealthiest1 (small blind) folded before Flop
Seat 6: xeD_ox_es (big blind) collected (256000)
Seat 7: reijomo folded before Flop (didn't bet)
Seat 9: jareth3542 folded before Flop (didn't bet)



PokerStars Hand #157571098442: Tournament #1641817020, $7.50+$7.50+$1.50 USD Hold'em No Limit - Level L (40000/80000) - 2016/08/21 17:03:49 ET
Table '1641817020 92' 9-max Seat #5 is the button
Seat 1: madtimm (758713 in chips) 
Seat 2: zugmoraes (3737321 in chips) 
Seat 3: Hulkyyyy (820969 in chips) 
Seat 4: hawkx1984 (1178326 in chips) 
Seat 5: Wealthiest1 (1712814 in chips) 
Seat 6: xeD_ox_es (1996412 in chips) 
Seat 7: reijomo (3789006 in chips) 
Seat 9: jareth3542 (4506439 in chips) 
madtimm: posts the ante 12000
zugmoraes: posts the ante 12000
Hulkyyyy: posts the ante 12000
hawkx1984: posts the ante 12000
Wealthiest1: posts the ante 12000
xeD_ox_es: posts the ante 12000
reijomo: posts the ante 12000
jareth3542: posts the ante 12000
xeD_ox_es: posts small blind 40000
reijomo: posts big blind 80000
*** HOLE CARDS ***
jareth3542: folds 
madtimm: folds 
zugmoraes: folds 
Hulkyyyy: folds 
hawkx1984: folds 
Wealthiest1: folds 
xeD_ox_es: calls 40000
reijomo: raises 164469 to 244469
xeD_ox_es: raises 1739943 to 1984412 and is all-in
reijomo: folds 
Uncalled bet (1739943) returned to xeD_ox_es
xeD_ox_es collected 584938 from pot
xeD_ox_es: doesn't show hand 
*** SUMMARY ***
Total pot 584938 | Rake 0 
Seat 1: madtimm folded before Flop (didn't bet)
Seat 2: zugmoraes folded before Flop (didn't bet)
Seat 3: Hulkyyyy folded before Flop (didn't bet)
Seat 4: hawkx1984 folded before Flop (didn't bet)
Seat 5: Wealthiest1 (button) folded before Flop (didn't bet)
Seat 6: xeD_ox_es (small blind) collected (584938)
Seat 7: reijomo (big blind) folded before Flop
Seat 9: jareth3542 folded before Flop (didn't bet)



PokerStars Hand #157571138826: Tournament #1641817020, $7.50+$7.50+$1.50 USD Hold'em No Limit - Level L (40000/80000) - 2016/08/21 17:04:39 ET
Table '1641817020 92' 9-max Seat #6 is the button
Seat 1: madtimm (746713 in chips)
Seat 2: zugmoraes (3725321 in chips)
Seat 3: Hulkyyyy (808969 in chips)
Seat 4: hawkx1984 (1166326 in chips)
Seat 5: Wealthiest1 (1700814 in chips)
Seat 6: xeD_ox_es (2324881 in chips)
Seat 7: reijomo (3532537 in chips)
Seat 9: jareth3542 (4494439 in chips)
madtimm: posts the ante 12000
zugmoraes: posts the ante 12000
Hulkyyyy: posts the ante 12000
hawkx1984: posts the ante 12000
Wealthiest1: posts the ante 12000
xeD_ox_es: posts the ante 12000
reijomo: posts the ante 12000
jareth3542: posts the ante 12000
reijomo: posts small blind 40000
jareth3542: posts big blind 80000
*** HOLE CARDS ***
madtimm: folds
zugmoraes: folds
Hulkyyyy: folds
hawkx1984: raises 1074326 to 1154326 and is all-in
Wealthiest1: folds
xeD_ox_es: folds
reijomo: raises 2366211 to 3520537 and is all-in
jareth3542: folds
Uncalled bet (2366211) returned to reijomo
*** FLOP *** [Th 9c 5h]
*** TURN *** [Th 9c 5h] [5s]
*** RIVER *** [Th 9c 5h 5s] [Qd]
*** SHOW DOWN ***
reijomo: shows [Qs Qc] (a full house, Queens full of Fives)
hawkx1984: shows [As Jd] (a pair of Fives)
reijomo collected 2484652 from pot
reijomo wins $179.52 for eliminating hawkx1984 and their own bounty increases by $179.51 to $509.89
hawkx1984 finished the tournament in 8th place and received $395.99.
*** SUMMARY ***
Total pot 2484652 | Rake 0
Board [Th 9c 5h 5s Qd]
Seat 1: madtimm folded before Flop (didn't bet)
Seat 2: zugmoraes folded before Flop (didn't bet)
Seat 3: Hulkyyyy folded before Flop (didn't bet)
Seat 4: hawkx1984 showed [As Jd] and lost with a pair of Fives
Seat 5: Wealthiest1 folded before Flop (didn't bet)
Seat 6: xeD_ox_es (button) folded before Flop (didn't bet)
Seat 7: reijomo (small blind) showed [Qs Qc] and won (2484652) with a full house, Queens full of Fives
Seat 9: jareth3542 (big blind) folded before Flop



PokerStars Hand #157571168824: Tournament #1641817020, $7.50+$7.50+$1.50 USD Hold'em No Limit - Level L (40000/80000) - 2016/08/21 17:05:15 ET
Table '1641817020 92' 9-max Seat #7 is the button
Seat 1: madtimm (734713 in chips)
Seat 2: zugmoraes (3713321 in chips)
Seat 3: Hulkyyyy (796969 in chips)
Seat 5: Wealthiest1 (1688814 in chips)
Seat 6: xeD_ox_es (2312881 in chips)
Seat 7: reijomo (4850863 in chips)
Seat 9: jareth3542 (4402439 in chips)
madtimm: posts the ante 12000
zugmoraes: posts the ante 12000
Hulkyyyy: posts the ante 12000
Wealthiest1: posts the ante 12000
xeD_ox_es: posts the ante 12000
reijomo: posts the ante 12000
jareth3542: posts the ante 12000
jareth3542: posts small blind 40000
madtimm: posts big blind 80000
*** HOLE CARDS ***
zugmoraes: folds
Hulkyyyy: folds
Wealthiest1: folds
xeD_ox_es: raises 96000 to 176000
reijomo: folds
jareth3542: folds
madtimm: folds
Uncalled bet (96000) returned to xeD_ox_es
xeD_ox_es collected 284000 from pot
xeD_ox_es: doesn't show hand
*** SUMMARY ***
Total pot 284000 | Rake 0
Seat 1: madtimm (big blind) folded before Flop
Seat 2: zugmoraes folded before Flop (didn't bet)
Seat 3: Hulkyyyy folded before Flop (didn't bet)
Seat 5: Wealthiest1 folded before Flop (didn't bet)
Seat 6: xeD_ox_es collected (284000)
Seat 7: reijomo (button) folded before Flop (didn't bet)
Seat 9: jareth3542 (small blind) folded before Flop



PokerStars Hand #157571186803: Tournament #1641817020, $7.50+$7.50+$1.50 USD Hold'em No Limit - Level L (40000/80000) - 2016/08/21 17:05:37 ET
Table '1641817020 92' 9-max Seat #9 is the button
Seat 1: madtimm (642713 in chips)
Seat 2: zugmoraes (3701321 in chips)
Seat 3: Hulkyyyy (784969 in chips)
Seat 5: Wealthiest1 (1676814 in chips)
Seat 6: xeD_ox_es (2504881 in chips)
Seat 7: reijomo (4838863 in chips)
Seat 9: jareth3542 (4350439 in chips)
madtimm: posts the ante 12000
zugmoraes: posts the ante 12000
Hulkyyyy: posts the ante 12000
Wealthiest1: posts the ante 12000
xeD_ox_es: posts the ante 12000
reijomo: posts the ante 12000
jareth3542: posts the ante 12000
madtimm: posts small blind 40000
zugmoraes: posts big blind 80000
*** HOLE CARDS ***
Hulkyyyy: folds
Wealthiest1: folds
xeD_ox_es: folds
reijomo: raises 88000 to 168000
jareth3542: folds
madtimm: folds
zugmoraes: folds
Uncalled bet (88000) returned to reijomo
reijomo collected 284000 from pot
*** SUMMARY ***
Total pot 284000 | Rake 0
Seat 1: madtimm (small blind) folded before Flop
Seat 2: zugmoraes (big blind) folded before Flop
Seat 3: Hulkyyyy folded before Flop (didn't bet)
Seat 5: Wealthiest1 folded before Flop (didn't bet)
Seat 6: xeD_ox_es folded before Flop (didn't bet)
Seat 7: reijomo collected (284000)
Seat 9: jareth3542 (button) folded before Flop (didn't bet)



PokerStars Hand #157571242023: Tournament #1641817020, $7.50+$7.50+$1.50 USD Hold'em No Limit - Level L (40000/80000) - 2016/08/21 17:06:44 ET
Table '1641817020 92' 9-max Seat #5 is the button
Seat 2: zugmoraes (3545321 in chips) 
Seat 5: Wealthiest1 (2960496 in chips) 
Seat 6: xeD_ox_es (2468881 in chips) 
Seat 7: reijomo (5210863 in chips) 
Seat 9: jareth3542 (4314439 in chips) 
zugmoraes: posts the ante 12000
Wealthiest1: posts the ante 12000
xeD_ox_es: posts the ante 12000
reijomo: posts the ante 12000
jareth3542: posts the ante 12000
xeD_ox_es: posts small blind 40000
reijomo: posts big blind 80000
*** HOLE CARDS ***
jareth3542: folds 
zugmoraes: folds 
Wealthiest1: folds 
xeD_ox_es: calls 40000
reijomo: raises 164469 to 244469
xeD_ox_es: folds 
Uncalled bet (164469) returned to reijomo
reijomo collected 220000 from pot
*** SUMMARY ***
Total pot 220000 | Rake 0 
Seat 2: zugmoraes folded before Flop (didn't bet)
Seat 5: Wealthiest1 (button) folded before Flop (didn't bet)
Seat 6: xeD_ox_es (small blind) folded before Flop
Seat 7: reijomo (big blind) collected (220000)
Seat 9: jareth3542 folded before Flop (didn't bet)



PokerStars Hand #157571281959: Tournament #1641817020, $7.50+$7.50+$1.50 USD Hold'em No Limit - Level L (40000/80000) - 2016/08/21 17:07:25 ET
Table '1641817020 92' 9-max Seat #6 is the button
Seat 2: zugmoraes (3533321 in chips) 
Seat 5: Wealthiest1 (2948496 in chips) 
Seat 6: xeD_ox_es (2376881 in chips) 
Seat 7: reijomo (5338863 in chips) 
Seat 9: jareth3542 (4302439 in chips) 
zugmoraes: posts the ante 12000
Wealthiest1: posts the ante 12000
xeD_ox_es: posts the ante 12000
reijomo: posts the ante 12000
jareth3542: posts the ante 12000
reijomo: posts small blind 40000
jareth3542: posts big blind 80000
*** HOLE CARDS ***
zugmoraes: folds 
Wealthiest1: folds 
xeD_ox_es: folds 
reijomo: calls 40000
jareth3542: raises 120000 to 200000
reijomo: folds 
Uncalled bet (120000) returned to jareth3542
jareth3542 collected 220000 from pot
*** SUMMARY ***
Total pot 220000 | Rake 0 
Seat 2: zugmoraes folded before Flop (didn't bet)
Seat 5: Wealthiest1 folded before Flop (didn't bet)
Seat 6: xeD_ox_es (button) folded before Flop (didn't bet)
Seat 7: reijomo (small blind) folded before Flop
Seat 9: jareth3542 (big blind) collected (220000)



PokerStars Hand #157571303361: Tournament #1641817020, $7.50+$7.50+$1.50 USD Hold'em No Limit - Level L (40000/80000) - 2016/08/21 17:07:51 ET
Table '1641817020 92' 9-max Seat #7 is the button
Seat 2: zugmoraes (3521321 in chips) 
Seat 5: Wealthiest1 (2936496 in chips) 
Seat 6: xeD_ox_es (2364881 in chips) 
Seat 7: reijomo (5246863 in chips) 
Seat 9: jareth3542 (4430439 in chips) 
zugmoraes: posts the ante 12000
Wealthiest1: posts the ante 12000
xeD_ox_es: posts the ante 12000
reijomo: posts the ante 12000
jareth3542: posts the ante 12000
jareth3542: posts small blind 40000
zugmoraes: posts big blind 80000
*** HOLE CARDS ***
Wealthiest1: folds 
xeD_ox_es: folds 
reijomo: raises 88000 to 168000
jareth3542: folds 
zugmoraes: calls 88000
*** FLOP *** [7s Td 3s]
zugmoraes: checks 
reijomo: bets 183120
zugmoraes: calls 183120
*** TURN *** [7s Td 3s] [8h]
zugmoraes: bets 409254
reijomo: calls 409254
*** RIVER *** [7s Td 3s 8h] [Jh]
zugmoraes: checks 
reijomo: checks 
*** SHOW DOWN ***
zugmoraes: shows [Ts 8c] (two pair, Tens and Eights)
reijomo: mucks hand 
zugmoraes collected 1620748 from pot
*** SUMMARY ***
Total pot 1620748 | Rake 0 
Board [7s Td 3s 8h Jh]
Seat 2: zugmoraes (big blind) showed [Ts 8c] and won (1620748) with two pair, Tens and Eights
Seat 5: Wealthiest1 folded before Flop (didn't bet)
Seat 6: xeD_ox_es folded before Flop (didn't bet)
Seat 7: reijomo (button) mucked
Seat 9: jareth3542 (small blind) folded before Flop



PokerStars Hand #157571376461: Tournament #1641817020, $7.50+$7.50+$1.50 USD Hold'em No Limit - Level L (40000/80000) - 2016/08/21 17:09:22 ET
Table '1641817020 92' 9-max Seat #9 is the button
Seat 2: zugmoraes (4369695 in chips) 
Seat 5: Wealthiest1 (2924496 in chips) 
Seat 6: xeD_ox_es (2352881 in chips) 
Seat 7: reijomo (4474489 in chips) 
Seat 9: jareth3542 (4378439 in chips) 
zugmoraes: posts the ante 12000
Wealthiest1: posts the ante 12000
xeD_ox_es: posts the ante 12000
reijomo: posts the ante 12000
jareth3542: posts the ante 12000
zugmoraes: posts small blind 40000
Wealthiest1: posts big blind 80000
*** HOLE CARDS ***
xeD_ox_es: raises 96000 to 176000
reijomo: calls 176000
jareth3542: calls 176000
zugmoraes: folds 
Wealthiest1: calls 96000
*** FLOP *** [8h Td 9h]
Wealthiest1: checks 
xeD_ox_es: checks 
reijomo: bets 265320
jareth3542: folds 
Wealthiest1: calls 265320
xeD_ox_es: folds 
*** TURN *** [8h Td 9h] [Ks]
Wealthiest1: checks 
reijomo: bets 466966
Wealthiest1: calls 466966
*** RIVER *** [8h Td 9h Ks] [3c]
Wealthiest1: checks 
reijomo: bets 3554203 and is all-in
Wealthiest1: folds 
Uncalled bet (3554203) returned to reijomo
reijomo collected 2268572 from pot
*** SUMMARY ***
Total pot 2268572 | Rake 0 
Board [8h Td 9h Ks 3c]
Seat 2: zugmoraes (small blind) folded before Flop
Seat 5: Wealthiest1 (big blind) folded on the River
Seat 6: xeD_ox_es folded on the Flop
Seat 7: reijomo collected (2268572)
Seat 9: jareth3542 (button) folded on the Flop



PokerStars Hand #157571486714: Tournament #1641817020, $7.50+$7.50+$1.50 USD Hold'em No Limit - Level L (40000/80000) - 2016/08/21 17:11:37 ET
Table '1641817020 92' 9-max Seat #2 is the button
Seat 2: zugmoraes (4317695 in chips) 
Seat 5: Wealthiest1 (2004210 in chips) 
Seat 6: xeD_ox_es (2164881 in chips) 
Seat 7: reijomo (5822775 in chips) 
Seat 9: jareth3542 (4190439 in chips) 
zugmoraes: posts the ante 12000
Wealthiest1: posts the ante 12000
xeD_ox_es: posts the ante 12000
reijomo: posts the ante 12000
jareth3542: posts the ante 12000
Wealthiest1: posts small blind 40000
xeD_ox_es: posts big blind 80000
*** HOLE CARDS ***
reijomo: raises 88000 to 168000
jareth3542: folds 
zugmoraes: folds 
Wealthiest1: folds 
xeD_ox_es: calls 88000
*** FLOP *** [Js 5d Jc]
xeD_ox_es: checks 
reijomo: checks 
*** TURN *** [Js 5d Jc] [Jd]
xeD_ox_es: checks 
reijomo: checks 
*** RIVER *** [Js 5d Jc Jd] [Qs]
xeD_ox_es: bets 200000
reijomo: folds 
Uncalled bet (200000) returned to xeD_ox_es
xeD_ox_es collected 436000 from pot
xeD_ox_es: doesn't show hand 
*** SUMMARY ***
Total pot 436000 | Rake 0 
Board [Js 5d Jc Jd Qs]
Seat 2: zugmoraes (button) folded before Flop (didn't bet)
Seat 5: Wealthiest1 (small blind) folded before Flop
Seat 6: xeD_ox_es (big blind) collected (436000)
Seat 7: reijomo folded on the River
Seat 9: jareth3542 folded before Flop (didn't bet)



PokerStars Hand #157571547640: Tournament #1641817020, $7.50+$7.50+$1.50 USD Hold'em No Limit - Level LI (45000/90000) - 2016/08/21 17:12:52 ET
Table '1641817020 92' 9-max Seat #5 is the button
Seat 2: zugmoraes (4305695 in chips) 
Seat 5: Wealthiest1 (1952210 in chips) 
Seat 6: xeD_ox_es (2420881 in chips) 
Seat 7: reijomo (5642775 in chips) 
Seat 9: jareth3542 (4178439 in chips) 
zugmoraes: posts the ante 14000
Wealthiest1: posts the ante 14000
xeD_ox_es: posts the ante 14000
reijomo: posts the ante 14000
jareth3542: posts the ante 14000
xeD_ox_es: posts small blind 45000
reijomo: posts big blind 90000
*** HOLE CARDS ***
jareth3542: folds 
zugmoraes: raises 117000 to 207000
Wealthiest1: folds 
xeD_ox_es: folds 
reijomo: calls 117000
*** FLOP *** [4d Kh Kd]
reijomo: checks 
zugmoraes: bets 169280
reijomo: calls 169280
*** TURN *** [4d Kh Kd] [8h]
reijomo: checks 
zugmoraes: checks 
*** RIVER *** [4d Kh Kd 8h] [Qh]
reijomo: bets 364375
zugmoraes: calls 364375
*** SHOW DOWN ***
reijomo: shows [Qd As] (two pair, Kings and Queens)
zugmoraes: mucks hand 
reijomo collected 1596310 from pot
*** SUMMARY ***
Total pot 1596310 | Rake 0 
Board [4d Kh Kd 8h Qh]
Seat 2: zugmoraes mucked
Seat 5: Wealthiest1 (button) folded before Flop (didn't bet)
Seat 6: xeD_ox_es (small blind) folded before Flop
Seat 7: reijomo (big blind) showed [Qd As] and won (1596310) with two pair, Kings and Queens
Seat 9: jareth3542 folded before Flop (didn't bet)



PokerStars Hand #157571634344: Tournament #1641817020, $7.50+$7.50+$1.50 USD Hold'em No Limit - Level LI (45000/90000) - 2016/08/21 17:14:40 ET
Table '1641817020 92' 9-max Seat #6 is the button
Seat 2: zugmoraes (3551040 in chips) 
Seat 5: Wealthiest1 (1938210 in chips) 
Seat 6: xeD_ox_es (2361881 in chips) 
Seat 7: reijomo (6484430 in chips) 
Seat 9: jareth3542 (4164439 in chips) 
zugmoraes: posts the ante 14000
Wealthiest1: posts the ante 14000
xeD_ox_es: posts the ante 14000
reijomo: posts the ante 14000
jareth3542: posts the ante 14000
reijomo: posts small blind 45000
jareth3542: posts big blind 90000
*** HOLE CARDS ***
zugmoraes: folds 
Wealthiest1: folds 
xeD_ox_es: raises 108000 to 198000
reijomo: folds 
jareth3542: folds 
Uncalled bet (108000) returned to xeD_ox_es
xeD_ox_es collected 295000 from pot
xeD_ox_es: doesn't show hand 
*** SUMMARY ***
Total pot 295000 | Rake 0 
Seat 2: zugmoraes folded before Flop (didn't bet)
Seat 5: Wealthiest1 folded before Flop (didn't bet)
Seat 6: xeD_ox_es (button) collected (295000)
Seat 7: reijomo (small blind) folded before Flop
Seat 9: jareth3542 (big blind) folded before Flop



PokerStars Hand #157571689254: Tournament #1641817020, $7.50+$7.50+$1.50 USD Hold'em No Limit - Level LI (45000/90000) - 2016/08/21 17:15:48 ET
Table '1641817020 92' 9-max Seat #7 is the button
Seat 2: zugmoraes (3537040 in chips) 
Seat 5: Wealthiest1 (1924210 in chips) 
Seat 6: xeD_ox_es (2552881 in chips) 
Seat 7: reijomo (6425430 in chips) 
Seat 9: jareth3542 (4060439 in chips) 
zugmoraes: posts the ante 14000
Wealthiest1: posts the ante 14000
xeD_ox_es: posts the ante 14000
reijomo: posts the ante 14000
jareth3542: posts the ante 14000
jareth3542: posts small blind 45000
zugmoraes: posts big blind 90000
*** HOLE CARDS ***
Wealthiest1: folds 
xeD_ox_es: folds 
reijomo: folds 
jareth3542 has timed out
jareth3542: folds 
Uncalled bet (45000) returned to zugmoraes
jareth3542 is sitting out
zugmoraes collected 160000 from pot
*** SUMMARY ***
Total pot 160000 | Rake 0 
Seat 2: zugmoraes (big blind) collected (160000)
Seat 5: Wealthiest1 folded before Flop (didn't bet)
Seat 6: xeD_ox_es folded before Flop (didn't bet)
Seat 7: reijomo (button) folded before Flop (didn't bet)
Seat 9: jareth3542 (small blind) folded before Flop



PokerStars Hand #157571713309: Tournament #1641817020, $7.50+$7.50+$1.50 USD Hold'em No Limit - Level LI (45000/90000) - 2016/08/21 17:16:18 ET
Table '1641817020 92' 9-max Seat #9 is the button
Seat 2: zugmoraes (3638040 in chips) 
Seat 5: Wealthiest1 (1910210 in chips) 
Seat 6: xeD_ox_es (2538881 in chips) 
Seat 7: reijomo (6411430 in chips) 
Seat 9: jareth3542 (4001439 in chips) is sitting out
zugmoraes: posts the ante 14000
Wealthiest1: posts the ante 14000
xeD_ox_es: posts the ante 14000
reijomo: posts the ante 14000
jareth3542: posts the ante 14000
zugmoraes: posts small blind 45000
Wealthiest1: posts big blind 90000
*** HOLE CARDS ***
xeD_ox_es: folds 
jareth3542 has returned
reijomo: raises 99000 to 189000
jareth3542: folds 
zugmoraes: folds 
Wealthiest1: folds 
Uncalled bet (99000) returned to reijomo
reijomo collected 295000 from pot
*** SUMMARY ***
Total pot 295000 | Rake 0 
Seat 2: zugmoraes (small blind) folded before Flop
Seat 5: Wealthiest1 (big blind) folded before Flop
Seat 6: xeD_ox_es folded before Flop (didn't bet)
Seat 7: reijomo collected (295000)
Seat 9: jareth3542 (button) folded before Flop (didn't bet)



PokerStars Hand #157571740268: Tournament #1641817020, $7.50+$7.50+$1.50 USD Hold'em No Limit - Level LI (45000/90000) - 2016/08/21 17:16:52 ET
Table '1641817020 92' 9-max Seat #2 is the button
Seat 2: zugmoraes (3579040 in chips) 
Seat 5: Wealthiest1 (1806210 in chips) 
Seat 6: xeD_ox_es (2524881 in chips) 
Seat 7: reijomo (6602430 in chips) 
Seat 9: jareth3542 (3987439 in chips) 
zugmoraes: posts the ante 14000
Wealthiest1: posts the ante 14000
xeD_ox_es: posts the ante 14000
reijomo: posts the ante 14000
jareth3542: posts the ante 14000
Wealthiest1: posts small blind 45000
xeD_ox_es: posts big blind 90000
*** HOLE CARDS ***
reijomo: folds 
jareth3542: raises 90000 to 180000
zugmoraes: folds 
Wealthiest1: folds 
xeD_ox_es: calls 90000
*** FLOP *** [7d 9c 5h]
xeD_ox_es: checks 
jareth3542: bets 180000
xeD_ox_es: calls 180000
*** TURN *** [7d 9c 5h] [7s]
xeD_ox_es: checks 
jareth3542: checks 
*** RIVER *** [7d 9c 5h 7s] [5d]
xeD_ox_es: checks 
jareth3542: bets 651300
xeD_ox_es: folds 
Uncalled bet (651300) returned to jareth3542
jareth3542 collected 835000 from pot
*** SUMMARY ***
Total pot 835000 | Rake 0 
Board [7d 9c 5h 7s 5d]
Seat 2: zugmoraes (button) folded before Flop (didn't bet)
Seat 5: Wealthiest1 (small blind) folded before Flop
Seat 6: xeD_ox_es (big blind) folded on the River
Seat 7: reijomo folded before Flop (didn't bet)
Seat 9: jareth3542 collected (835000)



PokerStars Hand #157571815432: Tournament #1641817020, $7.50+$7.50+$1.50 USD Hold'em No Limit - Level LI (45000/90000) - 2016/08/21 17:18:25 ET
Table '1641817020 92' 9-max Seat #5 is the button
Seat 2: zugmoraes (3565040 in chips) 
Seat 5: Wealthiest1 (1747210 in chips) 
Seat 6: xeD_ox_es (2150881 in chips) 
Seat 7: reijomo (6588430 in chips) 
Seat 9: jareth3542 (4448439 in chips) 
zugmoraes: posts the ante 14000
Wealthiest1: posts the ante 14000
xeD_ox_es: posts the ante 14000
reijomo: posts the ante 14000
jareth3542: posts the ante 14000
xeD_ox_es: posts small blind 45000
reijomo: posts big blind 90000
*** HOLE CARDS ***
jareth3542 has timed out
jareth3542: folds 
jareth3542 is sitting out
zugmoraes: folds 
Wealthiest1: raises 90000 to 180000
xeD_ox_es: folds 
reijomo: raises 6394430 to 6574430 and is all-in
Wealthiest1: folds 
Uncalled bet (6394430) returned to reijomo
reijomo collected 475000 from pot
*** SUMMARY ***
Total pot 475000 | Rake 0 
Seat 2: zugmoraes folded before Flop (didn't bet)
Seat 5: Wealthiest1 (button) folded before Flop
Seat 6: xeD_ox_es (small blind) folded before Flop
Seat 7: reijomo (big blind) collected (475000)
Seat 9: jareth3542 folded before Flop (didn't bet)



PokerStars Hand #157571856124: Tournament #1641817020, $7.50+$7.50+$1.50 USD Hold'em No Limit - Level LI (45000/90000) - 2016/08/21 17:19:17 ET
Table '1641817020 92' 9-max Seat #6 is the button
Seat 2: zugmoraes (3551040 in chips) 
Seat 5: Wealthiest1 (1553210 in chips) 
Seat 6: xeD_ox_es (2091881 in chips) 
Seat 7: reijomo (6869430 in chips) 
Seat 9: jareth3542 (4434439 in chips) is sitting out
zugmoraes: posts the ante 14000
Wealthiest1: posts the ante 14000
xeD_ox_es: posts the ante 14000
reijomo: posts the ante 14000
jareth3542: posts the ante 14000
reijomo: posts small blind 45000
jareth3542: posts big blind 90000
*** HOLE CARDS ***
zugmoraes: folds 
Wealthiest1: folds 
xeD_ox_es: raises 1987881 to 2077881 and is all-in
reijomo: folds 
jareth3542: folds 
Uncalled bet (1987881) returned to xeD_ox_es
xeD_ox_es collected 295000 from pot
xeD_ox_es: doesn't show hand 
*** SUMMARY ***
Total pot 295000 | Rake 0 
Seat 2: zugmoraes folded before Flop (didn't bet)
Seat 5: Wealthiest1 folded before Flop (didn't bet)
Seat 6: xeD_ox_es (button) collected (295000)
Seat 7: reijomo (small blind) folded before Flop
Seat 9: jareth3542 (big blind) folded before Flop



PokerStars Hand #157571870002: Tournament #1641817020, $7.50+$7.50+$1.50 USD Hold'em No Limit - Level LI (45000/90000) - 2016/08/21 17:19:34 ET
Table '1641817020 92' 9-max Seat #7 is the button
Seat 2: zugmoraes (3537040 in chips) 
Seat 5: Wealthiest1 (1539210 in chips) 
Seat 6: xeD_ox_es (2282881 in chips) 
Seat 7: reijomo (6810430 in chips) 
Seat 9: jareth3542 (4330439 in chips) is sitting out
zugmoraes: posts the ante 14000
Wealthiest1: posts the ante 14000
xeD_ox_es: posts the ante 14000
reijomo: posts the ante 14000
jareth3542: posts the ante 14000
jareth3542: posts small blind 45000
zugmoraes: posts big blind 90000
*** HOLE CARDS ***
Wealthiest1: folds 
xeD_ox_es: raises 90000 to 180000
reijomo: folds 
jareth3542: folds 
jareth3542 has returned
zugmoraes: raises 3343040 to 3523040 and is all-in
xeD_ox_es: folds 
Uncalled bet (3343040) returned to zugmoraes
zugmoraes collected 475000 from pot
zugmoraes: doesn't show hand 
*** SUMMARY ***
Total pot 475000 | Rake 0 
Seat 2: zugmoraes (big blind) collected (475000)
Seat 5: Wealthiest1 folded before Flop (didn't bet)
Seat 6: xeD_ox_es folded before Flop
Seat 7: reijomo (button) folded before Flop (didn't bet)
Seat 9: jareth3542 (small blind) folded before Flop



PokerStars Hand #157571895605: Tournament #1641817020, $7.50+$7.50+$1.50 USD Hold'em No Limit - Level LI (45000/90000) - 2016/08/21 17:20:06 ET
Table '1641817020 92' 9-max Seat #9 is the button
Seat 2: zugmoraes (3818040 in chips) 
Seat 5: Wealthiest1 (1525210 in chips) 
Seat 6: xeD_ox_es (2088881 in chips) 
Seat 7: reijomo (6796430 in chips) 
Seat 9: jareth3542 (4271439 in chips) 
zugmoraes: posts the ante 14000
Wealthiest1: posts the ante 14000
xeD_ox_es: posts the ante 14000
reijomo: posts the ante 14000
jareth3542: posts the ante 14000
zugmoraes: posts small blind 45000
Wealthiest1: posts big blind 90000
*** HOLE CARDS ***
xeD_ox_es: folds 
reijomo: folds 
jareth3542 has timed out
jareth3542: folds 
jareth3542 is sitting out
zugmoraes: calls 45000
Wealthiest1: checks 
*** FLOP *** [Ac 3h 9d]
zugmoraes: bets 98440
Wealthiest1: folds 
Uncalled bet (98440) returned to zugmoraes
zugmoraes collected 250000 from pot
zugmoraes: doesn't show hand 
*** SUMMARY ***
Total pot 250000 | Rake 0 
Board [Ac 3h 9d]
Seat 2: zugmoraes (small blind) collected (250000)
Seat 5: Wealthiest1 (big blind) folded on the Flop
Seat 6: xeD_ox_es folded before Flop (didn't bet)
Seat 7: reijomo folded before Flop (didn't bet)
Seat 9: jareth3542 (button) folded before Flop (didn't bet)



PokerStars Hand #157571938557: Tournament #1641817020, $7.50+$7.50+$1.50 USD Hold'em No Limit - Level LI (45000/90000) - 2016/08/21 17:21:00 ET
Table '1641817020 92' 9-max Seat #2 is the button
Seat 2: zugmoraes (3964040 in chips) 
Seat 5: Wealthiest1 (1421210 in chips) 
Seat 6: xeD_ox_es (2074881 in chips) 
Seat 7: reijomo (6782430 in chips) 
Seat 9: jareth3542 (4257439 in chips) is sitting out
zugmoraes: posts the ante 14000
Wealthiest1: posts the ante 14000
xeD_ox_es: posts the ante 14000
reijomo: posts the ante 14000
jareth3542: posts the ante 14000
Wealthiest1: posts small blind 45000
xeD_ox_es: posts big blind 90000
*** HOLE CARDS ***
reijomo: folds 
jareth3542: folds 
zugmoraes: folds 
Wealthiest1: folds 
Uncalled bet (45000) returned to xeD_ox_es
xeD_ox_es collected 160000 from pot
xeD_ox_es: doesn't show hand 
*** SUMMARY ***
Total pot 160000 | Rake 0 
Seat 2: zugmoraes (button) folded before Flop (didn't bet)
Seat 5: Wealthiest1 (small blind) folded before Flop
Seat 6: xeD_ox_es (big blind) collected (160000)
Seat 7: reijomo folded before Flop (didn't bet)
Seat 9: jareth3542 folded before Flop (didn't bet)



PokerStars Hand #157571949128: Tournament #1641817020, $7.50+$7.50+$1.50 USD Hold'em No Limit - Level LI (45000/90000) - 2016/08/21 17:21:13 ET
Table '1641817020 92' 9-max Seat #5 is the button
Seat 2: zugmoraes (3950040 in chips) 
Seat 5: Wealthiest1 (1362210 in chips) 
Seat 6: xeD_ox_es (2175881 in chips) 
Seat 7: reijomo (6768430 in chips) 
Seat 9: jareth3542 (4243439 in chips) is sitting out
zugmoraes: posts the ante 14000
Wealthiest1: posts the ante 14000
xeD_ox_es: posts the ante 14000
reijomo: posts the ante 14000
jareth3542: posts the ante 14000
xeD_ox_es: posts small blind 45000
reijomo: posts big blind 90000
*** HOLE CARDS ***
jareth3542: folds 
zugmoraes: folds 
Wealthiest1: folds 
xeD_ox_es: calls 45000
reijomo: checks 
*** FLOP *** [3s 5d 7h]
jareth3542 has returned
xeD_ox_es: checks 
reijomo: bets 99999
xeD_ox_es: folds 
Uncalled bet (99999) returned to reijomo
reijomo collected 250000 from pot
*** SUMMARY ***
Total pot 250000 | Rake 0 
Board [3s 5d 7h]
Seat 2: zugmoraes folded before Flop (didn't bet)
Seat 5: Wealthiest1 (button) folded before Flop (didn't bet)
Seat 6: xeD_ox_es (small blind) folded on the Flop
Seat 7: reijomo (big blind) collected (250000)
Seat 9: jareth3542 folded before Flop (didn't bet)



PokerStars Hand #157571974315: Tournament #1641817020, $7.50+$7.50+$1.50 USD Hold'em No Limit - Level LI (45000/90000) - 2016/08/21 17:21:46 ET
Table '1641817020 92' 9-max Seat #6 is the button
Seat 2: zugmoraes (3936040 in chips) 
Seat 5: Wealthiest1 (1348210 in chips) 
Seat 6: xeD_ox_es (2071881 in chips) 
Seat 7: reijomo (6914430 in chips) 
Seat 9: jareth3542 (4229439 in chips) 
zugmoraes: posts the ante 14000
Wealthiest1: posts the ante 14000
xeD_ox_es: posts the ante 14000
reijomo: posts the ante 14000
jareth3542: posts the ante 14000
reijomo: posts small blind 45000
jareth3542: posts big blind 90000
*** HOLE CARDS ***
zugmoraes: folds 
Wealthiest1: folds 
xeD_ox_es: folds 
reijomo: calls 45000
jareth3542: checks 
*** FLOP *** [Ad Kd 7h]
reijomo: bets 99999
jareth3542: folds 
Uncalled bet (99999) returned to reijomo
reijomo collected 250000 from pot
*** SUMMARY ***
Total pot 250000 | Rake 0 
Board [Ad Kd 7h]
Seat 2: zugmoraes folded before Flop (didn't bet)
Seat 5: Wealthiest1 folded before Flop (didn't bet)
Seat 6: xeD_ox_es (button) folded before Flop (didn't bet)
Seat 7: reijomo (small blind) collected (250000)
Seat 9: jareth3542 (big blind) folded on the Flop



PokerStars Hand #157572006698: Tournament #1641817020, $7.50+$7.50+$1.50 USD Hold'em No Limit - Level LII (50000/100000) - 2016/08/21 17:22:27 ET
Table '1641817020 92' 9-max Seat #7 is the button
Seat 2: zugmoraes (3922040 in chips) 
Seat 5: Wealthiest1 (1334210 in chips) 
Seat 6: xeD_ox_es (2057881 in chips) 
Seat 7: reijomo (7060430 in chips) 
Seat 9: jareth3542 (4125439 in chips) 
zugmoraes: posts the ante 15000
Wealthiest1: posts the ante 15000
xeD_ox_es: posts the ante 15000
reijomo: posts the ante 15000
jareth3542: posts the ante 15000
jareth3542: posts small blind 50000
zugmoraes: posts big blind 100000
*** HOLE CARDS ***
Wealthiest1: folds 
xeD_ox_es: raises 100000 to 200000
reijomo: folds 
jareth3542: folds 
zugmoraes: calls 100000
*** FLOP *** [2h 3d 7h]
zugmoraes: checks 
xeD_ox_es: checks 
*** TURN *** [2h 3d 7h] [6s]
zugmoraes: checks 
xeD_ox_es: bets 198550
zugmoraes: calls 198550
*** RIVER *** [2h 3d 7h 6s] [Qd]
zugmoraes: checks 
xeD_ox_es: bets 550000
zugmoraes: calls 550000
*** SHOW DOWN ***
xeD_ox_es: shows [Qh Ts] (a pair of Queens)
zugmoraes: mucks hand 
xeD_ox_es collected 2022100 from pot
*** SUMMARY ***
Total pot 2022100 | Rake 0 
Board [2h 3d 7h 6s Qd]
Seat 2: zugmoraes (big blind) mucked
Seat 5: Wealthiest1 folded before Flop (didn't bet)
Seat 6: xeD_ox_es showed [Qh Ts] and won (2022100) with a pair of Queens
Seat 7: reijomo (button) folded before Flop (didn't bet)
Seat 9: jareth3542 (small blind) folded before Flop



PokerStars Hand #157572073327: Tournament #1641817020, $7.50+$7.50+$1.50 USD Hold'em No Limit - Level LII (50000/100000) - 2016/08/21 17:23:43 ET
Table '1641817020 92' 9-max Seat #9 is the button
Seat 2: zugmoraes (2958490 in chips) 
Seat 5: Wealthiest1 (1319210 in chips) 
Seat 6: xeD_ox_es (3116431 in chips) 
Seat 7: reijomo (7045430 in chips) 
Seat 9: jareth3542 (4060439 in chips) 
zugmoraes: posts the ante 15000
Wealthiest1: posts the ante 15000
xeD_ox_es: posts the ante 15000
reijomo: posts the ante 15000
jareth3542: posts the ante 15000
zugmoraes: posts small blind 50000
Wealthiest1: posts big blind 100000
*** HOLE CARDS ***
xeD_ox_es: folds 
reijomo: folds 
jareth3542: raises 100000 to 200000
zugmoraes: folds 
Wealthiest1: folds 
Uncalled bet (100000) returned to jareth3542
jareth3542 collected 325000 from pot
*** SUMMARY ***
Total pot 325000 | Rake 0 
Seat 2: zugmoraes (small blind) folded before Flop
Seat 5: Wealthiest1 (big blind) folded before Flop
Seat 6: xeD_ox_es folded before Flop (didn't bet)
Seat 7: reijomo folded before Flop (didn't bet)
Seat 9: jareth3542 (button) collected (325000)



PokerStars Hand #157572089729: Tournament #1641817020, $7.50+$7.50+$1.50 USD Hold'em No Limit - Level LII (50000/100000) - 2016/08/21 17:24:00 ET
Table '1641817020 92' 9-max Seat #2 is the button
Seat 2: zugmoraes (2893490 in chips) 
Seat 5: Wealthiest1 (1204210 in chips) 
Seat 6: xeD_ox_es (3101431 in chips) 
Seat 7: reijomo (7030430 in chips) 
Seat 9: jareth3542 (4270439 in chips) 
zugmoraes: posts the ante 15000
Wealthiest1: posts the ante 15000
xeD_ox_es: posts the ante 15000
reijomo: posts the ante 15000
jareth3542: posts the ante 15000
Wealthiest1: posts small blind 50000
xeD_ox_es: posts big blind 100000
*** HOLE CARDS ***
reijomo: raises 110000 to 210000
jareth3542: folds 
zugmoraes: folds 
Wealthiest1: folds 
xeD_ox_es: calls 110000
*** FLOP *** [3s Qh Qs]
xeD_ox_es: checks 
reijomo: checks 
*** TURN *** [3s Qh Qs] [3h]
xeD_ox_es: checks 
reijomo: checks 
*** RIVER *** [3s Qh Qs 3h] [7d]
xeD_ox_es: checks 
reijomo: bets 100000
xeD_ox_es: folds 
Uncalled bet (100000) returned to reijomo
reijomo collected 545000 from pot
*** SUMMARY ***
Total pot 545000 | Rake 0 
Board [3s Qh Qs 3h 7d]
Seat 2: zugmoraes (button) folded before Flop (didn't bet)
Seat 5: Wealthiest1 (small blind) folded before Flop
Seat 6: xeD_ox_es (big blind) folded on the River
Seat 7: reijomo collected (545000)
Seat 9: jareth3542 folded before Flop (didn't bet)



PokerStars Hand #157572141555: Tournament #1641817020, $7.50+$7.50+$1.50 USD Hold'em No Limit - Level LII (50000/100000) - 2016/08/21 17:24:51 ET
Table '1641817020 92' 9-max Seat #5 is the button
Seat 2: zugmoraes (2878490 in chips) 
Seat 5: Wealthiest1 (1139210 in chips) 
Seat 6: xeD_ox_es (2876431 in chips) 
Seat 7: reijomo (7350430 in chips) 
Seat 9: jareth3542 (4255439 in chips) 
zugmoraes: posts the ante 15000
Wealthiest1: posts the ante 15000
xeD_ox_es: posts the ante 15000
reijomo: posts the ante 15000
jareth3542: posts the ante 15000
xeD_ox_es: posts small blind 50000
reijomo: posts big blind 100000
*** HOLE CARDS ***
jareth3542: folds 
zugmoraes: raises 130000 to 230000
Wealthiest1: folds 
xeD_ox_es: folds 
reijomo: calls 130000
*** FLOP *** [5h 4s Jh]
reijomo: checks 
zugmoraes: bets 187200
reijomo: calls 187200
*** TURN *** [5h 4s Jh] [7c]
reijomo: checks 
zugmoraes: checks 
*** RIVER *** [5h 4s Jh 7c] [5d]
reijomo: bets 500000
zugmoraes: folds 
Uncalled bet (500000) returned to reijomo
reijomo collected 959400 from pot
*** SUMMARY ***
Total pot 959400 | Rake 0 
Board [5h 4s Jh 7c 5d]
Seat 2: zugmoraes folded on the River
Seat 5: Wealthiest1 (button) folded before Flop (didn't bet)
Seat 6: xeD_ox_es (small blind) folded before Flop
Seat 7: reijomo (big blind) collected (959400)
Seat 9: jareth3542 folded before Flop (didn't bet)



PokerStars Hand #157572229370: Tournament #1641817020, $7.50+$7.50+$1.50 USD Hold'em No Limit - Level LII (50000/100000) - 2016/08/21 17:26:18 ET
Table '1641817020 92' 9-max Seat #6 is the button
Seat 2: zugmoraes (2446290 in chips) 
Seat 5: Wealthiest1 (1124210 in chips) 
Seat 6: xeD_ox_es (2811431 in chips) 
Seat 7: reijomo (7877630 in chips) 
Seat 9: jareth3542 (4240439 in chips) 
zugmoraes: posts the ante 15000
Wealthiest1: posts the ante 15000
xeD_ox_es: posts the ante 15000
reijomo: posts the ante 15000
jareth3542: posts the ante 15000
reijomo: posts small blind 50000
jareth3542: posts big blind 100000
*** HOLE CARDS ***
zugmoraes: folds 
Wealthiest1: folds 
xeD_ox_es: folds 
reijomo: calls 50000
jareth3542: checks 
*** FLOP *** [Kc As Th]
reijomo: bets 123456
jareth3542: folds 
Uncalled bet (123456) returned to reijomo
reijomo collected 275000 from pot
*** SUMMARY ***
Total pot 275000 | Rake 0 
Board [Kc As Th]
Seat 2: zugmoraes folded before Flop (didn't bet)
Seat 5: Wealthiest1 folded before Flop (didn't bet)
Seat 6: xeD_ox_es (button) folded before Flop (didn't bet)
Seat 7: reijomo (small blind) collected (275000)
Seat 9: jareth3542 (big blind) folded on the Flop



PokerStars Hand #157572278255: Tournament #1641817020, $7.50+$7.50+$1.50 USD Hold'em No Limit - Level LII (50000/100000) - 2016/08/21 17:27:01 ET
Table '1641817020 92' 9-max Seat #7 is the button
Seat 2: zugmoraes (2431290 in chips) 
Seat 5: Wealthiest1 (1109210 in chips) 
Seat 6: xeD_ox_es (2796431 in chips) 
Seat 7: reijomo (8037630 in chips) 
Seat 9: jareth3542 (4125439 in chips) 
zugmoraes: posts the ante 15000
Wealthiest1: posts the ante 15000
xeD_ox_es: posts the ante 15000
reijomo: posts the ante 15000
jareth3542: posts the ante 15000
jareth3542: posts small blind 50000
zugmoraes: posts big blind 100000
*** HOLE CARDS ***
Wealthiest1: folds 
xeD_ox_es: folds 
reijomo: raises 110000 to 210000
jareth3542: folds 
zugmoraes: folds 
Uncalled bet (110000) returned to reijomo
reijomo collected 325000 from pot
*** SUMMARY ***
Total pot 325000 | Rake 0 
Seat 2: zugmoraes (big blind) folded before Flop
Seat 5: Wealthiest1 folded before Flop (didn't bet)
Seat 6: xeD_ox_es folded before Flop (didn't bet)
Seat 7: reijomo (button) collected (325000)
Seat 9: jareth3542 (small blind) folded before Flop



PokerStars Hand #157572311994: Tournament #1641817020, $7.50+$7.50+$1.50 USD Hold'em No Limit - Level LII (50000/100000) - 2016/08/21 17:27:34 ET
Table '1641817020 92' 9-max Seat #9 is the button
Seat 2: zugmoraes (2316290 in chips) 
Seat 5: Wealthiest1 (1094210 in chips) 
Seat 6: xeD_ox_es (2781431 in chips) 
Seat 7: reijomo (8247630 in chips) 
Seat 9: jareth3542 (4060439 in chips) 
zugmoraes: posts the ante 15000
Wealthiest1: posts the ante 15000
xeD_ox_es: posts the ante 15000
reijomo: posts the ante 15000
jareth3542: posts the ante 15000
zugmoraes: posts small blind 50000
Wealthiest1: posts big blind 100000
*** HOLE CARDS ***
xeD_ox_es: folds 
reijomo: folds 
jareth3542: raises 100000 to 200000
zugmoraes: folds 
Wealthiest1: folds 
Uncalled bet (100000) returned to jareth3542
jareth3542 collected 325000 from pot
*** SUMMARY ***
Total pot 325000 | Rake 0 
Seat 2: zugmoraes (small blind) folded before Flop
Seat 5: Wealthiest1 (big blind) folded before Flop
Seat 6: xeD_ox_es folded before Flop (didn't bet)
Seat 7: reijomo folded before Flop (didn't bet)
Seat 9: jareth3542 (button) collected (325000)



PokerStars Hand #157572334217: Tournament #1641817020, $7.50+$7.50+$1.50 USD Hold'em No Limit - Level LII (50000/100000) - 2016/08/21 17:27:57 ET
Table '1641817020 92' 9-max Seat #2 is the button
Seat 2: zugmoraes (2251290 in chips) 
Seat 5: Wealthiest1 (979210 in chips) 
Seat 6: xeD_ox_es (2766431 in chips) 
Seat 7: reijomo (8232630 in chips) 
Seat 9: jareth3542 (4270439 in chips) 
zugmoraes: posts the ante 15000
Wealthiest1: posts the ante 15000
xeD_ox_es: posts the ante 15000
reijomo: posts the ante 15000
jareth3542: posts the ante 15000
Wealthiest1: posts small blind 50000
xeD_ox_es: posts big blind 100000
*** HOLE CARDS ***
reijomo: raises 110000 to 210000
jareth3542: folds 
zugmoraes: folds 
Wealthiest1: folds 
xeD_ox_es: folds 
Uncalled bet (110000) returned to reijomo
reijomo collected 325000 from pot
*** SUMMARY ***
Total pot 325000 | Rake 0 
Seat 2: zugmoraes (button) folded before Flop (didn't bet)
Seat 5: Wealthiest1 (small blind) folded before Flop
Seat 6: xeD_ox_es (big blind) folded before Flop
Seat 7: reijomo collected (325000)
Seat 9: jareth3542 folded before Flop (didn't bet)



PokerStars Hand #157572355190: Tournament #1641817020, $7.50+$7.50+$1.50 USD Hold'em No Limit - Level LII (50000/100000) - 2016/08/21 17:28:19 ET
Table '1641817020 92' 9-max Seat #5 is the button
Seat 2: zugmoraes (2236290 in chips) 
Seat 5: Wealthiest1 (914210 in chips) 
Seat 6: xeD_ox_es (2651431 in chips) 
Seat 7: reijomo (8442630 in chips) 
Seat 9: jareth3542 (4255439 in chips) 
zugmoraes: posts the ante 15000
Wealthiest1: posts the ante 15000
xeD_ox_es: posts the ante 15000
reijomo: posts the ante 15000
jareth3542: posts the ante 15000
xeD_ox_es: posts small blind 50000
reijomo: posts big blind 100000
*** HOLE CARDS ***
jareth3542: folds 
zugmoraes: folds 
Wealthiest1: folds 
xeD_ox_es: calls 50000
reijomo: checks 
*** FLOP *** [Th 4c As]
xeD_ox_es: bets 100000
reijomo: folds 
Uncalled bet (100000) returned to xeD_ox_es
xeD_ox_es collected 275000 from pot
xeD_ox_es: doesn't show hand 
*** SUMMARY ***
Total pot 275000 | Rake 0 
Board [Th 4c As]
Seat 2: zugmoraes folded before Flop (didn't bet)
Seat 5: Wealthiest1 (button) folded before Flop (didn't bet)
Seat 6: xeD_ox_es (small blind) collected (275000)
Seat 7: reijomo (big blind) folded on the Flop
Seat 9: jareth3542 folded before Flop (didn't bet)



PokerStars Hand #157572390411: Tournament #1641817020, $7.50+$7.50+$1.50 USD Hold'em No Limit - Level LII (50000/100000) - 2016/08/21 17:28:55 ET
Table '1641817020 92' 9-max Seat #6 is the button
Seat 2: zugmoraes (2221290 in chips) 
Seat 5: Wealthiest1 (899210 in chips) 
Seat 6: xeD_ox_es (2811431 in chips) 
Seat 7: reijomo (8327630 in chips) 
Seat 9: jareth3542 (4240439 in chips) 
zugmoraes: posts the ante 15000
Wealthiest1: posts the ante 15000
xeD_ox_es: posts the ante 15000
reijomo: posts the ante 15000
jareth3542: posts the ante 15000
reijomo: posts small blind 50000
jareth3542: posts big blind 100000
*** HOLE CARDS ***
zugmoraes: folds 
Wealthiest1: folds 
xeD_ox_es: folds 
reijomo: folds 
Uncalled bet (50000) returned to jareth3542
jareth3542 collected 175000 from pot
*** SUMMARY ***
Total pot 175000 | Rake 0 
Seat 2: zugmoraes folded before Flop (didn't bet)
Seat 5: Wealthiest1 folded before Flop (didn't bet)
Seat 6: xeD_ox_es (button) folded before Flop (didn't bet)
Seat 7: reijomo (small blind) folded before Flop
Seat 9: jareth3542 (big blind) collected (175000)



PokerStars Hand #157572409267: Tournament #1641817020, $7.50+$7.50+$1.50 USD Hold'em No Limit - Level LII (50000/100000) - 2016/08/21 17:29:14 ET
Table '1641817020 92' 9-max Seat #7 is the button
Seat 2: zugmoraes (2206290 in chips) 
Seat 5: Wealthiest1 (884210 in chips) 
Seat 6: xeD_ox_es (2796431 in chips) 
Seat 7: reijomo (8262630 in chips) 
Seat 9: jareth3542 (4350439 in chips) 
zugmoraes: posts the ante 15000
Wealthiest1: posts the ante 15000
xeD_ox_es: posts the ante 15000
reijomo: posts the ante 15000
jareth3542: posts the ante 15000
jareth3542: posts small blind 50000
zugmoraes: posts big blind 100000
*** HOLE CARDS ***
Wealthiest1: folds 
xeD_ox_es: folds 
reijomo: raises 110000 to 210000
jareth3542: folds 
zugmoraes: folds 
Uncalled bet (110000) returned to reijomo
reijomo collected 325000 from pot
*** SUMMARY ***
Total pot 325000 | Rake 0 
Seat 2: zugmoraes (big blind) folded before Flop
Seat 5: Wealthiest1 folded before Flop (didn't bet)
Seat 6: xeD_ox_es folded before Flop (didn't bet)
Seat 7: reijomo (button) collected (325000)
Seat 9: jareth3542 (small blind) folded before Flop



PokerStars Hand #157572703300: Tournament #1641817020, $7.50+$7.50+$1.50 USD Hold'em No Limit - Level LIII (60000/120000) - 2016/08/21 17:35:05 ET
Table '1641817020 92' 9-max Seat #5 is the button
Seat 2: zugmoraes (5231580 in chips) 
Seat 5: Wealthiest1 (1080420 in chips) 
Seat 6: xeD_ox_es (1270772 in chips) 
Seat 7: reijomo (7226999 in chips) 
Seat 9: jareth3542 (3690229 in chips) 
zugmoraes: posts the ante 18000
Wealthiest1: posts the ante 18000
xeD_ox_es: posts the ante 18000
reijomo: posts the ante 18000
jareth3542: posts the ante 18000
xeD_ox_es: posts small blind 60000
reijomo: posts big blind 120000
*** HOLE CARDS ***
jareth3542: folds 
zugmoraes: raises 156000 to 276000
Wealthiest1: folds 
xeD_ox_es: raises 976772 to 1252772 and is all-in
reijomo: folds 
zugmoraes: calls 976772
*** FLOP *** [2c Js Th]
*** TURN *** [2c Js Th] [Kh]
*** RIVER *** [2c Js Th Kh] [Td]
*** SHOW DOWN ***
xeD_ox_es: shows [As 6h] (a pair of Tens)
zugmoraes: shows [Kd Kc] (a full house, Kings full of Tens)
zugmoraes collected 2715544 from pot
zugmoraes wins $207.81 for eliminating xeD_ox_es and their own bounty increases by $207.80 to $631.10
xeD_ox_es finished the tournament in 5th place and received $939.06.
*** SUMMARY ***
Total pot 2715544 | Rake 0 
Board [2c Js Th Kh Td]
Seat 2: zugmoraes showed [Kd Kc] and won (2715544) with a full house, Kings full of Tens
Seat 5: Wealthiest1 (button) folded before Flop (didn't bet)
Seat 6: xeD_ox_es (small blind) showed [As 6h] and lost with a pair of Tens
Seat 7: reijomo (big blind) folded before Flop
Seat 9: jareth3542 folded before Flop (didn't bet)



PokerStars Hand #157572727318: Tournament #1641817020, $7.50+$7.50+$1.50 USD Hold'em No Limit - Level LIII (60000/120000) - 2016/08/21 17:35:35 ET
Table '1641817020 92' 9-max Seat #7 is the button
Seat 2: zugmoraes (6676352 in chips) 
Seat 5: Wealthiest1 (1062420 in chips) 
Seat 7: reijomo (7088999 in chips) 
Seat 9: jareth3542 (3672229 in chips) 
zugmoraes: posts the ante 18000
Wealthiest1: posts the ante 18000
reijomo: posts the ante 18000
jareth3542: posts the ante 18000
jareth3542: posts small blind 60000
zugmoraes: posts big blind 120000
*** HOLE CARDS ***
Wealthiest1: folds 
reijomo: raises 180000 to 300000
jareth3542: raises 3354229 to 3654229 and is all-in
zugmoraes: folds 
reijomo: folds 
Uncalled bet (3354229) returned to jareth3542
jareth3542 collected 792000 from pot
*** SUMMARY ***
Total pot 792000 | Rake 0 
Seat 2: zugmoraes (big blind) folded before Flop
Seat 5: Wealthiest1 folded before Flop (didn't bet)
Seat 7: reijomo (button) folded before Flop
Seat 9: jareth3542 (small blind) collected (792000)



PokerStars Hand #157572768024: Tournament #1641817020, $7.50+$7.50+$1.50 USD Hold'em No Limit - Level LIII (60000/120000) - 2016/08/21 17:36:27 ET
Table '1641817020 92' 9-max Seat #9 is the button
Seat 2: zugmoraes (6538352 in chips) 
Seat 5: Wealthiest1 (1044420 in chips) 
Seat 7: reijomo (6770999 in chips) 
Seat 9: jareth3542 (4146229 in chips) 
zugmoraes: posts the ante 18000
Wealthiest1: posts the ante 18000
reijomo: posts the ante 18000
jareth3542: posts the ante 18000
zugmoraes: posts small blind 60000
Wealthiest1: posts big blind 120000
*** HOLE CARDS ***
reijomo: raises 132000 to 252000
jareth3542: folds 
zugmoraes: folds 
Wealthiest1: folds 
Uncalled bet (132000) returned to reijomo
reijomo collected 372000 from pot
reijomo is connected 
*** SUMMARY ***
Total pot 372000 | Rake 0 
Seat 2: zugmoraes (small blind) folded before Flop
Seat 5: Wealthiest1 (big blind) folded before Flop
Seat 7: reijomo collected (372000)
Seat 9: jareth3542 (button) folded before Flop (didn't bet)



PokerStars Hand #157572781427: Tournament #1641817020, $7.50+$7.50+$1.50 USD Hold'em No Limit - Level LIII (60000/120000) - 2016/08/21 17:36:45 ET
Table '1641817020 92' 9-max Seat #2 is the button
Seat 2: zugmoraes (6460352 in chips) 
Seat 5: Wealthiest1 (906420 in chips) 
Seat 7: reijomo (7004999 in chips) 
Seat 9: jareth3542 (4128229 in chips) 
zugmoraes: posts the ante 18000
Wealthiest1: posts the ante 18000
reijomo: posts the ante 18000
jareth3542: posts the ante 18000
Wealthiest1: posts small blind 60000
reijomo: posts big blind 120000
*** HOLE CARDS ***
jareth3542: folds 
zugmoraes: raises 156000 to 276000
Wealthiest1: raises 612420 to 888420 and is all-in
reijomo: folds 
zugmoraes: calls 612420
*** FLOP *** [6d 7s Qc]
*** TURN *** [6d 7s Qc] [5d]
*** RIVER *** [6d 7s Qc 5d] [7h]
*** SHOW DOWN ***
Wealthiest1: shows [Ah 2s] (a pair of Sevens)
zugmoraes: shows [Js 8s] (a pair of Sevens - lower kicker)
Wealthiest1 collected 1968840 from pot
*** SUMMARY ***
Total pot 1968840 | Rake 0 
Board [6d 7s Qc 5d 7h]
Seat 2: zugmoraes (button) showed [Js 8s] and lost with a pair of Sevens
Seat 5: Wealthiest1 (small blind) showed [Ah 2s] and won (1968840) with a pair of Sevens
Seat 7: reijomo (big blind) folded before Flop
Seat 9: jareth3542 folded before Flop (didn't bet)



PokerStars Hand #157572816067: Tournament #1641817020, $7.50+$7.50+$1.50 USD Hold'em No Limit - Level LIII (60000/120000) - 2016/08/21 17:37:29 ET
Table '1641817020 92' 9-max Seat #7 is the button
Seat 2: zugmoraes (5535932 in chips) 
Seat 5: Wealthiest1 (1950840 in chips) 
Seat 7: reijomo (6788999 in chips) 
Seat 9: jareth3542 (4224229 in chips) 
zugmoraes: posts the ante 18000
Wealthiest1: posts the ante 18000
reijomo: posts the ante 18000
jareth3542: posts the ante 18000
jareth3542: posts small blind 60000
zugmoraes: posts big blind 120000
*** HOLE CARDS ***
Wealthiest1: raises 120000 to 240000
reijomo: folds 
jareth3542: folds 
zugmoraes: folds 
Uncalled bet (120000) returned to Wealthiest1
Wealthiest1 collected 372000 from pot
Wealthiest1: doesn't show hand 
*** SUMMARY ***
Total pot 372000 | Rake 0 
Seat 2: zugmoraes (big blind) folded before Flop
Seat 5: Wealthiest1 collected (372000)
Seat 7: reijomo (button) folded before Flop (didn't bet)
Seat 9: jareth3542 (small blind) folded before Flop



PokerStars Hand #157572835042: Tournament #1641817020, $7.50+$7.50+$1.50 USD Hold'em No Limit - Level LIII (60000/120000) - 2016/08/21 17:37:53 ET
Table '1641817020 92' 9-max Seat #9 is the button
Seat 2: zugmoraes (5397932 in chips) 
Seat 5: Wealthiest1 (2184840 in chips) 
Seat 7: reijomo (6770999 in chips) 
Seat 9: jareth3542 (4146229 in chips) 
zugmoraes: posts the ante 18000
Wealthiest1: posts the ante 18000
reijomo: posts the ante 18000
jareth3542: posts the ante 18000
zugmoraes: posts small blind 60000
Wealthiest1: posts big blind 120000
*** HOLE CARDS ***
reijomo: folds 
jareth3542: raises 120000 to 240000
zugmoraes: folds 
Wealthiest1: folds 
Uncalled bet (120000) returned to jareth3542
jareth3542 collected 372000 from pot
*** SUMMARY ***
Total pot 372000 | Rake 0 
Seat 2: zugmoraes (small blind) folded before Flop
Seat 5: Wealthiest1 (big blind) folded before Flop
Seat 7: reijomo folded before Flop (didn't bet)
Seat 9: jareth3542 (button) collected (372000)



PokerStars Hand #157572847165: Tournament #1641817020, $7.50+$7.50+$1.50 USD Hold'em No Limit - Level LIII (60000/120000) - 2016/08/21 17:38:09 ET
Table '1641817020 92' 9-max Seat #2 is the button
Seat 2: zugmoraes (5319932 in chips) 
Seat 5: Wealthiest1 (2046840 in chips) 
Seat 7: reijomo (6752999 in chips) 
Seat 9: jareth3542 (4380229 in chips) 
zugmoraes: posts the ante 18000
Wealthiest1: posts the ante 18000
reijomo: posts the ante 18000
jareth3542: posts the ante 18000
Wealthiest1: posts small blind 60000
reijomo: posts big blind 120000
*** HOLE CARDS ***
jareth3542: folds 
zugmoraes: raises 156000 to 276000
Wealthiest1: folds 
reijomo: raises 612888 to 888888
zugmoraes: folds 
Uncalled bet (612888) returned to reijomo
reijomo collected 684000 from pot
*** SUMMARY ***
Total pot 684000 | Rake 0 
Seat 2: zugmoraes (button) folded before Flop
Seat 5: Wealthiest1 (small blind) folded before Flop
Seat 7: reijomo (big blind) collected (684000)
Seat 9: jareth3542 folded before Flop (didn't bet)



PokerStars Hand #157572892593: Tournament #1641817020, $7.50+$7.50+$1.50 USD Hold'em No Limit - Level LIII (60000/120000) - 2016/08/21 17:39:07 ET
Table '1641817020 92' 9-max Seat #5 is the button
Seat 2: zugmoraes (5025932 in chips) 
Seat 5: Wealthiest1 (1968840 in chips) 
Seat 7: reijomo (7142999 in chips) 
Seat 9: jareth3542 (4362229 in chips) 
zugmoraes: posts the ante 18000
Wealthiest1: posts the ante 18000
reijomo: posts the ante 18000
jareth3542: posts the ante 18000
reijomo: posts small blind 60000
jareth3542: posts big blind 120000
*** HOLE CARDS ***
zugmoraes: folds 
Wealthiest1: folds 
reijomo: calls 60000
jareth3542: raises 4224229 to 4344229 and is all-in
reijomo: folds 
Uncalled bet (4224229) returned to jareth3542
jareth3542 collected 312000 from pot
*** SUMMARY ***
Total pot 312000 | Rake 0 
Seat 2: zugmoraes folded before Flop (didn't bet)
Seat 5: Wealthiest1 (button) folded before Flop (didn't bet)
Seat 7: reijomo (small blind) folded before Flop
Seat 9: jareth3542 (big blind) collected (312000)



PokerStars Hand #157572929444: Tournament #1641817020, $7.50+$7.50+$1.50 USD Hold'em No Limit - Level LIII (60000/120000) - 2016/08/21 17:39:55 ET
Table '1641817020 92' 9-max Seat #7 is the button
Seat 2: zugmoraes (5007932 in chips) 
Seat 5: Wealthiest1 (1950840 in chips) 
Seat 7: reijomo (7004999 in chips) 
Seat 9: jareth3542 (4536229 in chips) 
zugmoraes: posts the ante 18000
Wealthiest1: posts the ante 18000
reijomo: posts the ante 18000
jareth3542: posts the ante 18000
jareth3542: posts small blind 60000
zugmoraes: posts big blind 120000
*** HOLE CARDS ***
Wealthiest1: folds 
reijomo said, "i may folded best hand"
reijomo: raises 132000 to 252000
jareth3542: folds 
zugmoraes: calls 132000
*** FLOP *** [Qs 4d 5h]
zugmoraes: checks 
reijomo: bets 267120
zugmoraes: calls 267120
*** TURN *** [Qs 4d 5h] [Ah]
zugmoraes: checks 
reijomo: bets 490000
zugmoraes: calls 490000
*** RIVER *** [Qs 4d 5h Ah] [Jd]
zugmoraes: checks 
reijomo: checks 
*** SHOW DOWN ***
zugmoraes: shows [Tc Qh] (a pair of Queens)
reijomo: shows [Ad 3d] (a pair of Aces)
reijomo collected 2150240 from pot
*** SUMMARY ***
Total pot 2150240 | Rake 0 
Board [Qs 4d 5h Ah Jd]
Seat 2: zugmoraes (big blind) showed [Tc Qh] and lost with a pair of Queens
Seat 5: Wealthiest1 folded before Flop (didn't bet)
Seat 7: reijomo (button) showed [Ad 3d] and won (2150240) with a pair of Aces
Seat 9: jareth3542 (small blind) folded before Flop



PokerStars Hand #157572996280: Tournament #1641817020, $7.50+$7.50+$1.50 USD Hold'em No Limit - Level LIII (60000/120000) - 2016/08/21 17:41:23 ET
Table '1641817020 92' 9-max Seat #9 is the button
Seat 2: zugmoraes (3980812 in chips) 
Seat 5: Wealthiest1 (1932840 in chips) 
Seat 7: reijomo (8128119 in chips) 
Seat 9: jareth3542 (4458229 in chips) 
zugmoraes: posts the ante 18000
Wealthiest1: posts the ante 18000
reijomo: posts the ante 18000
jareth3542: posts the ante 18000
zugmoraes: posts small blind 60000
Wealthiest1: posts big blind 120000
*** HOLE CARDS ***
reijomo: folds 
jareth3542: raises 120000 to 240000
zugmoraes: folds 
Wealthiest1: folds 
Uncalled bet (120000) returned to jareth3542
jareth3542 collected 372000 from pot
*** SUMMARY ***
Total pot 372000 | Rake 0 
Seat 2: zugmoraes (small blind) folded before Flop
Seat 5: Wealthiest1 (big blind) folded before Flop
Seat 7: reijomo folded before Flop (didn't bet)
Seat 9: jareth3542 (button) collected (372000)



PokerStars Hand #157573005620: Tournament #1641817020, $7.50+$7.50+$1.50 USD Hold'em No Limit - Level LIII (60000/120000) - 2016/08/21 17:41:35 ET
Table '1641817020 92' 9-max Seat #2 is the button
Seat 2: zugmoraes (3902812 in chips) 
Seat 5: Wealthiest1 (1794840 in chips) 
Seat 7: reijomo (8110119 in chips) 
Seat 9: jareth3542 (4692229 in chips) 
zugmoraes: posts the ante 18000
Wealthiest1: posts the ante 18000
reijomo: posts the ante 18000
jareth3542: posts the ante 18000
Wealthiest1: posts small blind 60000
reijomo: posts big blind 120000
*** HOLE CARDS ***
jareth3542: folds 
zugmoraes: folds 
Wealthiest1: folds 
Uncalled bet (60000) returned to reijomo
reijomo collected 192000 from pot
*** SUMMARY ***
Total pot 192000 | Rake 0 
Seat 2: zugmoraes (button) folded before Flop (didn't bet)
Seat 5: Wealthiest1 (small blind) folded before Flop
Seat 7: reijomo (big blind) collected (192000)
Seat 9: jareth3542 folded before Flop (didn't bet)



PokerStars Hand #157573019544: Tournament #1641817020, $7.50+$7.50+$1.50 USD Hold'em No Limit - Level LIII (60000/120000) - 2016/08/21 17:41:54 ET
Table '1641817020 92' 9-max Seat #5 is the button
Seat 2: zugmoraes (3884812 in chips) 
Seat 5: Wealthiest1 (1716840 in chips) 
Seat 7: reijomo (8224119 in chips) 
Seat 9: jareth3542 (4674229 in chips) 
zugmoraes: posts the ante 18000
Wealthiest1: posts the ante 18000
reijomo: posts the ante 18000
jareth3542: posts the ante 18000
reijomo: posts small blind 60000
jareth3542: posts big blind 120000
*** HOLE CARDS ***
zugmoraes: folds 
Wealthiest1: raises 1578840 to 1698840 and is all-in
reijomo: folds 
jareth3542: calls 1578840
*** FLOP *** [6h 8d 8s]
*** TURN *** [6h 8d 8s] [6s]
*** RIVER *** [6h 8d 8s 6s] [Qd]
*** SHOW DOWN ***
jareth3542: shows [Ac Qc] (two pair, Queens and Eights)
Wealthiest1: shows [Jh Th] (two pair, Eights and Sixes)
jareth3542 collected 3529680 from pot
jareth3542 wins $239.57 for eliminating Wealthiest1 and their own bounty increases by $239.56 to $582.52
Wealthiest1 finished the tournament in 4th place and received $1252.26.
*** SUMMARY ***
Total pot 3529680 | Rake 0 
Board [6h 8d 8s 6s Qd]
Seat 2: zugmoraes folded before Flop (didn't bet)
Seat 5: Wealthiest1 (button) showed [Jh Th] and lost with two pair, Eights and Sixes
Seat 7: reijomo (small blind) folded before Flop
Seat 9: jareth3542 (big blind) showed [Ac Qc] and won (3529680) with two pair, Queens and Eights



PokerStars Hand #157573042134: Tournament #1641817020, $7.50+$7.50+$1.50 USD Hold'em No Limit - Level LIV (70000/140000) - 2016/08/21 17:42:17 ET
Table '1641817020 92' 9-max Seat #7 is the button
Seat 2: zugmoraes (3866812 in chips) 
Seat 7: reijomo (8146119 in chips) 
Seat 9: jareth3542 (6487069 in chips) 
zugmoraes: posts the ante 21000
reijomo: posts the ante 21000
jareth3542: posts the ante 21000
jareth3542: posts small blind 70000
zugmoraes: posts big blind 140000
*** HOLE CARDS ***
reijomo: raises 154000 to 294000
jareth3542: folds 
zugmoraes: raises 3551812 to 3845812 and is all-in
reijomo: calls 3551812
*** FLOP *** [9s 3d 6c]
*** TURN *** [9s 3d 6c] [9h]
*** RIVER *** [9s 3d 6c 9h] [4s]
*** SHOW DOWN ***
zugmoraes: shows [7h 7c] (two pair, Nines and Sevens)
reijomo: shows [5c 5h] (two pair, Nines and Fives)
zugmoraes collected 7824624 from pot
*** SUMMARY ***
Total pot 7824624 | Rake 0 
Board [9s 3d 6c 9h 4s]
Seat 2: zugmoraes (big blind) showed [7h 7c] and won (7824624) with two pair, Nines and Sevens
Seat 7: reijomo (button) showed [5c 5h] and lost with two pair, Nines and Fives
Seat 9: jareth3542 (small blind) folded before Flop



PokerStars Hand #157573068501: Tournament #1641817020, $7.50+$7.50+$1.50 USD Hold'em No Limit - Level LIV (70000/140000) - 2016/08/21 17:42:52 ET
Table '1641817020 92' 9-max Seat #9 is the button
Seat 2: zugmoraes (7824624 in chips) 
Seat 7: reijomo (4279307 in chips) 
Seat 9: jareth3542 (6396069 in chips) 
zugmoraes: posts the ante 21000
reijomo: posts the ante 21000
jareth3542: posts the ante 21000
zugmoraes: posts small blind 70000
reijomo: posts big blind 140000
*** HOLE CARDS ***
jareth3542: raises 140000 to 280000
zugmoraes: raises 414332 to 694332
reijomo: folds 
jareth3542: folds 
Uncalled bet (414332) returned to zugmoraes
zugmoraes collected 763000 from pot
*** SUMMARY ***
Total pot 763000 | Rake 0 
Seat 2: zugmoraes (small blind) collected (763000)
Seat 7: reijomo (big blind) folded before Flop
Seat 9: jareth3542 (button) folded before Flop



PokerStars Hand #157573085987: Tournament #1641817020, $7.50+$7.50+$1.50 USD Hold'em No Limit - Level LIV (70000/140000) - 2016/08/21 17:43:15 ET
Table '1641817020 92' 9-max Seat #2 is the button
Seat 2: zugmoraes (8286624 in chips) 
Seat 7: reijomo (4118307 in chips) 
Seat 9: jareth3542 (6095069 in chips) 
zugmoraes: posts the ante 21000
reijomo: posts the ante 21000
jareth3542: posts the ante 21000
reijomo: posts small blind 70000
jareth3542: posts big blind 140000
*** HOLE CARDS ***
zugmoraes: raises 182000 to 322000
reijomo: calls 252000
jareth3542: calls 182000
*** FLOP *** [Js Th Qd]
reijomo: checks 
jareth3542: checks 
zugmoraes: checks 
*** TURN *** [Js Th Qd] [Ac]
reijomo: checks 
jareth3542: bets 350000
zugmoraes: folds 
reijomo: calls 350000
*** RIVER *** [Js Th Qd Ac] [6h]
reijomo: checks 
jareth3542: folds 
reijomo collected 1729000 from pot
*** SUMMARY ***
Total pot 1729000 | Rake 0 
Board [Js Th Qd Ac 6h]
Seat 2: zugmoraes (button) folded on the Turn
Seat 7: reijomo (small blind) collected (1729000)
Seat 9: jareth3542 (big blind) folded on the River



PokerStars Hand #157573145776: Tournament #1641817020, $7.50+$7.50+$1.50 USD Hold'em No Limit - Level LIV (70000/140000) - 2016/08/21 17:44:35 ET
Table '1641817020 92' 9-max Seat #7 is the button
Seat 2: zugmoraes (7943624 in chips) 
Seat 7: reijomo (5154307 in chips) 
Seat 9: jareth3542 (5402069 in chips) 
zugmoraes: posts the ante 21000
reijomo: posts the ante 21000
jareth3542: posts the ante 21000
jareth3542: posts small blind 70000
zugmoraes: posts big blind 140000
*** HOLE CARDS ***
reijomo: raises 154000 to 294000
jareth3542: raises 5087069 to 5381069 and is all-in
zugmoraes: folds 
reijomo: folds 
Uncalled bet (5087069) returned to jareth3542
jareth3542 collected 791000 from pot
*** SUMMARY ***
Total pot 791000 | Rake 0 
Seat 2: zugmoraes (big blind) folded before Flop
Seat 7: reijomo (button) folded before Flop
Seat 9: jareth3542 (small blind) collected (791000)



PokerStars Hand #157573159169: Tournament #1641817020, $7.50+$7.50+$1.50 USD Hold'em No Limit - Level LIV (70000/140000) - 2016/08/21 17:44:53 ET
Table '1641817020 92' 9-max Seat #9 is the button
Seat 2: zugmoraes (7782624 in chips) 
Seat 7: reijomo (4839307 in chips) 
Seat 9: jareth3542 (5878069 in chips) 
zugmoraes: posts the ante 21000
reijomo: posts the ante 21000
jareth3542: posts the ante 21000
zugmoraes: posts small blind 70000
reijomo: posts big blind 140000
*** HOLE CARDS ***
jareth3542: raises 140000 to 280000
zugmoraes: folds 
reijomo: calls 140000
*** FLOP *** [9s 2d Qd]
reijomo: checks 
jareth3542: checks 
*** TURN *** [9s 2d Qd] [5d]
reijomo: bets 600000
jareth3542: calls 600000
*** RIVER *** [9s 2d Qd 5d] [5h]
reijomo: bets 1820000
jareth3542: folds 
Uncalled bet (1820000) returned to reijomo
reijomo collected 1893000 from pot
*** SUMMARY ***
Total pot 1893000 | Rake 0 
Board [9s 2d Qd 5d 5h]
Seat 2: zugmoraes (small blind) folded before Flop
Seat 7: reijomo (big blind) collected (1893000)
Seat 9: jareth3542 (button) folded on the River



PokerStars Hand #157573212966: Tournament #1641817020, $7.50+$7.50+$1.50 USD Hold'em No Limit - Level LIV (70000/140000) - 2016/08/21 17:46:05 ET
Table '1641817020 92' 9-max Seat #2 is the button
Seat 2: zugmoraes (7691624 in chips) 
Seat 7: reijomo (5831307 in chips) 
Seat 9: jareth3542 (4977069 in chips) 
zugmoraes: posts the ante 21000
reijomo: posts the ante 21000
jareth3542: posts the ante 21000
reijomo: posts small blind 70000
jareth3542: posts big blind 140000
*** HOLE CARDS ***
zugmoraes: folds 
reijomo: calls 70000
jareth3542: raises 210000 to 350000
reijomo: folds 
Uncalled bet (210000) returned to jareth3542
jareth3542 collected 343000 from pot
*** SUMMARY ***
Total pot 343000 | Rake 0 
Seat 2: zugmoraes (button) folded before Flop (didn't bet)
Seat 7: reijomo (small blind) folded before Flop
Seat 9: jareth3542 (big blind) collected (343000)



PokerStars Hand #157573233017: Tournament #1641817020, $7.50+$7.50+$1.50 USD Hold'em No Limit - Level LIV (70000/140000) - 2016/08/21 17:46:31 ET
Table '1641817020 92' 9-max Seat #7 is the button
Seat 2: zugmoraes (7670624 in chips) 
Seat 7: reijomo (5670307 in chips) 
Seat 9: jareth3542 (5159069 in chips) 
zugmoraes: posts the ante 21000
reijomo: posts the ante 21000
jareth3542: posts the ante 21000
jareth3542: posts small blind 70000
zugmoraes: posts big blind 140000
*** HOLE CARDS ***
reijomo: folds 
jareth3542: calls 70000
zugmoraes: checks 
*** FLOP *** [5s 8h 8d]
jareth3542: bets 140000
zugmoraes: folds 
Uncalled bet (140000) returned to jareth3542
jareth3542 collected 343000 from pot
*** SUMMARY ***
Total pot 343000 | Rake 0 
Board [5s 8h 8d]
Seat 2: zugmoraes (big blind) folded on the Flop
Seat 7: reijomo (button) folded before Flop (didn't bet)
Seat 9: jareth3542 (small blind) collected (343000)



PokerStars Hand #157573248482: Tournament #1641817020, $7.50+$7.50+$1.50 USD Hold'em No Limit - Level LIV (70000/140000) - 2016/08/21 17:46:52 ET
Table '1641817020 92' 9-max Seat #9 is the button
Seat 2: zugmoraes (7509624 in chips) 
Seat 7: reijomo (5649307 in chips) 
Seat 9: jareth3542 (5341069 in chips) 
zugmoraes: posts the ante 21000
reijomo: posts the ante 21000
jareth3542: posts the ante 21000
zugmoraes: posts small blind 70000
reijomo: posts big blind 140000
*** HOLE CARDS ***
jareth3542: raises 140000 to 280000
zugmoraes: folds 
reijomo: calls 140000
*** FLOP *** [Jh 8s Js]
reijomo: checks 
jareth3542: checks 
*** TURN *** [Jh 8s Js] [9d]
reijomo: checks 
jareth3542: checks 
*** RIVER *** [Jh 8s Js 9d] [3d]
reijomo: checks 
jareth3542: checks 
*** SHOW DOWN ***
reijomo: shows [6s 3c] (two pair, Jacks and Threes)
jareth3542: mucks hand 
reijomo collected 693000 from pot
*** SUMMARY ***
Total pot 693000 | Rake 0 
Board [Jh 8s Js 9d 3d]
Seat 2: zugmoraes (small blind) folded before Flop
Seat 7: reijomo (big blind) showed [6s 3c] and won (693000) with two pair, Jacks and Threes
Seat 9: jareth3542 (button) mucked



PokerStars Hand #157573273762: Tournament #1641817020, $7.50+$7.50+$1.50 USD Hold'em No Limit - Level LIV (70000/140000) - 2016/08/21 17:47:26 ET
Table '1641817020 92' 9-max Seat #2 is the button
Seat 2: zugmoraes (7418624 in chips) 
Seat 7: reijomo (6041307 in chips) 
Seat 9: jareth3542 (5040069 in chips) 
zugmoraes: posts the ante 21000
reijomo: posts the ante 21000
jareth3542: posts the ante 21000
reijomo: posts small blind 70000
jareth3542: posts big blind 140000
*** HOLE CARDS ***
zugmoraes: raises 182000 to 322000
reijomo: raises 644969 to 966969
jareth3542: folds 
zugmoraes: folds 
Uncalled bet (644969) returned to reijomo
reijomo collected 847000 from pot
*** SUMMARY ***
Total pot 847000 | Rake 0 
Seat 2: zugmoraes (button) folded before Flop
Seat 7: reijomo (small blind) collected (847000)
Seat 9: jareth3542 (big blind) folded before Flop



PokerStars Hand #157573308694: Tournament #1641817020, $7.50+$7.50+$1.50 USD Hold'em No Limit - Level LIV (70000/140000) - 2016/08/21 17:48:13 ET
Table '1641817020 92' 9-max Seat #7 is the button
Seat 2: zugmoraes (7075624 in chips) 
Seat 7: reijomo (6545307 in chips) 
Seat 9: jareth3542 (4879069 in chips) 
zugmoraes: posts the ante 21000
reijomo: posts the ante 21000
jareth3542: posts the ante 21000
jareth3542: posts small blind 70000
zugmoraes: posts big blind 140000
*** HOLE CARDS ***
reijomo: calls 140000
jareth3542: folds 
zugmoraes: raises 302199 to 442199
reijomo: calls 302199
*** FLOP *** [9s 5d Ad]
zugmoraes: bets 437481
reijomo: folds 
Uncalled bet (437481) returned to zugmoraes
zugmoraes collected 1017398 from pot
zugmoraes: doesn't show hand 
*** SUMMARY ***
Total pot 1017398 | Rake 0 
Board [9s 5d Ad]
Seat 2: zugmoraes (big blind) collected (1017398)
Seat 7: reijomo (button) folded on the Flop
Seat 9: jareth3542 (small blind) folded before Flop



PokerStars Hand #157573352927: Tournament #1641817020, $7.50+$7.50+$1.50 USD Hold'em No Limit - Level LIV (70000/140000) - 2016/08/21 17:49:13 ET
Table '1641817020 92' 9-max Seat #9 is the button
Seat 2: zugmoraes (7629823 in chips) 
Seat 7: reijomo (6082108 in chips) 
Seat 9: jareth3542 (4788069 in chips) 
zugmoraes: posts the ante 21000
reijomo: posts the ante 21000
jareth3542: posts the ante 21000
zugmoraes: posts small blind 70000
reijomo: posts big blind 140000
*** HOLE CARDS ***
jareth3542: raises 140000 to 280000
zugmoraes: folds 
reijomo: calls 140000
*** FLOP *** [4c Qh Kh]
reijomo: checks 
jareth3542: checks 
*** TURN *** [4c Qh Kh] [2h]
reijomo: bets 346500
jareth3542: calls 346500
*** RIVER *** [4c Qh Kh 2h] [Th]
reijomo: checks 
jareth3542: checks 
*** SHOW DOWN ***
reijomo: shows [5d 4s] (a pair of Fours)
jareth3542: shows [9h 9c] (a flush, King high)
jareth3542 collected 1386000 from pot
*** SUMMARY ***
Total pot 1386000 | Rake 0 
Board [4c Qh Kh 2h Th]
Seat 2: zugmoraes (small blind) folded before Flop
Seat 7: reijomo (big blind) showed [5d 4s] and lost with a pair of Fours
Seat 9: jareth3542 (button) showed [9h 9c] and won (1386000) with a flush, King high



PokerStars Hand #157573392243: Tournament #1641817020, $7.50+$7.50+$1.50 USD Hold'em No Limit - Level LIV (70000/140000) - 2016/08/21 17:50:06 ET
Table '1641817020 92' 9-max Seat #2 is the button
Seat 2: zugmoraes (7538823 in chips) 
Seat 7: reijomo (5434608 in chips) 
Seat 9: jareth3542 (5526569 in chips) 
zugmoraes: posts the ante 21000
reijomo: posts the ante 21000
jareth3542: posts the ante 21000
reijomo: posts small blind 70000
jareth3542: posts big blind 140000
*** HOLE CARDS ***
zugmoraes: folds 
reijomo: folds 
Uncalled bet (70000) returned to jareth3542
jareth3542 collected 203000 from pot
*** SUMMARY ***
Total pot 203000 | Rake 0 
Seat 2: zugmoraes (button) folded before Flop (didn't bet)
Seat 7: reijomo (small blind) folded before Flop
Seat 9: jareth3542 (big blind) collected (203000)



PokerStars Hand #157573398790: Tournament #1641817020, $7.50+$7.50+$1.50 USD Hold'em No Limit - Level LIV (70000/140000) - 2016/08/21 17:50:16 ET
Table '1641817020 92' 9-max Seat #7 is the button
Seat 2: zugmoraes (7517823 in chips) 
Seat 7: reijomo (5343608 in chips) 
Seat 9: jareth3542 (5638569 in chips) 
zugmoraes: posts the ante 21000
reijomo: posts the ante 21000
jareth3542: posts the ante 21000
jareth3542: posts small blind 70000
zugmoraes: posts big blind 140000
*** HOLE CARDS ***
reijomo: raises 154000 to 294000
jareth3542: folds 
zugmoraes: calls 154000
*** FLOP *** [Js 8s Qc]
zugmoraes: checks 
reijomo: checks 
*** TURN *** [Js 8s Qc] [6c]
zugmoraes: bets 352030
reijomo: calls 352030
*** RIVER *** [Js 8s Qc 6c] [5h]
zugmoraes: checks 
reijomo: checks 
*** SHOW DOWN ***
zugmoraes: shows [7c Kc] (high card King)
reijomo: shows [Jd As] (a pair of Jacks)
reijomo collected 1425060 from pot
*** SUMMARY ***
Total pot 1425060 | Rake 0 
Board [Js 8s Qc 6c 5h]
Seat 2: zugmoraes (big blind) showed [7c Kc] and lost with high card King
Seat 7: reijomo (button) showed [Jd As] and won (1425060) with a pair of Jacks
Seat 9: jareth3542 (small blind) folded before Flop



PokerStars Hand #157573446605: Tournament #1641817020, $7.50+$7.50+$1.50 USD Hold'em No Limit - Level LIV (70000/140000) - 2016/08/21 17:51:21 ET
Table '1641817020 92' 9-max Seat #9 is the button
Seat 2: zugmoraes (6850793 in chips) 
Seat 7: reijomo (6101638 in chips) 
Seat 9: jareth3542 (5547569 in chips) 
zugmoraes: posts the ante 21000
reijomo: posts the ante 21000
jareth3542: posts the ante 21000
zugmoraes: posts small blind 70000
reijomo: posts big blind 140000
*** HOLE CARDS ***
jareth3542: raises 140000 to 280000
zugmoraes: calls 210000
reijomo: calls 140000
*** FLOP *** [Js As 8d]
zugmoraes: checks 
reijomo: checks 
jareth3542: checks 
*** TURN *** [Js As 8d] [9d]
zugmoraes: checks 
reijomo: checks 
jareth3542 has timed out
jareth3542: checks 
*** RIVER *** [Js As 8d 9d] [Kh]
zugmoraes: checks 
reijomo: checks 
jareth3542: checks 
*** SHOW DOWN ***
zugmoraes: shows [Qc Kc] (a pair of Kings)
reijomo: mucks hand 
jareth3542: mucks hand 
zugmoraes collected 903000 from pot
*** SUMMARY ***
Total pot 903000 | Rake 0 
Board [Js As 8d 9d Kh]
Seat 2: zugmoraes (small blind) showed [Qc Kc] and won (903000) with a pair of Kings
Seat 7: reijomo (big blind) mucked
Seat 9: jareth3542 (button) mucked



PokerStars Hand #157573525957: Tournament #1641817020, $7.50+$7.50+$1.50 USD Hold'em No Limit - Level LV (80000/160000) - 2016/08/21 17:53:11 ET
Table '1641817020 92' 9-max Seat #2 is the button
Seat 2: zugmoraes (7452793 in chips) 
Seat 7: reijomo (5800638 in chips) 
Seat 9: jareth3542 (5246569 in chips) 
zugmoraes: posts the ante 24000
reijomo: posts the ante 24000
jareth3542: posts the ante 24000
reijomo: posts small blind 80000
jareth3542: posts big blind 160000
*** HOLE CARDS ***
zugmoraes: folds 
reijomo: calls 80000
jareth3542: raises 240000 to 400000
reijomo: folds 
Uncalled bet (240000) returned to jareth3542
jareth3542 collected 392000 from pot
*** SUMMARY ***
Total pot 392000 | Rake 0 
Seat 2: zugmoraes (button) folded before Flop (didn't bet)
Seat 7: reijomo (small blind) folded before Flop
Seat 9: jareth3542 (big blind) collected (392000)



PokerStars Hand #157573536638: Tournament #1641817020, $7.50+$7.50+$1.50 USD Hold'em No Limit - Level LV (80000/160000) - 2016/08/21 17:53:25 ET
Table '1641817020 92' 9-max Seat #7 is the button
Seat 2: zugmoraes (7428793 in chips) 
Seat 7: reijomo (5616638 in chips) 
Seat 9: jareth3542 (5454569 in chips) 
zugmoraes: posts the ante 24000
reijomo: posts the ante 24000
jareth3542: posts the ante 24000
jareth3542: posts small blind 80000
zugmoraes: posts big blind 160000
*** HOLE CARDS ***
reijomo: folds 
jareth3542: calls 80000
zugmoraes: checks 
*** FLOP *** [Jc 4c Qc]
jareth3542: bets 160000
zugmoraes: folds 
Uncalled bet (160000) returned to jareth3542
jareth3542 collected 392000 from pot
*** SUMMARY ***
Total pot 392000 | Rake 0 
Board [Jc 4c Qc]
Seat 2: zugmoraes (big blind) folded on the Flop
Seat 7: reijomo (button) folded before Flop (didn't bet)
Seat 9: jareth3542 (small blind) collected (392000)



PokerStars Hand #157573557913: Tournament #1641817020, $7.50+$7.50+$1.50 USD Hold'em No Limit - Level LV (80000/160000) - 2016/08/21 17:53:54 ET
Table '1641817020 92' 9-max Seat #9 is the button
Seat 2: zugmoraes (7244793 in chips) 
Seat 7: reijomo (5592638 in chips) 
Seat 9: jareth3542 (5662569 in chips) 
zugmoraes: posts the ante 24000
reijomo: posts the ante 24000
jareth3542: posts the ante 24000
zugmoraes: posts small blind 80000
reijomo: posts big blind 160000
*** HOLE CARDS ***
jareth3542: raises 160000 to 320000
zugmoraes: calls 240000
reijomo: raises 650000 to 970000
jareth3542: folds 
zugmoraes: calls 650000
*** FLOP *** [8c 6s 4c]
zugmoraes: checks 
reijomo: checks 
*** TURN *** [8c 6s 4c] [Kd]
zugmoraes: checks 
reijomo: bets 979440
zugmoraes: calls 979440
*** RIVER *** [8c 6s 4c Kd] [2c]
zugmoraes: checks 
reijomo: bets 3619198 and is all-in
zugmoraes: calls 3619198
*** SHOW DOWN ***
reijomo: shows [8h 8s] (three of a kind, Eights)
zugmoraes: shows [Kh Qh] (a pair of Kings)
reijomo collected 11529276 from pot
*** SUMMARY ***
Total pot 11529276 | Rake 0 
Board [8c 6s 4c Kd 2c]
Seat 2: zugmoraes (small blind) showed [Kh Qh] and lost with a pair of Kings
Seat 7: reijomo (big blind) showed [8h 8s] and won (11529276) with three of a kind, Eights
Seat 9: jareth3542 (button) folded before Flop



PokerStars Hand #157573819676: Tournament #1641817020, $7.50+$7.50+$1.50 USD Hold'em No Limit - Level LV (80000/160000) - 2016/08/21 18:01:10 ET
Table '1641817020 92' 9-max Seat #2 is the button
Seat 2: zugmoraes (1652155 in chips) 
Seat 7: reijomo (11529276 in chips) 
Seat 9: jareth3542 (5318569 in chips) 
All players have agreed to skip the break. Game resuming.
zugmoraes: posts the ante 24000
reijomo: posts the ante 24000
jareth3542: posts the ante 24000
reijomo: posts small blind 80000
jareth3542: posts big blind 160000
*** HOLE CARDS ***
zugmoraes: raises 1468155 to 1628155 and is all-in
reijomo: folds 
jareth3542: folds 
Uncalled bet (1468155) returned to zugmoraes
zugmoraes collected 472000 from pot
zugmoraes: doesn't show hand 
*** SUMMARY ***
Total pot 472000 | Rake 0 
Seat 2: zugmoraes (button) collected (472000)
Seat 7: reijomo (small blind) folded before Flop
Seat 9: jareth3542 (big blind) folded before Flop



PokerStars Hand #157573829138: Tournament #1641817020, $7.50+$7.50+$1.50 USD Hold'em No Limit - Level LV (80000/160000) - 2016/08/21 18:01:24 ET
Table '1641817020 92' 9-max Seat #7 is the button
Seat 2: zugmoraes (1940155 in chips) 
Seat 7: reijomo (11425276 in chips) 
Seat 9: jareth3542 (5134569 in chips) 
zugmoraes: posts the ante 24000
reijomo: posts the ante 24000
jareth3542: posts the ante 24000
jareth3542: posts small blind 80000
zugmoraes: posts big blind 160000
*** HOLE CARDS ***
reijomo: raises 176000 to 336000
jareth3542: raises 4774569 to 5110569 and is all-in
zugmoraes: folds 
reijomo: folds 
Uncalled bet (4774569) returned to jareth3542
jareth3542 collected 904000 from pot
*** SUMMARY ***
Total pot 904000 | Rake 0 
Seat 2: zugmoraes (big blind) folded before Flop
Seat 7: reijomo (button) folded before Flop
Seat 9: jareth3542 (small blind) collected (904000)



PokerStars Hand #157573847112: Tournament #1641817020, $7.50+$7.50+$1.50 USD Hold'em No Limit - Level LV (80000/160000) - 2016/08/21 18:01:50 ET
Table '1641817020 92' 9-max Seat #9 is the button
Seat 2: zugmoraes (1756155 in chips) 
Seat 7: reijomo (11065276 in chips) 
Seat 9: jareth3542 (5678569 in chips) 
zugmoraes: posts the ante 24000
reijomo: posts the ante 24000
jareth3542: posts the ante 24000
zugmoraes: posts small blind 80000
reijomo: posts big blind 160000
*** HOLE CARDS ***
jareth3542: raises 160000 to 320000
zugmoraes: folds 
reijomo: calls 160000
*** FLOP *** [2c 8c Qc]
reijomo: checks 
jareth3542: checks 
*** TURN *** [2c 8c Qc] [Ks]
reijomo: bets 800000
jareth3542: calls 800000
*** RIVER *** [2c 8c Qc Ks] [Jc]
reijomo: bets 1196000
jareth3542: raises 1196000 to 2392000
reijomo said, ":("
reijomo said, "show bluff"
reijomo: folds [Kc]
Uncalled bet (1196000) returned to jareth3542
jareth3542 collected 4784000 from pot
*** SUMMARY ***
Total pot 4784000 | Rake 0 
Board [2c 8c Qc Ks Jc]
Seat 2: zugmoraes (small blind) folded before Flop
Seat 7: reijomo (big blind) folded on the River
Seat 9: jareth3542 (button) collected (4784000)



PokerStars Hand #157573915199: Tournament #1641817020, $7.50+$7.50+$1.50 USD Hold'em No Limit - Level LV (80000/160000) - 2016/08/21 18:03:27 ET
Table '1641817020 92' 9-max Seat #2 is the button
Seat 2: zugmoraes (1652155 in chips) 
Seat 7: reijomo (8725276 in chips) 
Seat 9: jareth3542 (8122569 in chips) 
zugmoraes: posts the ante 24000
reijomo: posts the ante 24000
jareth3542: posts the ante 24000
reijomo: posts small blind 80000
jareth3542: posts big blind 160000
*** HOLE CARDS ***
zugmoraes: raises 1468155 to 1628155 and is all-in
reijomo: calls 1548155
jareth3542: folds 
*** FLOP *** [9s Kh Th]
*** TURN *** [9s Kh Th] [Qc]
*** RIVER *** [9s Kh Th Qc] [7c]
*** SHOW DOWN ***
reijomo: shows [As 8c] (high card Ace)
zugmoraes: shows [Ad Jd] (a straight, Ten to Ace)
zugmoraes collected 3488310 from pot
*** SUMMARY ***
Total pot 3488310 | Rake 0 
Board [9s Kh Th Qc 7c]
Seat 2: zugmoraes (button) showed [Ad Jd] and won (3488310) with a straight, Ten to Ace
Seat 7: reijomo (small blind) showed [As 8c] and lost with high card Ace
Seat 9: jareth3542 (big blind) folded before Flop



PokerStars Hand #157573929952: Tournament #1641817020, $7.50+$7.50+$1.50 USD Hold'em No Limit - Level LV (80000/160000) - 2016/08/21 18:03:48 ET
Table '1641817020 92' 9-max Seat #7 is the button
Seat 2: zugmoraes (3488310 in chips) 
Seat 7: reijomo (7073121 in chips) 
Seat 9: jareth3542 (7938569 in chips) 
zugmoraes: posts the ante 24000
reijomo: posts the ante 24000
jareth3542: posts the ante 24000
jareth3542: posts small blind 80000
zugmoraes: posts big blind 160000
*** HOLE CARDS ***
reijomo: raises 176000 to 336000
jareth3542: calls 256000
zugmoraes: folds 
*** FLOP *** [Jd 2h Qs]
jareth3542: checks 
reijomo: checks 
*** TURN *** [Jd 2h Qs] [4s]
jareth3542: checks 
reijomo: checks 
*** RIVER *** [Jd 2h Qs 4s] [Tc]
jareth3542: bets 1040000
reijomo: raises 1520000 to 2560000
jareth3542: calls 1520000
*** SHOW DOWN ***
reijomo: shows [As Kh] (a straight, Ten to Ace)
jareth3542: mucks hand 
reijomo collected 6024000 from pot
*** SUMMARY ***
Total pot 6024000 | Rake 0 
Board [Jd 2h Qs 4s Tc]
Seat 2: zugmoraes (big blind) folded before Flop
Seat 7: reijomo (button) showed [As Kh] and won (6024000) with a straight, Ten to Ace
Seat 9: jareth3542 (small blind) mucked



PokerStars Hand #157573982509: Tournament #1641817020, $7.50+$7.50+$1.50 USD Hold'em No Limit - Level LV (80000/160000) - 2016/08/21 18:05:02 ET
Table '1641817020 92' 9-max Seat #9 is the button
Seat 2: zugmoraes (3304310 in chips) 
Seat 7: reijomo (10177121 in chips) 
Seat 9: jareth3542 (5018569 in chips) 
zugmoraes: posts the ante 24000
reijomo: posts the ante 24000
jareth3542: posts the ante 24000
zugmoraes: posts small blind 80000
reijomo: posts big blind 160000
*** HOLE CARDS ***
jareth3542: raises 160000 to 320000
zugmoraes: folds 
reijomo: folds 
Uncalled bet (160000) returned to jareth3542
jareth3542 collected 472000 from pot
*** SUMMARY ***
Total pot 472000 | Rake 0 
Seat 2: zugmoraes (small blind) folded before Flop
Seat 7: reijomo (big blind) folded before Flop
Seat 9: jareth3542 (button) collected (472000)



PokerStars Hand #157573999343: Tournament #1641817020, $7.50+$7.50+$1.50 USD Hold'em No Limit - Level LV (80000/160000) - 2016/08/21 18:05:25 ET
Table '1641817020 92' 9-max Seat #2 is the button
Seat 2: zugmoraes (3200310 in chips) 
Seat 7: reijomo (9993121 in chips) 
Seat 9: jareth3542 (5306569 in chips) 
zugmoraes: posts the ante 24000
reijomo: posts the ante 24000
jareth3542: posts the ante 24000
reijomo: posts small blind 80000
jareth3542: posts big blind 160000
*** HOLE CARDS ***
zugmoraes: raises 208000 to 368000
reijomo: raises 632000 to 1000000
jareth3542: folds 
zugmoraes: calls 632000
*** FLOP *** [5s 5c Ts]
reijomo: bets 650000
zugmoraes: folds 
Uncalled bet (650000) returned to reijomo
reijomo collected 2232000 from pot
*** SUMMARY ***
Total pot 2232000 | Rake 0 
Board [5s 5c Ts]
Seat 2: zugmoraes (button) folded on the Flop
Seat 7: reijomo (small blind) collected (2232000)
Seat 9: jareth3542 (big blind) folded before Flop



PokerStars Hand #157574061378: Tournament #1641817020, $7.50+$7.50+$1.50 USD Hold'em No Limit - Level LV (80000/160000) - 2016/08/21 18:06:53 ET
Table '1641817020 92' 9-max Seat #7 is the button
Seat 2: zugmoraes (2176310 in chips) 
Seat 7: reijomo (11201121 in chips) 
Seat 9: jareth3542 (5122569 in chips) 
zugmoraes: posts the ante 24000
reijomo: posts the ante 24000
jareth3542: posts the ante 24000
jareth3542: posts small blind 80000
zugmoraes: posts big blind 160000
*** HOLE CARDS ***
reijomo: folds 
jareth3542: calls 80000
zugmoraes: checks 
*** FLOP *** [4d Th 3s]
jareth3542: bets 160000
zugmoraes: calls 160000
*** TURN *** [4d Th 3s] [6c]
jareth3542: bets 320000
zugmoraes: folds 
Uncalled bet (320000) returned to jareth3542
jareth3542 collected 712000 from pot
*** SUMMARY ***
Total pot 712000 | Rake 0 
Board [4d Th 3s 6c]
Seat 2: zugmoraes (big blind) folded on the Turn
Seat 7: reijomo (button) folded before Flop (didn't bet)
Seat 9: jareth3542 (small blind) collected (712000)



PokerStars Hand #157574119416: Tournament #1641817020, $7.50+$7.50+$1.50 USD Hold'em No Limit - Level LVI (90000/180000) - 2016/08/21 18:08:00 ET
Table '1641817020 92' 9-max Seat #9 is the button
Seat 2: zugmoraes (1832310 in chips) 
Seat 7: reijomo (11177121 in chips) 
Seat 9: jareth3542 (5490569 in chips) 
zugmoraes: posts the ante 27000
reijomo: posts the ante 27000
jareth3542: posts the ante 27000
zugmoraes: posts small blind 90000
reijomo: posts big blind 180000
*** HOLE CARDS ***
jareth3542: raises 180000 to 360000
zugmoraes: raises 1445310 to 1805310 and is all-in
reijomo: folds 
jareth3542 has timed out
jareth3542: folds 
Uncalled bet (1445310) returned to zugmoraes
jareth3542 is sitting out
zugmoraes collected 981000 from pot
*** SUMMARY ***
Total pot 981000 | Rake 0 
Seat 2: zugmoraes (small blind) collected (981000)
Seat 7: reijomo (big blind) folded before Flop
Seat 9: jareth3542 (button) folded before Flop



PokerStars Hand #157574149230: Tournament #1641817020, $7.50+$7.50+$1.50 USD Hold'em No Limit - Level LVI (90000/180000) - 2016/08/21 18:08:39 ET
Table '1641817020 92' 9-max Seat #2 is the button
Seat 2: zugmoraes (2426310 in chips) 
Seat 7: reijomo (10970121 in chips) 
Seat 9: jareth3542 (5103569 in chips) is sitting out
zugmoraes: posts the ante 27000
reijomo: posts the ante 27000
jareth3542: posts the ante 27000
reijomo: posts small blind 90000
jareth3542: posts big blind 180000
*** HOLE CARDS ***
jareth3542 has returned
zugmoraes: folds 
reijomo: calls 90000
jareth3542: checks 
*** FLOP *** [5d Ts 7h]
reijomo: bets 185220
jareth3542: folds 
Uncalled bet (185220) returned to reijomo
reijomo collected 441000 from pot
*** SUMMARY ***
Total pot 441000 | Rake 0 
Board [5d Ts 7h]
Seat 2: zugmoraes (button) folded before Flop (didn't bet)
Seat 7: reijomo (small blind) collected (441000)
Seat 9: jareth3542 (big blind) folded on the Flop



PokerStars Hand #157574175073: Tournament #1641817020, $7.50+$7.50+$1.50 USD Hold'em No Limit - Level LVI (90000/180000) - 2016/08/21 18:09:12 ET
Table '1641817020 92' 9-max Seat #7 is the button
Seat 2: zugmoraes (2399310 in chips) 
Seat 7: reijomo (11204121 in chips) 
Seat 9: jareth3542 (4896569 in chips) 
zugmoraes: posts the ante 27000
reijomo: posts the ante 27000
jareth3542: posts the ante 27000
jareth3542: posts small blind 90000
zugmoraes: posts big blind 180000
*** HOLE CARDS ***
reijomo: calls 180000
jareth3542: folds 
zugmoraes: checks 
*** FLOP *** [Jc 4h 7d]
zugmoraes: checks 
reijomo: bets 190000
zugmoraes: folds 
Uncalled bet (190000) returned to reijomo
reijomo collected 531000 from pot
*** SUMMARY ***
Total pot 531000 | Rake 0 
Board [Jc 4h 7d]
Seat 2: zugmoraes (big blind) folded on the Flop
Seat 7: reijomo (button) collected (531000)
Seat 9: jareth3542 (small blind) folded before Flop



PokerStars Hand #157574200557: Tournament #1641817020, $7.50+$7.50+$1.50 USD Hold'em No Limit - Level LVI (90000/180000) - 2016/08/21 18:09:45 ET
Table '1641817020 92' 9-max Seat #9 is the button
Seat 2: zugmoraes (2192310 in chips) 
Seat 7: reijomo (11528121 in chips) 
Seat 9: jareth3542 (4779569 in chips) 
zugmoraes: posts the ante 27000
reijomo: posts the ante 27000
jareth3542: posts the ante 27000
zugmoraes: posts small blind 90000
reijomo: posts big blind 180000
*** HOLE CARDS ***
jareth3542: raises 180000 to 360000
zugmoraes: folds 
reijomo: calls 180000
*** FLOP *** [Qc Ah 3h]
reijomo: checks 
jareth3542: bets 360000
reijomo: folds 
Uncalled bet (360000) returned to jareth3542
jareth3542 collected 891000 from pot
*** SUMMARY ***
Total pot 891000 | Rake 0 
Board [Qc Ah 3h]
Seat 2: zugmoraes (small blind) folded before Flop
Seat 7: reijomo (big blind) folded on the Flop
Seat 9: jareth3542 (button) collected (891000)



PokerStars Hand #157574218708: Tournament #1641817020, $7.50+$7.50+$1.50 USD Hold'em No Limit - Level LVI (90000/180000) - 2016/08/21 18:10:09 ET
Table '1641817020 92' 9-max Seat #2 is the button
Seat 2: zugmoraes (2075310 in chips) 
Seat 7: reijomo (11141121 in chips) 
Seat 9: jareth3542 (5283569 in chips) 
zugmoraes: posts the ante 27000
reijomo: posts the ante 27000
jareth3542: posts the ante 27000
reijomo: posts small blind 90000
jareth3542: posts big blind 180000
*** HOLE CARDS ***
zugmoraes: folds 
reijomo: calls 90000
jareth3542: raises 270000 to 450000
reijomo: raises 725000 to 1175000
jareth3542: folds 
Uncalled bet (725000) returned to reijomo
reijomo collected 981000 from pot
*** SUMMARY ***
Total pot 981000 | Rake 0 
Seat 2: zugmoraes (button) folded before Flop (didn't bet)
Seat 7: reijomo (small blind) collected (981000)
Seat 9: jareth3542 (big blind) folded before Flop



PokerStars Hand #157574251631: Tournament #1641817020, $7.50+$7.50+$1.50 USD Hold'em No Limit - Level LVI (90000/180000) - 2016/08/21 18:10:53 ET
Table '1641817020 92' 9-max Seat #7 is the button
Seat 2: zugmoraes (2048310 in chips) 
Seat 7: reijomo (11645121 in chips) 
Seat 9: jareth3542 (4806569 in chips) 
zugmoraes: posts the ante 27000
reijomo: posts the ante 27000
jareth3542: posts the ante 27000
jareth3542: posts small blind 90000
zugmoraes: posts big blind 180000
*** HOLE CARDS ***
reijomo: folds 
jareth3542: raises 4599569 to 4779569 and is all-in
zugmoraes: folds 
Uncalled bet (4599569) returned to jareth3542
jareth3542 collected 441000 from pot
*** SUMMARY ***
Total pot 441000 | Rake 0 
Seat 2: zugmoraes (big blind) folded before Flop
Seat 7: reijomo (button) folded before Flop (didn't bet)
Seat 9: jareth3542 (small blind) collected (441000)



PokerStars Hand #157574260839: Tournament #1641817020, $7.50+$7.50+$1.50 USD Hold'em No Limit - Level LVI (90000/180000) - 2016/08/21 18:11:05 ET
Table '1641817020 92' 9-max Seat #9 is the button
Seat 2: zugmoraes (1841310 in chips) 
Seat 7: reijomo (11618121 in chips) 
Seat 9: jareth3542 (5040569 in chips) 
zugmoraes: posts the ante 27000
reijomo: posts the ante 27000
jareth3542: posts the ante 27000
zugmoraes: posts small blind 90000
reijomo: posts big blind 180000
*** HOLE CARDS ***
jareth3542: raises 180000 to 360000
zugmoraes: raises 1454310 to 1814310 and is all-in
reijomo: folds 
jareth3542: folds 
Uncalled bet (1454310) returned to zugmoraes
zugmoraes collected 981000 from pot
*** SUMMARY ***
Total pot 981000 | Rake 0 
Seat 2: zugmoraes (small blind) collected (981000)
Seat 7: reijomo (big blind) folded before Flop
Seat 9: jareth3542 (button) folded before Flop



PokerStars Hand #157574279241: Tournament #1641817020, $7.50+$7.50+$1.50 USD Hold'em No Limit - Level LVI (90000/180000) - 2016/08/21 18:11:29 ET
Table '1641817020 92' 9-max Seat #2 is the button
Seat 2: zugmoraes (2435310 in chips) 
Seat 7: reijomo (11411121 in chips) 
Seat 9: jareth3542 (4653569 in chips) 
zugmoraes: posts the ante 27000
reijomo: posts the ante 27000
jareth3542: posts the ante 27000
reijomo: posts small blind 90000
jareth3542: posts big blind 180000
*** HOLE CARDS ***
zugmoraes: folds 
reijomo: folds 
Uncalled bet (90000) returned to jareth3542
jareth3542 collected 261000 from pot
*** SUMMARY ***
Total pot 261000 | Rake 0 
Seat 2: zugmoraes (button) folded before Flop (didn't bet)
Seat 7: reijomo (small blind) folded before Flop
Seat 9: jareth3542 (big blind) collected (261000)



PokerStars Hand #157574284849: Tournament #1641817020, $7.50+$7.50+$1.50 USD Hold'em No Limit - Level LVI (90000/180000) - 2016/08/21 18:11:37 ET
Table '1641817020 92' 9-max Seat #7 is the button
Seat 2: zugmoraes (2408310 in chips) 
Seat 7: reijomo (11294121 in chips) 
Seat 9: jareth3542 (4797569 in chips) 
zugmoraes: posts the ante 27000
reijomo: posts the ante 27000
jareth3542: posts the ante 27000
jareth3542: posts small blind 90000
zugmoraes: posts big blind 180000
*** HOLE CARDS ***
reijomo: raises 198000 to 378000
jareth3542: folds 
zugmoraes: calls 198000
*** FLOP *** [Ah 8c 6c]
zugmoraes: checks 
reijomo: bets 305910
zugmoraes: folds 
Uncalled bet (305910) returned to reijomo
reijomo collected 927000 from pot
*** SUMMARY ***
Total pot 927000 | Rake 0 
Board [Ah 8c 6c]
Seat 2: zugmoraes (big blind) folded on the Flop
Seat 7: reijomo (button) collected (927000)
Seat 9: jareth3542 (small blind) folded before Flop



PokerStars Hand #157574320191: Tournament #1641817020, $7.50+$7.50+$1.50 USD Hold'em No Limit - Level LVI (90000/180000) - 2016/08/21 18:12:23 ET
Table '1641817020 92' 9-max Seat #9 is the button
Seat 2: zugmoraes (2003310 in chips) 
Seat 7: reijomo (11816121 in chips) 
Seat 9: jareth3542 (4680569 in chips) 
zugmoraes: posts the ante 27000
reijomo: posts the ante 27000
jareth3542: posts the ante 27000
zugmoraes: posts small blind 90000
reijomo: posts big blind 180000
*** HOLE CARDS ***
jareth3542: folds 
zugmoraes: raises 1796310 to 1976310 and is all-in
reijomo: folds 
Uncalled bet (1796310) returned to zugmoraes
zugmoraes collected 441000 from pot
zugmoraes: doesn't show hand 
*** SUMMARY ***
Total pot 441000 | Rake 0 
Seat 2: zugmoraes (small blind) collected (441000)
Seat 7: reijomo (big blind) folded before Flop
Seat 9: jareth3542 (button) folded before Flop (didn't bet)



PokerStars Hand #157574328520: Tournament #1641817020, $7.50+$7.50+$1.50 USD Hold'em No Limit - Level LVI (90000/180000) - 2016/08/21 18:12:35 ET
Table '1641817020 92' 9-max Seat #2 is the button
Seat 2: zugmoraes (2237310 in chips) 
Seat 7: reijomo (11609121 in chips) 
Seat 9: jareth3542 (4653569 in chips) 
zugmoraes: posts the ante 27000
reijomo: posts the ante 27000
jareth3542: posts the ante 27000
reijomo: posts small blind 90000
jareth3542: posts big blind 180000
*** HOLE CARDS ***
zugmoraes: folds 
reijomo: calls 90000
jareth3542: checks 
*** FLOP *** [6d 5s 9s]
reijomo: bets 185220
jareth3542: raises 264780 to 450000
reijomo: folds 
Uncalled bet (264780) returned to jareth3542
jareth3542 collected 811440 from pot
*** SUMMARY ***
Total pot 811440 | Rake 0 
Board [6d 5s 9s]
Seat 2: zugmoraes (button) folded before Flop (didn't bet)
Seat 7: reijomo (small blind) folded on the Flop
Seat 9: jareth3542 (big blind) collected (811440)



PokerStars Hand #157574351177: Tournament #1641817020, $7.50+$7.50+$1.50 USD Hold'em No Limit - Level LVI (90000/180000) - 2016/08/21 18:13:05 ET
Table '1641817020 92' 9-max Seat #7 is the button
Seat 2: zugmoraes (2210310 in chips) 
Seat 7: reijomo (11216901 in chips) 
Seat 9: jareth3542 (5072789 in chips) 
zugmoraes: posts the ante 27000
reijomo: posts the ante 27000
jareth3542: posts the ante 27000
jareth3542: posts small blind 90000
zugmoraes: posts big blind 180000
*** HOLE CARDS ***
reijomo: folds 
jareth3542: calls 90000
zugmoraes: raises 234000 to 414000
jareth3542: folds 
Uncalled bet (234000) returned to zugmoraes
zugmoraes collected 441000 from pot
*** SUMMARY ***
Total pot 441000 | Rake 0 
Seat 2: zugmoraes (big blind) collected (441000)
Seat 7: reijomo (button) folded before Flop (didn't bet)
Seat 9: jareth3542 (small blind) folded before Flop



PokerStars Hand #157574369484: Tournament #1641817020, $7.50+$7.50+$1.50 USD Hold'em No Limit - Level LVI (90000/180000) - 2016/08/21 18:13:29 ET
Table '1641817020 92' 9-max Seat #9 is the button
Seat 2: zugmoraes (2444310 in chips) 
Seat 7: reijomo (11189901 in chips) 
Seat 9: jareth3542 (4865789 in chips) 
zugmoraes: posts the ante 27000
reijomo: posts the ante 27000
jareth3542: posts the ante 27000
zugmoraes: posts small blind 90000
reijomo: posts big blind 180000
*** HOLE CARDS ***
jareth3542: calls 180000
zugmoraes: folds 
reijomo: checks 
*** FLOP *** [Ad Ks 4c]
reijomo: checks 
jareth3542: bets 180000
reijomo: folds 
Uncalled bet (180000) returned to jareth3542
jareth3542 collected 531000 from pot
*** SUMMARY ***
Total pot 531000 | Rake 0 
Board [Ad Ks 4c]
Seat 2: zugmoraes (small blind) folded before Flop
Seat 7: reijomo (big blind) folded on the Flop
Seat 9: jareth3542 (button) collected (531000)



PokerStars Hand #157574384526: Tournament #1641817020, $7.50+$7.50+$1.50 USD Hold'em No Limit - Level LVI (90000/180000) - 2016/08/21 18:13:50 ET
Table '1641817020 92' 9-max Seat #2 is the button
Seat 2: zugmoraes (2327310 in chips) 
Seat 7: reijomo (10982901 in chips) 
Seat 9: jareth3542 (5189789 in chips) 
zugmoraes: posts the ante 27000
reijomo: posts the ante 27000
jareth3542: posts the ante 27000
reijomo: posts small blind 90000
jareth3542: posts big blind 180000
*** HOLE CARDS ***
zugmoraes: raises 234000 to 414000
reijomo: folds 
jareth3542: folds 
Uncalled bet (234000) returned to zugmoraes
zugmoraes collected 531000 from pot
zugmoraes: doesn't show hand 
*** SUMMARY ***
Total pot 531000 | Rake 0 
Seat 2: zugmoraes (button) collected (531000)
Seat 7: reijomo (small blind) folded before Flop
Seat 9: jareth3542 (big blind) folded before Flop



PokerStars Hand #157574413241: Tournament #1641817020, $7.50+$7.50+$1.50 USD Hold'em No Limit - Level LVI (90000/180000) - 2016/08/21 18:14:28 ET
Table '1641817020 92' 9-max Seat #7 is the button
Seat 2: zugmoraes (2651310 in chips) 
Seat 7: reijomo (10865901 in chips) 
Seat 9: jareth3542 (4982789 in chips) 
zugmoraes: posts the ante 27000
reijomo: posts the ante 27000
jareth3542: posts the ante 27000
jareth3542: posts small blind 90000
zugmoraes: posts big blind 180000
*** HOLE CARDS ***
reijomo: raises 198000 to 378000
jareth3542: folds 
zugmoraes: folds 
Uncalled bet (198000) returned to reijomo
reijomo collected 531000 from pot
*** SUMMARY ***
Total pot 531000 | Rake 0 
Seat 2: zugmoraes (big blind) folded before Flop
Seat 7: reijomo (button) collected (531000)
Seat 9: jareth3542 (small blind) folded before Flop



PokerStars Hand #157574424693: Tournament #1641817020, $7.50+$7.50+$1.50 USD Hold'em No Limit - Level LVI (90000/180000) - 2016/08/21 18:14:44 ET
Table '1641817020 92' 9-max Seat #9 is the button
Seat 2: zugmoraes (2444310 in chips) 
Seat 7: reijomo (11189901 in chips) 
Seat 9: jareth3542 (4865789 in chips) 
zugmoraes: posts the ante 27000
reijomo: posts the ante 27000
jareth3542: posts the ante 27000
zugmoraes: posts small blind 90000
reijomo: posts big blind 180000
*** HOLE CARDS ***
jareth3542: folds 
zugmoraes: calls 90000
reijomo: checks 
*** FLOP *** [Kc Jd 9c]
zugmoraes: bets 180000
reijomo: calls 180000
*** TURN *** [Kc Jd 9c] [As]
zugmoraes: bets 394430
reijomo: calls 394430
*** RIVER *** [Kc Jd 9c As] [2s]
zugmoraes: bets 1662880 and is all-in
reijomo: folds 
Uncalled bet (1662880) returned to zugmoraes
zugmoraes collected 1589860 from pot
zugmoraes: doesn't show hand 
*** SUMMARY ***
Total pot 1589860 | Rake 0 
Board [Kc Jd 9c As 2s]
Seat 2: zugmoraes (small blind) collected (1589860)
Seat 7: reijomo (big blind) folded on the River
Seat 9: jareth3542 (button) folded before Flop (didn't bet)



PokerStars Hand #157574488911: Tournament #1641817020, $7.50+$7.50+$1.50 USD Hold'em No Limit - Level LVI (90000/180000) - 2016/08/21 18:16:14 ET
Table '1641817020 92' 9-max Seat #2 is the button
Seat 2: zugmoraes (3252740 in chips) 
Seat 7: reijomo (10408471 in chips) 
Seat 9: jareth3542 (4838789 in chips) 
zugmoraes: posts the ante 27000
reijomo: posts the ante 27000
jareth3542: posts the ante 27000
reijomo: posts small blind 90000
jareth3542: posts big blind 180000
*** HOLE CARDS ***
zugmoraes: folds 
reijomo: calls 90000
jareth3542: checks 
*** FLOP *** [7c 3h 2s]
reijomo: checks 
jareth3542: bets 270000
reijomo: folds 
Uncalled bet (270000) returned to jareth3542
jareth3542 collected 441000 from pot
*** SUMMARY ***
Total pot 441000 | Rake 0 
Board [7c 3h 2s]
Seat 2: zugmoraes (button) folded before Flop (didn't bet)
Seat 7: reijomo (small blind) folded on the Flop
Seat 9: jareth3542 (big blind) collected (441000)



PokerStars Hand #157574505154: Tournament #1641817020, $7.50+$7.50+$1.50 USD Hold'em No Limit - Level LVI (90000/180000) - 2016/08/21 18:16:36 ET
Table '1641817020 92' 9-max Seat #7 is the button
Seat 2: zugmoraes (3225740 in chips) 
Seat 7: reijomo (10201471 in chips) 
Seat 9: jareth3542 (5072789 in chips) 
zugmoraes: posts the ante 27000
reijomo: posts the ante 27000
jareth3542: posts the ante 27000
jareth3542: posts small blind 90000
zugmoraes: posts big blind 180000
*** HOLE CARDS ***
reijomo: folds 
jareth3542: calls 90000
zugmoraes: checks 
*** FLOP *** [Kh 7h 6s]
jareth3542: bets 180000
zugmoraes: folds 
Uncalled bet (180000) returned to jareth3542
jareth3542 collected 441000 from pot
*** SUMMARY ***
Total pot 441000 | Rake 0 
Board [Kh 7h 6s]
Seat 2: zugmoraes (big blind) folded on the Flop
Seat 7: reijomo (button) folded before Flop (didn't bet)
Seat 9: jareth3542 (small blind) collected (441000)



PokerStars Hand #157574526678: Tournament #1641817020, $7.50+$7.50+$1.50 USD Hold'em No Limit - Level LVI (90000/180000) - 2016/08/21 18:17:07 ET
Table '1641817020 92' 9-max Seat #9 is the button
Seat 2: zugmoraes (3018740 in chips) 
Seat 7: reijomo (10174471 in chips) 
Seat 9: jareth3542 (5306789 in chips) 
zugmoraes: posts the ante 27000
reijomo: posts the ante 27000
jareth3542: posts the ante 27000
zugmoraes: posts small blind 90000
reijomo: posts big blind 180000
*** HOLE CARDS ***
jareth3542: calls 180000
zugmoraes: calls 90000
reijomo: raises 486666 to 666666
jareth3542: folds 
zugmoraes: folds 
Uncalled bet (486666) returned to reijomo
reijomo collected 621000 from pot
*** SUMMARY ***
Total pot 621000 | Rake 0 
Seat 2: zugmoraes (small blind) folded before Flop
Seat 7: reijomo (big blind) collected (621000)
Seat 9: jareth3542 (button) folded before Flop



PokerStars Hand #157574551172: Tournament #1641817020, $7.50+$7.50+$1.50 USD Hold'em No Limit - Level LVI (90000/180000) - 2016/08/21 18:17:42 ET
Table '1641817020 92' 9-max Seat #2 is the button
Seat 2: zugmoraes (2811740 in chips) 
Seat 7: reijomo (10588471 in chips) 
Seat 9: jareth3542 (5099789 in chips) 
zugmoraes: posts the ante 27000
reijomo: posts the ante 27000
jareth3542: posts the ante 27000
reijomo: posts small blind 90000
jareth3542: posts big blind 180000
*** HOLE CARDS ***
zugmoraes: folds 
reijomo: calls 90000
jareth3542: checks 
*** FLOP *** [2h 9h 3d]
reijomo: bets 180000
jareth3542: folds 
Uncalled bet (180000) returned to reijomo
reijomo collected 441000 from pot
*** SUMMARY ***
Total pot 441000 | Rake 0 
Board [2h 9h 3d]
Seat 2: zugmoraes (button) folded before Flop (didn't bet)
Seat 7: reijomo (small blind) collected (441000)
Seat 9: jareth3542 (big blind) folded on the Flop



PokerStars Hand #157574571832: Tournament #1641817020, $7.50+$7.50+$1.50 USD Hold'em No Limit - Level LVII (100000/200000) - 2016/08/21 18:18:11 ET
Table '1641817020 92' 9-max Seat #7 is the button
Seat 2: zugmoraes (2784740 in chips) 
Seat 7: reijomo (10822471 in chips) 
Seat 9: jareth3542 (4892789 in chips) 
zugmoraes: posts the ante 30000
reijomo: posts the ante 30000
jareth3542: posts the ante 30000
jareth3542: posts small blind 100000
zugmoraes: posts big blind 200000
*** HOLE CARDS ***
reijomo: raises 220000 to 420000
jareth3542: folds 
zugmoraes: calls 220000
*** FLOP *** [Jc Kc Tc]
zugmoraes: checks 
reijomo: checks 
*** TURN *** [Jc Kc Tc] [5h]
zugmoraes: checks 
reijomo: bets 432600
zugmoraes: folds 
Uncalled bet (432600) returned to reijomo
reijomo collected 1030000 from pot
*** SUMMARY ***
Total pot 1030000 | Rake 0 
Board [Jc Kc Tc 5h]
Seat 2: zugmoraes (big blind) folded on the Turn
Seat 7: reijomo (button) collected (1030000)
Seat 9: jareth3542 (small blind) folded before Flop



PokerStars Hand #157574607800: Tournament #1641817020, $7.50+$7.50+$1.50 USD Hold'em No Limit - Level LVII (100000/200000) - 2016/08/21 18:19:02 ET
Table '1641817020 92' 9-max Seat #9 is the button
Seat 2: zugmoraes (2334740 in chips) 
Seat 7: reijomo (11402471 in chips) 
Seat 9: jareth3542 (4762789 in chips) 
zugmoraes: posts the ante 30000
reijomo: posts the ante 30000
jareth3542: posts the ante 30000
zugmoraes: posts small blind 100000
reijomo: posts big blind 200000
*** HOLE CARDS ***
jareth3542: raises 200000 to 400000
zugmoraes: folds 
reijomo: raises 900000 to 1300000
jareth3542: raises 3432789 to 4732789 and is all-in
reijomo: calls 3432789
*** FLOP *** [5s Tc 6c]
*** TURN *** [5s Tc 6c] [Ac]
*** RIVER *** [5s Tc 6c Ac] [9d]
*** SHOW DOWN ***
reijomo: shows [Ks As] (a pair of Aces)
jareth3542: shows [Jh Js] (a pair of Jacks)
reijomo collected 9655578 from pot
reijomo wins $291.26 for eliminating jareth3542 and their own bounty increases by $291.26 to $801.15
jareth3542 finished the tournament in 3rd place and received $1669.92.
*** SUMMARY ***
Total pot 9655578 | Rake 0 
Board [5s Tc 6c Ac 9d]
Seat 2: zugmoraes (small blind) folded before Flop
Seat 7: reijomo (big blind) showed [Ks As] and won (9655578) with a pair of Aces
Seat 9: jareth3542 (button) showed [Jh Js] and lost with a pair of Jacks



PokerStars Hand #157574644582: Tournament #1641817020, $7.50+$7.50+$1.50 USD Hold'em No Limit - Level LVII (100000/200000) - 2016/08/21 18:19:55 ET
Table '1641817020 92' 9-max Seat #2 is the button
Seat 2: zugmoraes (2204740 in chips) 
Seat 7: reijomo (16295260 in chips) 
zugmoraes: posts the ante 30000
reijomo: posts the ante 30000
zugmoraes: posts small blind 100000
reijomo: posts big blind 200000
*** HOLE CARDS ***
zugmoraes: folds 
Uncalled bet (100000) returned to reijomo
reijomo collected 260000 from pot
*** SUMMARY ***
Total pot 260000 | Rake 0 
Seat 2: zugmoraes (button) (small blind) folded before Flop
Seat 7: reijomo (big blind) collected (260000)



PokerStars Hand #157574651798: Tournament #1641817020, $7.50+$7.50+$1.50 USD Hold'em No Limit - Level LVII (100000/200000) - 2016/08/21 18:20:06 ET
Table '1641817020 92' 9-max Seat #7 is the button
Seat 2: zugmoraes (2074740 in chips) 
Seat 7: reijomo (16425260 in chips) 
zugmoraes: posts the ante 30000
reijomo: posts the ante 30000
reijomo: posts small blind 100000
zugmoraes: posts big blind 200000
*** HOLE CARDS ***
reijomo: calls 100000
zugmoraes: checks 
*** FLOP *** [8h Ac 3h]
zugmoraes: checks 
reijomo: bets 200000
zugmoraes: folds 
Uncalled bet (200000) returned to reijomo
reijomo collected 460000 from pot
*** SUMMARY ***
Total pot 460000 | Rake 0 
Board [8h Ac 3h]
Seat 2: zugmoraes (big blind) folded on the Flop
Seat 7: reijomo (button) (small blind) collected (460000)



PokerStars Hand #157574669701: Tournament #1641817020, $7.50+$7.50+$1.50 USD Hold'em No Limit - Level LVII (100000/200000) - 2016/08/21 18:20:32 ET
Table '1641817020 92' 9-max Seat #2 is the button
Seat 2: zugmoraes (1844740 in chips) 
Seat 7: reijomo (16655260 in chips) 
zugmoraes: posts the ante 30000
reijomo: posts the ante 30000
zugmoraes: posts small blind 100000
reijomo: posts big blind 200000
*** HOLE CARDS ***
zugmoraes: folds 
Uncalled bet (100000) returned to reijomo
reijomo collected 260000 from pot
*** SUMMARY ***
Total pot 260000 | Rake 0 
Seat 2: zugmoraes (button) (small blind) folded before Flop
Seat 7: reijomo (big blind) collected (260000)



PokerStars Hand #157574682199: Tournament #1641817020, $7.50+$7.50+$1.50 USD Hold'em No Limit - Level LVII (100000/200000) - 2016/08/21 18:20:50 ET
Table '1641817020 92' 9-max Seat #7 is the button
Seat 2: zugmoraes (1714740 in chips) 
Seat 7: reijomo (16785260 in chips) 
zugmoraes: posts the ante 30000
reijomo: posts the ante 30000
reijomo: posts small blind 100000
zugmoraes: posts big blind 200000
*** HOLE CARDS ***
reijomo: folds 
Uncalled bet (100000) returned to zugmoraes
zugmoraes collected 260000 from pot
*** SUMMARY ***
Total pot 260000 | Rake 0 
Seat 2: zugmoraes (big blind) collected (260000)
Seat 7: reijomo (button) (small blind) folded before Flop



PokerStars Hand #157574686831: Tournament #1641817020, $7.50+$7.50+$1.50 USD Hold'em No Limit - Level LVII (100000/200000) - 2016/08/21 18:20:56 ET
Table '1641817020 92' 9-max Seat #2 is the button
Seat 2: zugmoraes (1844740 in chips) 
Seat 7: reijomo (16655260 in chips) 
zugmoraes: posts the ante 30000
reijomo: posts the ante 30000
zugmoraes: posts small blind 100000
reijomo: posts big blind 200000
*** HOLE CARDS ***
zugmoraes: raises 1614740 to 1814740 and is all-in
reijomo: calls 1614740
*** FLOP *** [Ah 5s Js]
*** TURN *** [Ah 5s Js] [7d]
*** RIVER *** [Ah 5s Js 7d] [7c]
*** SHOW DOWN ***
reijomo: shows [4s Kd] (a pair of Sevens)
zugmoraes: shows [Jd Kc] (two pair, Jacks and Sevens)
zugmoraes collected 3689480 from pot
*** SUMMARY ***
Total pot 3689480 | Rake 0 
Board [Ah 5s Js 7d 7c]
Seat 2: zugmoraes (button) (small blind) showed [Jd Kc] and won (3689480) with two pair, Jacks and Sevens
Seat 7: reijomo (big blind) showed [4s Kd] and lost with a pair of Sevens



PokerStars Hand #157574703567: Tournament #1641817020, $7.50+$7.50+$1.50 USD Hold'em No Limit - Level LVII (100000/200000) - 2016/08/21 18:21:21 ET
Table '1641817020 92' 9-max Seat #7 is the button
Seat 2: zugmoraes (3689480 in chips) 
Seat 7: reijomo (14810520 in chips) 
zugmoraes: posts the ante 30000
reijomo: posts the ante 30000
reijomo: posts small blind 100000
zugmoraes: posts big blind 200000
*** HOLE CARDS ***
reijomo: calls 100000
zugmoraes: checks 
*** FLOP *** [Kd 7s 2s]
zugmoraes: checks 
reijomo: bets 200000
zugmoraes: folds 
Uncalled bet (200000) returned to reijomo
reijomo collected 460000 from pot
*** SUMMARY ***
Total pot 460000 | Rake 0 
Board [Kd 7s 2s]
Seat 2: zugmoraes (big blind) folded on the Flop
Seat 7: reijomo (button) (small blind) collected (460000)



PokerStars Hand #157574720884: Tournament #1641817020, $7.50+$7.50+$1.50 USD Hold'em No Limit - Level LVII (100000/200000) - 2016/08/21 18:21:46 ET
Table '1641817020 92' 9-max Seat #2 is the button
Seat 2: zugmoraes (3459480 in chips) 
Seat 7: reijomo (15040520 in chips) 
zugmoraes: posts the ante 30000
reijomo: posts the ante 30000
zugmoraes: posts small blind 100000
reijomo: posts big blind 200000
*** HOLE CARDS ***
zugmoraes: calls 100000
reijomo: raises 466666 to 666666
zugmoraes: folds 
Uncalled bet (466666) returned to reijomo
reijomo collected 460000 from pot
*** SUMMARY ***
Total pot 460000 | Rake 0 
Seat 2: zugmoraes (button) (small blind) folded before Flop
Seat 7: reijomo (big blind) collected (460000)



PokerStars Hand #157574741583: Tournament #1641817020, $7.50+$7.50+$1.50 USD Hold'em No Limit - Level LVII (100000/200000) - 2016/08/21 18:22:17 ET
Table '1641817020 92' 9-max Seat #7 is the button
Seat 2: zugmoraes (3229480 in chips) 
Seat 7: reijomo (15270520 in chips) 
zugmoraes: posts the ante 30000
reijomo: posts the ante 30000
reijomo: posts small blind 100000
zugmoraes: posts big blind 200000
*** HOLE CARDS ***
reijomo: calls 100000
zugmoraes: checks 
*** FLOP *** [3s Ah 6c]
zugmoraes: checks 
reijomo: bets 200000
zugmoraes: folds 
Uncalled bet (200000) returned to reijomo
reijomo collected 460000 from pot
*** SUMMARY ***
Total pot 460000 | Rake 0 
Board [3s Ah 6c]
Seat 2: zugmoraes (big blind) folded on the Flop
Seat 7: reijomo (button) (small blind) collected (460000)



PokerStars Hand #157574754433: Tournament #1641817020, $7.50+$7.50+$1.50 USD Hold'em No Limit - Level LVII (100000/200000) - 2016/08/21 18:22:36 ET
Table '1641817020 92' 9-max Seat #2 is the button
Seat 2: zugmoraes (2999480 in chips) 
Seat 7: reijomo (15500520 in chips) 
zugmoraes: posts the ante 30000
reijomo: posts the ante 30000
zugmoraes: posts small blind 100000
reijomo: posts big blind 200000
*** HOLE CARDS ***
zugmoraes: raises 200000 to 400000
reijomo: calls 200000
*** FLOP *** [7h Ad 8d]
reijomo: checks 
zugmoraes: bets 275200
reijomo: folds 
Uncalled bet (275200) returned to zugmoraes
zugmoraes collected 860000 from pot
zugmoraes: doesn't show hand 
*** SUMMARY ***
Total pot 860000 | Rake 0 
Board [7h Ad 8d]
Seat 2: zugmoraes (button) (small blind) collected (860000)
Seat 7: reijomo (big blind) folded on the Flop



PokerStars Hand #157574771655: Tournament #1641817020, $7.50+$7.50+$1.50 USD Hold'em No Limit - Level LVII (100000/200000) - 2016/08/21 18:23:01 ET
Table '1641817020 92' 9-max Seat #7 is the button
Seat 2: zugmoraes (3429480 in chips) 
Seat 7: reijomo (15070520 in chips) 
zugmoraes: posts the ante 30000
reijomo: posts the ante 30000
reijomo: posts small blind 100000
zugmoraes: posts big blind 200000
*** HOLE CARDS ***
reijomo: folds 
Uncalled bet (100000) returned to zugmoraes
zugmoraes collected 260000 from pot
zugmoraes: doesn't show hand 
*** SUMMARY ***
Total pot 260000 | Rake 0 
Seat 2: zugmoraes (big blind) collected (260000)
Seat 7: reijomo (button) (small blind) folded before Flop



PokerStars Hand #157574775684: Tournament #1641817020, $7.50+$7.50+$1.50 USD Hold'em No Limit - Level LVII (100000/200000) - 2016/08/21 18:23:07 ET
Table '1641817020 92' 9-max Seat #2 is the button
Seat 2: zugmoraes (3559480 in chips) 
Seat 7: reijomo (14940520 in chips) 
zugmoraes: posts the ante 30000
reijomo: posts the ante 30000
zugmoraes: posts small blind 100000
reijomo: posts big blind 200000
*** HOLE CARDS ***
zugmoraes: raises 3329480 to 3529480 and is all-in
reijomo: calls 3329480
*** FLOP *** [4d Ts 9c]
*** TURN *** [4d Ts 9c] [2d]
*** RIVER *** [4d Ts 9c 2d] [7s]
*** SHOW DOWN ***
reijomo: shows [Ks Ad] (high card Ace)
zugmoraes: shows [As 3h] (high card Ace - lower kicker)
reijomo collected 7118960 from pot
reijomo wins $315.55 for eliminating zugmoraes and their own bounty increases by $315.55 to $1116.70
zugmoraes finished the tournament in 2nd place and received $2226.87.
reijomo wins the tournament and receives $2971.40 - congratulations!
*** SUMMARY ***
Total pot 7118960 | Rake 0 
Board [4d Ts 9c 2d 7s]
Seat 2: zugmoraes (button) (small blind) showed [As 3h] and lost with high card Ace
Seat 7: reijomo (big blind) showed [Ks Ad] and won (7118960) with high card Ace



PokerStars Hand #157575058928: Tournament #1641817620, $7.50+$7.50+$1.50 USD Hold'em No Limit - Level I (15/30) - 2016/08/21 18:30:08 ET
Table '1641817620 1' 9-max Seat #1 is the button
Seat 1: mattyonuts (5000 in chips) 
Seat 2: topaipi (5000 in chips) 
Seat 3: MAMOHT_T (5000 in chips) 
Seat 4: disbrey87 (5000 in chips) 
Seat 5: LADIEFJ (5000 in chips) 
Seat 6: TheGuerreiro (5000 in chips) 
Seat 7: Amorkos (5000 in chips) 
Seat 8: K. Ichinose (5000 in chips) 
Seat 9: AdiMutu1001 (5000 in chips) 
mattyonuts: posts the ante 5
topaipi: posts the ante 5
MAMOHT_T: posts the ante 5
disbrey87: posts the ante 5
LADIEFJ: posts the ante 5
TheGuerreiro: posts the ante 5
Amorkos: posts the ante 5
K. Ichinose: posts the ante 5
AdiMutu1001: posts the ante 5
topaipi: posts small blind 15
MAMOHT_T: posts big blind 30
*** HOLE CARDS ***
disbrey87: raises 30 to 60
LADIEFJ: calls 60
TheGuerreiro: folds 
Amorkos: folds 
K. Ichinose: folds 
AdiMutu1001: folds 
mattyonuts: folds 
topaipi: calls 45
MAMOHT_T: folds 
*** FLOP *** [9d 3s Qs]
topaipi: checks 
disbrey87: bets 120
LADIEFJ: calls 120
topaipi: folds 
*** TURN *** [9d 3s Qs] [Ah]
disbrey87: bets 240
LADIEFJ: calls 240
*** RIVER *** [9d 3s Qs Ah] [Ac]
disbrey87: bets 510
LADIEFJ: calls 510
*** SHOW DOWN ***
disbrey87: shows [4c 4h] (two pair, Aces and Fours)
LADIEFJ: shows [As 5s] (three of a kind, Aces)
LADIEFJ collected 1995 from pot
*** SUMMARY ***
Total pot 1995 | Rake 0 
Board [9d 3s Qs Ah Ac]
Seat 1: mattyonuts (button) folded before Flop (didn't bet)
Seat 2: topaipi (small blind) folded on the Flop
Seat 3: MAMOHT_T (big blind) folded before Flop
Seat 4: disbrey87 showed [4c 4h] and lost with two pair, Aces and Fours
Seat 5: LADIEFJ showed [As 5s] and won (1995) with three of a kind, Aces
Seat 6: TheGuerreiro folded before Flop (didn't bet)
Seat 7: Amorkos folded before Flop (didn't bet)
Seat 8: K. Ichinose folded before Flop (didn't bet)
Seat 9: AdiMutu1001 folded before Flop (didn't bet)



PokerStars Hand #157575058929: Tournament #1641817620, $7.50+$7.50+$1.50 USD Hold'em No Limit - Level I (15/30) - 2016/08/21 18:30:08 ET
Table '1641817620 2' 9-max Seat #1 is the button
Seat 1: ChaCha121 (5000 in chips) 
Seat 2: T8yourmoney (5000 in chips) 
Seat 3: mvpalls (5000 in chips) 
Seat 4: m1r0o (5000 in chips) 
Seat 5: junkshow#1 (5000 in chips) is sitting out
Seat 6: Vstoinov (5000 in chips) 
Seat 7: GreenDja (5000 in chips) 
Seat 8: BckDoorFlux (5000 in chips) 
Seat 9: LeaD25 (5000 in chips) 
ChaCha121: posts the ante 5
T8yourmoney: posts the ante 5
mvpalls: posts the ante 5
m1r0o: posts the ante 5
junkshow#1: posts the ante 5
Vstoinov: posts the ante 5
GreenDja: posts the ante 5
BckDoorFlux: posts the ante 5
LeaD25: posts the ante 5
T8yourmoney: posts small blind 15
mvpalls: posts big blind 30
*** HOLE CARDS ***
m1r0o: raises 30 to 60
junkshow#1: folds 
Vstoinov: folds 
GreenDja: folds 
BckDoorFlux: folds 
LeaD25: calls 60
ChaCha121: folds 
T8yourmoney: folds 
mvpalls: calls 30
*** FLOP *** [Jh 7c 6c]
mvpalls: checks 
m1r0o: checks 
LeaD25: checks 
*** TURN *** [Jh 7c 6c] [2c]
mvpalls: checks 
m1r0o: checks 
LeaD25: bets 150
mvpalls: folds 
m1r0o: calls 150
*** RIVER *** [Jh 7c 6c 2c] [Ts]
m1r0o: checks 
LeaD25: bets 300
m1r0o: folds 
Uncalled bet (300) returned to LeaD25
LeaD25 collected 540 from pot
LeaD25: doesn't show hand 
*** SUMMARY ***
Total pot 540 | Rake 0 
Board [Jh 7c 6c 2c Ts]
Seat 1: ChaCha121 (button) folded before Flop (didn't bet)
Seat 2: T8yourmoney (small blind) folded before Flop
Seat 3: mvpalls (big blind) folded on the Turn
Seat 4: m1r0o folded on the River
Seat 5: junkshow#1 folded before Flop (didn't bet)
Seat 6: Vstoinov folded before Flop (didn't bet)
Seat 7: GreenDja folded before Flop (didn't bet)
Seat 8: BckDoorFlux folded before Flop (didn't bet)
Seat 9: LeaD25 collected (540)



PokerStars Hand #157575058930: Tournament #1641817620, $7.50+$7.50+$1.50 USD Hold'em No Limit - Level I (15/30) - 2016/08/21 18:30:08 ET
Table '1641817620 3' 9-max Seat #1 is the button
Seat 1: IwantplayNL (5000 in chips) 
Seat 2: dufino (5000 in chips) 
Seat 3: zIggY-7-rAc3 (5000 in chips) 
Seat 4: gerald0jr (5000 in chips) 
Seat 5: sergiohbl (5000 in chips) 
Seat 6: BrunoCastroR (5000 in chips) 
Seat 7: alehirazawa (5000 in chips) 
Seat 8: markosharko (5000 in chips) 
Seat 9: VictorZh14 (5000 in chips) 
IwantplayNL: posts the ante 5
dufino: posts the ante 5
zIggY-7-rAc3: posts the ante 5
gerald0jr: posts the ante 5
sergiohbl: posts the ante 5
BrunoCastroR: posts the ante 5
alehirazawa: posts the ante 5
markosharko: posts the ante 5
VictorZh14: posts the ante 5
dufino: posts small blind 15
zIggY-7-rAc3: posts big blind 30
*** HOLE CARDS ***
gerald0jr: folds 
sergiohbl: folds 
BrunoCastroR: folds 
alehirazawa: folds 
markosharko: raises 33 to 63
VictorZh14: folds 
IwantplayNL: folds 
dufino: raises 33 to 96
zIggY-7-rAc3: folds 
markosharko: calls 33
*** FLOP *** [2h Kh Tc]
dufino: bets 270
markosharko: folds 
Uncalled bet (270) returned to dufino
dufino collected 267 from pot
*** SUMMARY ***
Total pot 267 | Rake 0 
Board [2h Kh Tc]
Seat 1: IwantplayNL (button) folded before Flop (didn't bet)
Seat 2: dufino (small blind) collected (267)
Seat 3: zIggY-7-rAc3 (big blind) folded before Flop
Seat 4: gerald0jr folded before Flop (didn't bet)
Seat 5: sergiohbl folded before Flop (didn't bet)
Seat 6: BrunoCastroR folded before Flop (didn't bet)
Seat 7: alehirazawa folded before Flop (didn't bet)
Seat 8: markosharko folded on the Flop
Seat 9: VictorZh14 folded before Flop (didn't bet)



PokerStars Hand #157575058931: Tournament #1641817620, $7.50+$7.50+$1.50 USD Hold'em No Limit - Level I (15/30) - 2016/08/21 18:30:08 ET
Table '1641817620 4' 9-max Seat #1 is the button
Seat 1: coldboy23 (5000 in chips) 
Seat 2: Velho Sábio (5000 in chips) 
Seat 3: manukk2 (5000 in chips) 
Seat 4: slk55amg (5000 in chips) 
Seat 5: sica26 (5000 in chips) 
Seat 6: stiftmaster9 (5000 in chips) 
Seat 7: AleksZy (5000 in chips) 
Seat 8: petersonmach (5000 in chips) 
Seat 9: DagobertQuad (5000 in chips) 
coldboy23: posts the ante 5
Velho Sábio: posts the ante 5
manukk2: posts the ante 5
slk55amg: posts the ante 5
sica26: posts the ante 5
stiftmaster9: posts the ante 5
AleksZy: posts the ante 5
petersonmach: posts the ante 5
DagobertQuad: posts the ante 5
Velho Sábio: posts small blind 15
manukk2: posts big blind 30
*** HOLE CARDS ***
slk55amg: raises 60 to 90
sica26: folds 
stiftmaster9: calls 90
AleksZy: folds 
petersonmach: folds 
DagobertQuad: folds 
coldboy23: folds 
Velho Sábio: folds 
manukk2: calls 60
*** FLOP *** [9s 7c 5h]
manukk2: checks 
slk55amg: bets 300
stiftmaster9: calls 300
manukk2: calls 300
*** TURN *** [9s 7c 5h] [Qs]
manukk2: checks 
slk55amg: checks 
stiftmaster9: checks 
*** RIVER *** [9s 7c 5h Qs] [5d]
manukk2: checks 
slk55amg: checks 
stiftmaster9: bets 570
manukk2: folds 
slk55amg: folds 
Uncalled bet (570) returned to stiftmaster9
stiftmaster9 collected 1230 from pot
*** SUMMARY ***
Total pot 1230 | Rake 0 
Board [9s 7c 5h Qs 5d]
Seat 1: coldboy23 (button) folded before Flop (didn't bet)
Seat 2: Velho Sábio (small blind) folded before Flop
Seat 3: manukk2 (big blind) folded on the River
Seat 4: slk55amg folded on the River
Seat 5: sica26 folded before Flop (didn't bet)
Seat 6: stiftmaster9 collected (1230)
Seat 7: AleksZy folded before Flop (didn't bet)
Seat 8: petersonmach folded before Flop (didn't bet)
Seat 9: DagobertQuad folded before Flop (didn't bet)



PokerStars Hand #157575058932: Tournament #1641817620, $7.50+$7.50+$1.50 USD Hold'em No Limit - Level I (15/30) - 2016/08/21 18:30:08 ET
Table '1641817620 5' 9-max Seat #1 is the button
Seat 1: kelvin171 (5000 in chips) 
Seat 2: jonesfi5sh (5000 in chips) 
Seat 3: PhenomPen1 (5000 in chips) 
Seat 4: GrimJoker77 (5000 in chips) 
Seat 5: NorocDeRoman (5000 in chips) 
Seat 6: Javicho9 (5000 in chips) 
Seat 7: athilapvh (5000 in chips) 
Seat 8: sloty27 (5000 in chips) 
Seat 9: chuny dealer (5000 in chips) 
kelvin171: posts the ante 5
jonesfi5sh: posts the ante 5
PhenomPen1: posts the ante 5
GrimJoker77: posts the ante 5
NorocDeRoman: posts the ante 5
Javicho9: posts the ante 5
athilapvh: posts the ante 5
sloty27: posts the ante 5
chuny dealer: posts the ante 5
jonesfi5sh: posts small blind 15
PhenomPen1: posts big blind 30
*** HOLE CARDS ***
GrimJoker77: raises 30 to 60
NorocDeRoman: folds 
Javicho9: folds 
athilapvh: calls 60
sloty27: folds 
chuny dealer: folds 
kelvin171: raises 4935 to 4995 and is all-in
jonesfi5sh: folds 
PhenomPen1: folds 
GrimJoker77: folds 
athilapvh: calls 4935 and is all-in
*** FLOP *** [Ks As 4c]
*** TURN *** [Ks As 4c] [5h]
*** RIVER *** [Ks As 4c 5h] [9h]
*** SHOW DOWN ***
athilapvh: shows [Ac Kc] (two pair, Aces and Kings)
kelvin171: shows [Jd Js] (a pair of Jacks)
athilapvh collected 10140 from pot
athilapvh wins $3.75 for eliminating kelvin171 and their own bounty increases by $3.75 to $11.25
kelvin171 finished the tournament in 1000000000th place
*** SUMMARY ***
Total pot 10140 | Rake 0 
Board [Ks As 4c 5h 9h]
Seat 1: kelvin171 (button) showed [Jd Js] and lost with a pair of Jacks
Seat 2: jonesfi5sh (small blind) folded before Flop
Seat 3: PhenomPen1 (big blind) folded before Flop
Seat 4: GrimJoker77 folded before Flop
Seat 5: NorocDeRoman folded before Flop (didn't bet)
Seat 6: Javicho9 folded before Flop (didn't bet)
Seat 7: athilapvh showed [Ac Kc] and won (10140) with two pair, Aces and Kings
Seat 8: sloty27 folded before Flop (didn't bet)
Seat 9: chuny dealer folded before Flop (didn't bet)



PokerStars Hand #157575058933: Tournament #1641817620, $7.50+$7.50+$1.50 USD Hold'em No Limit - Level I (15/30) - 2016/08/21 18:30:08 ET
Table '1641817620 51' 9-max Seat #1 is the button
Seat 1: yys000 (5000 in chips) 
Seat 2: paulotury (5000 in chips) 
Seat 3: kozloeric (5000 in chips) 
Seat 4: bastef79 (5000 in chips) 
Seat 5: cusirc (5000 in chips) 
Seat 6: demonas05 (5000 in chips) 
Seat 7: boostyz (5000 in chips) 
Seat 8: Garfild740 (5000 in chips) 
Seat 9: Kalvar1 (5000 in chips) 
yys000: posts the ante 5
paulotury: posts the ante 5
kozloeric: posts the ante 5
bastef79: posts the ante 5
cusirc: posts the ante 5
demonas05: posts the ante 5
boostyz: posts the ante 5
Garfild740: posts the ante 5
Kalvar1: posts the ante 5
paulotury: posts small blind 15
kozloeric: posts big blind 30
*** HOLE CARDS ***
bastef79: folds 
cusirc: folds 
demonas05: folds 
boostyz: folds 
Garfild740: folds 
Kalvar1: folds 
yys000: folds 
paulotury: folds 
Uncalled bet (15) returned to kozloeric
kozloeric collected 75 from pot
*** SUMMARY ***
Total pot 75 | Rake 0 
Seat 1: yys000 (button) folded before Flop (didn't bet)
Seat 2: paulotury (small blind) folded before Flop
Seat 3: kozloeric (big blind) collected (75)
Seat 4: bastef79 folded before Flop (didn't bet)
Seat 5: cusirc folded before Flop (didn't bet)
Seat 6: demonas05 folded before Flop (didn't bet)
Seat 7: boostyz folded before Flop (didn't bet)
Seat 8: Garfild740 folded before Flop (didn't bet)
Seat 9: Kalvar1 folded before Flop (didn't bet)



PokerStars Hand #157575058934: Tournament #1641817620, $7.50+$7.50+$1.50 USD Hold'em No Limit - Level I (15/30) - 2016/08/21 18:30:08 ET
Table '1641817620 52' 9-max Seat #1 is the button
Seat 1: DoubleBBle (5000 in chips) 
Seat 2: FelipeMarlon (5000 in chips) 
Seat 3: michalis009 (5000 in chips) 
Seat 4: Daviderevan (5000 in chips) 
Seat 5: Armin2188 (5000 in chips) 
Seat 6: HORSEPOKER28 (5000 in chips) 
Seat 7: mopeeds87 (5000 in chips) 
Seat 8: vladvladutz (5000 in chips) 
Seat 9: leothefirm (5000 in chips) 
DoubleBBle: posts the ante 5
FelipeMarlon: posts the ante 5
michalis009: posts the ante 5
Daviderevan: posts the ante 5
Armin2188: posts the ante 5
HORSEPOKER28: posts the ante 5
mopeeds87: posts the ante 5
vladvladutz: posts the ante 5
leothefirm: posts the ante 5
FelipeMarlon: posts small blind 15
michalis009: posts big blind 30
*** HOLE CARDS ***
Daviderevan: folds 
Armin2188: folds 
HORSEPOKER28: folds 
mopeeds87: raises 60 to 90
vladvladutz: folds 
leothefirm: folds 
DoubleBBle: calls 90
FelipeMarlon: folds 
michalis009: folds 
*** FLOP *** [7h 9c Kd]
mopeeds87: checks 
DoubleBBle: bets 225
mopeeds87: calls 225
*** TURN *** [7h 9c Kd] [8d]
mopeeds87: checks 
DoubleBBle: bets 225
mopeeds87: folds 
Uncalled bet (225) returned to DoubleBBle
DoubleBBle collected 720 from pot
DoubleBBle: doesn't show hand 
*** SUMMARY ***
Total pot 720 | Rake 0 
Board [7h 9c Kd 8d]
Seat 1: DoubleBBle (button) collected (720)
Seat 2: FelipeMarlon (small blind) folded before Flop
Seat 3: michalis009 (big blind) folded before Flop
Seat 4: Daviderevan folded before Flop (didn't bet)
Seat 5: Armin2188 folded before Flop (didn't bet)
Seat 6: HORSEPOKER28 folded before Flop (didn't bet)
Seat 7: mopeeds87 folded on the Turn
Seat 8: vladvladutz folded before Flop (didn't bet)
Seat 9: leothefirm folded before Flop (didn't bet)



PokerStars Hand #157575058935: Tournament #1641817620, $7.50+$7.50+$1.50 USD Hold'em No Limit - Level I (15/30) - 2016/08/21 18:30:08 ET
Table '1641817620 53' 9-max Seat #1 is the button
Seat 1: star729 (5000 in chips) 
Seat 2: cebola77 (5000 in chips) 
Seat 3: Pekkosaurus (5000 in chips) 
Seat 4: -UNREGPRE- (5000 in chips) 
Seat 5: carlostrend (5000 in chips) 
Seat 6: The39player (5000 in chips) 
Seat 7: MingRey (5000 in chips) 
Seat 8: top@pokker (5000 in chips) 
Seat 9: cruiser5917 (5000 in chips) 
star729: posts the ante 5
cebola77: posts the ante 5
Pekkosaurus: posts the ante 5
-UNREGPRE-: posts the ante 5
carlostrend: posts the ante 5
The39player: posts the ante 5
MingRey: posts the ante 5
top@pokker: posts the ante 5
cruiser5917: posts the ante 5
cebola77: posts small blind 15
Pekkosaurus: posts big blind 30
*** HOLE CARDS ***
-UNREGPRE-: folds 
carlostrend: calls 30
The39player: folds 
MingRey: folds 
top@pokker: folds 
cruiser5917: folds 
star729: raises 90 to 120
cebola77: folds 
Pekkosaurus: folds 
carlostrend: calls 90
*** FLOP *** [As 2h 8d]
carlostrend: checks 
star729: bets 180
carlostrend: folds 
Uncalled bet (180) returned to star729
star729 collected 330 from pot
star729: doesn't show hand 
*** SUMMARY ***
Total pot 330 | Rake 0 
Board [As 2h 8d]
Seat 1: star729 (button) collected (330)
Seat 2: cebola77 (small blind) folded before Flop
Seat 3: Pekkosaurus (big blind) folded before Flop
Seat 4: -UNREGPRE- folded before Flop (didn't bet)
Seat 5: carlostrend folded on the Flop
Seat 6: The39player folded before Flop (didn't bet)
Seat 7: MingRey folded before Flop (didn't bet)
Seat 8: top@pokker folded before Flop (didn't bet)
Seat 9: cruiser5917 folded before Flop (didn't bet)



PokerStars Hand #157575058936: Tournament #1641817620, $7.50+$7.50+$1.50 USD Hold'em No Limit - Level I (15/30) - 2016/08/21 18:30:08 ET
Table '1641817620 54' 9-max Seat #1 is the button
Seat 1: nixx77 (5000 in chips) 
Seat 2: FábioC.p.br (5000 in chips) 
Seat 3: pinokkioOo (5000 in chips) 
Seat 4: ALLESC-114 (5000 in chips) 
Seat 5: appache55 (5000 in chips) 
Seat 6: hrabbi87 (5000 in chips) 
Seat 7: xpsbynoc (5000 in chips) 
Seat 8: MiltonMorais (5000 in chips) 
Seat 9: ZeckMaverick (5000 in chips) 
nixx77: posts the ante 5
FábioC.p.br: posts the ante 5
pinokkioOo: posts the ante 5
ALLESC-114: posts the ante 5
appache55: posts the ante 5
hrabbi87: posts the ante 5
xpsbynoc: posts the ante 5
MiltonMorais: posts the ante 5
ZeckMaverick: posts the ante 5
FábioC.p.br: posts small blind 15
pinokkioOo: posts big blind 30
*** HOLE CARDS ***
ALLESC-114: folds 
appache55: folds 
hrabbi87: folds 
xpsbynoc: raises 30 to 60
MiltonMorais: folds 
ZeckMaverick: folds 
nixx77: folds 
FábioC.p.br: folds 
pinokkioOo: folds 
Uncalled bet (30) returned to xpsbynoc
xpsbynoc collected 120 from pot
*** SUMMARY ***
Total pot 120 | Rake 0 
Seat 1: nixx77 (button) folded before Flop (didn't bet)
Seat 2: FábioC.p.br (small blind) folded before Flop
Seat 3: pinokkioOo (big blind) folded before Flop
Seat 4: ALLESC-114 folded before Flop (didn't bet)
Seat 5: appache55 folded before Flop (didn't bet)
Seat 6: hrabbi87 folded before Flop (didn't bet)
Seat 7: xpsbynoc collected (120)
Seat 8: MiltonMorais folded before Flop (didn't bet)
Seat 9: ZeckMaverick folded before Flop (didn't bet)



PokerStars Hand #157575058937: Tournament #1641817620, $7.50+$7.50+$1.50 USD Hold'em No Limit - Level I (15/30) - 2016/08/21 18:30:08 ET
Table '1641817620 55' 9-max Seat #1 is the button
Seat 1: jake5030 (5000 in chips) 
Seat 2: HayArro (5000 in chips) 
Seat 3: MaxPips (5000 in chips) 
Seat 4: furia75205 (5000 in chips) 
Seat 5: hoolzky (5000 in chips) 
Seat 6: B.Paulino (5000 in chips) 
Seat 7: xLewie (5000 in chips) 
Seat 8: mendozoQ (5000 in chips) 
Seat 9: igara tigara (5000 in chips) 
jake5030: posts the ante 5
HayArro: posts the ante 5
MaxPips: posts the ante 5
furia75205: posts the ante 5
hoolzky: posts the ante 5
B.Paulino: posts the ante 5
xLewie: posts the ante 5
mendozoQ: posts the ante 5
igara tigara: posts the ante 5
HayArro: posts small blind 15
MaxPips: posts big blind 30
*** HOLE CARDS ***
furia75205: folds 
hoolzky: raises 60 to 90
B.Paulino: folds 
xLewie: calls 90
mendozoQ: folds 
igara tigara: folds 
jake5030: folds 
HayArro: calls 75
MaxPips: calls 60
*** FLOP *** [Ad 8s 2d]
HayArro: checks 
MaxPips: checks 
hoolzky: checks 
xLewie: bets 120
HayArro: folds 
MaxPips: folds 
hoolzky: folds 
Uncalled bet (120) returned to xLewie
xLewie collected 405 from pot
xLewie: doesn't show hand 
*** SUMMARY ***
Total pot 405 | Rake 0 
Board [Ad 8s 2d]
Seat 1: jake5030 (button) folded before Flop (didn't bet)
Seat 2: HayArro (small blind) folded on the Flop
Seat 3: MaxPips (big blind) folded on the Flop
Seat 4: furia75205 folded before Flop (didn't bet)
Seat 5: hoolzky folded on the Flop
Seat 6: B.Paulino folded before Flop (didn't bet)
Seat 7: xLewie collected (405)
Seat 8: mendozoQ folded before Flop (didn't bet)
Seat 9: igara tigara folded before Flop (didn't bet)



PokerStars Hand #157575058938: Tournament #1641817620, $7.50+$7.50+$1.50 USD Hold'em No Limit - Level I (15/30) - 2016/08/21 18:30:08 ET
Table '1641817620 56' 9-max Seat #1 is the button
Seat 1: PpME_Oe_87 (5000 in chips) 
Seat 2: NrRockeT9 (5000 in chips) 
Seat 3: DontFoldItPL (5000 in chips) 
Seat 4: cla11 (5000 in chips) 
Seat 5: luvlust (5000 in chips) 
Seat 6: pedro300390 (5000 in chips) 
Seat 7: rickyrdmy (5000 in chips) 
Seat 8: M.J.466 (5000 in chips) 
Seat 9: Exan13 (5000 in chips) 
PpME_Oe_87: posts the ante 5
NrRockeT9: posts the ante 5
DontFoldItPL: posts the ante 5
cla11: posts the ante 5
luvlust: posts the ante 5
pedro300390: posts the ante 5
rickyrdmy: posts the ante 5
M.J.466: posts the ante 5
Exan13: posts the ante 5
NrRockeT9: posts small blind 15
DontFoldItPL: posts big blind 30
*** HOLE CARDS ***
cla11: folds 
luvlust: raises 30 to 60
pedro300390: folds 
rickyrdmy: folds 
M.J.466: folds 
Exan13: folds 
PpME_Oe_87: folds 
NrRockeT9: calls 45
DontFoldItPL: calls 30
*** FLOP *** [8d Qs Qd]
NrRockeT9: checks 
DontFoldItPL: checks 
luvlust: bets 150
NrRockeT9: folds 
DontFoldItPL: calls 150
*** TURN *** [8d Qs Qd] [5c]
DontFoldItPL: checks 
luvlust: checks 
*** RIVER *** [8d Qs Qd 5c] [7s]
DontFoldItPL: checks 
luvlust: checks 
*** SHOW DOWN ***
DontFoldItPL: shows [Jc 8s] (two pair, Queens and Eights)
luvlust: mucks hand 
DontFoldItPL collected 525 from pot
*** SUMMARY ***
Total pot 525 | Rake 0 
Board [8d Qs Qd 5c 7s]
Seat 1: PpME_Oe_87 (button) folded before Flop (didn't bet)
Seat 2: NrRockeT9 (small blind) folded on the Flop
Seat 3: DontFoldItPL (big blind) showed [Jc 8s] and won (525) with two pair, Queens and Eights
Seat 4: cla11 folded before Flop (didn't bet)
Seat 5: luvlust mucked
Seat 6: pedro300390 folded before Flop (didn't bet)
Seat 7: rickyrdmy folded before Flop (didn't bet)
Seat 8: M.J.466 folded before Flop (didn't bet)
Seat 9: Exan13 folded before Flop (didn't bet)



PokerStars Hand #157575058939: Tournament #1641817620, $7.50+$7.50+$1.50 USD Hold'em No Limit - Level I (15/30) - 2016/08/21 18:30:08 ET
Table '1641817620 57' 9-max Seat #1 is the button
Seat 1: pedroh2010 (5000 in chips) 
Seat 2: MasterTony77 (5000 in chips) 
Seat 3: ovekas (5000 in chips) 
Seat 4: ALWAYSBRAVES (5000 in chips) 
Seat 5: BaDBeaT_AK85 (5000 in chips) 
Seat 6: kachumban (5000 in chips) 
Seat 7: ZodiakGB (5000 in chips) 
Seat 8: MeortheMrs (5000 in chips) 
Seat 9: andreiuc (5000 in chips) 
pedroh2010: posts the ante 5
MasterTony77: posts the ante 5
ovekas: posts the ante 5
ALWAYSBRAVES: posts the ante 5
BaDBeaT_AK85: posts the ante 5
kachumban: posts the ante 5
ZodiakGB: posts the ante 5
MeortheMrs: posts the ante 5
andreiuc: posts the ante 5
MasterTony77: posts small blind 15
ovekas: posts big blind 30
*** HOLE CARDS ***
ALWAYSBRAVES: folds 
BaDBeaT_AK85: folds 
kachumban: folds 
ZodiakGB: folds 
MeortheMrs: raises 60 to 90
andreiuc: folds 
pedroh2010: folds 
MasterTony77: folds 
ovekas: calls 60
*** FLOP *** [3h 9c 2c]
ovekas: checks 
MeortheMrs: checks 
*** TURN *** [3h 9c 2c] [Qs]
ovekas: bets 120
MeortheMrs: folds 
Uncalled bet (120) returned to ovekas
ovekas collected 240 from pot
ovekas: doesn't show hand 
*** SUMMARY ***
Total pot 240 | Rake 0 
Board [3h 9c 2c Qs]
Seat 1: pedroh2010 (button) folded before Flop (didn't bet)
Seat 2: MasterTony77 (small blind) folded before Flop
Seat 3: ovekas (big blind) collected (240)
Seat 4: ALWAYSBRAVES folded before Flop (didn't bet)
Seat 5: BaDBeaT_AK85 folded before Flop (didn't bet)
Seat 6: kachumban folded before Flop (didn't bet)
Seat 7: ZodiakGB folded before Flop (didn't bet)
Seat 8: MeortheMrs folded on the Turn
Seat 9: andreiuc folded before Flop (didn't bet)



PokerStars Hand #157575058940: Tournament #1641817620, $7.50+$7.50+$1.50 USD Hold'em No Limit - Level I (15/30) - 2016/08/21 18:30:08 ET
Table '1641817620 58' 9-max Seat #1 is the button
Seat 1: bld66 (5000 in chips) 
Seat 2: FACEBUHH (5000 in chips) 
Seat 3: CFgabriel (5000 in chips) 
Seat 4: nejirose (5000 in chips) 
Seat 5: pokercr7721 (5000 in chips) 
Seat 6: verdao134 (5000 in chips) 
Seat 7: I_R0B0T_90 (5000 in chips) 
Seat 8: lovebigpairs (5000 in chips) 
Seat 9: binho1806 (5000 in chips) 
bld66: posts the ante 5
FACEBUHH: posts the ante 5
CFgabriel: posts the ante 5
nejirose: posts the ante 5
pokercr7721: posts the ante 5
verdao134: posts the ante 5
I_R0B0T_90: posts the ante 5
lovebigpairs: posts the ante 5
binho1806: posts the ante 5
FACEBUHH: posts small blind 15
CFgabriel: posts big blind 30
*** HOLE CARDS ***
nejirose: folds 
pokercr7721: folds 
verdao134: folds 
I_R0B0T_90: folds 
lovebigpairs: folds 
binho1806: raises 30 to 60
bld66: calls 60
FACEBUHH: calls 45
CFgabriel: folds 
*** FLOP *** [4h 6s Kc]
FACEBUHH: checks 
binho1806: checks 
bld66: checks 
*** TURN *** [4h 6s Kc] [9h]
FACEBUHH: bets 60
binho1806: calls 60
bld66: calls 60
*** RIVER *** [4h 6s Kc 9h] [As]
FACEBUHH: checks 
binho1806: checks 
bld66: bets 210
FACEBUHH: folds 
binho1806: calls 210
*** SHOW DOWN ***
bld66: shows [7c 7h] (a pair of Sevens)
binho1806: shows [Kd Qs] (a pair of Kings)
binho1806 collected 855 from pot
*** SUMMARY ***
Total pot 855 | Rake 0 
Board [4h 6s Kc 9h As]
Seat 1: bld66 (button) showed [7c 7h] and lost with a pair of Sevens
Seat 2: FACEBUHH (small blind) folded on the River
Seat 3: CFgabriel (big blind) folded before Flop
Seat 4: nejirose folded before Flop (didn't bet)
Seat 5: pokercr7721 folded before Flop (didn't bet)
Seat 6: verdao134 folded before Flop (didn't bet)
Seat 7: I_R0B0T_90 folded before Flop (didn't bet)
Seat 8: lovebigpairs folded before Flop (didn't bet)
Seat 9: binho1806 showed [Kd Qs] and won (855) with a pair of Kings



PokerStars Hand #157575058941: Tournament #1641817620, $7.50+$7.50+$1.50 USD Hold'em No Limit - Level I (15/30) - 2016/08/21 18:30:08 ET
Table '1641817620 59' 9-max Seat #1 is the button
Seat 1: pitoco2012 (5000 in chips) 
Seat 2: M_ORBIT_M (5000 in chips) 
Seat 3: alemaowe (5000 in chips) 
Seat 4: jan monster (5000 in chips) 
Seat 5: laiyitui (5000 in chips) 
Seat 6: stilio_al (5000 in chips) 
Seat 7: 88Xin88 (5000 in chips) 
Seat 8: Enio Pinho (5000 in chips) 
Seat 9: Robsn087 (5000 in chips) 
pitoco2012: posts the ante 5
M_ORBIT_M: posts the ante 5
alemaowe: posts the ante 5
jan monster: posts the ante 5
laiyitui: posts the ante 5
stilio_al: posts the ante 5
88Xin88: posts the ante 5
Enio Pinho: posts the ante 5
Robsn087: posts the ante 5
M_ORBIT_M: posts small blind 15
alemaowe: posts big blind 30
*** HOLE CARDS ***
jan monster: folds 
laiyitui: folds 
stilio_al: folds 
88Xin88: raises 60 to 90
Enio Pinho: folds 
Robsn087: folds 
pitoco2012: folds 
M_ORBIT_M: folds 
alemaowe: folds 
Uncalled bet (60) returned to 88Xin88
88Xin88 collected 120 from pot
88Xin88: doesn't show hand 
*** SUMMARY ***
Total pot 120 | Rake 0 
Seat 1: pitoco2012 (button) folded before Flop (didn't bet)
Seat 2: M_ORBIT_M (small blind) folded before Flop
Seat 3: alemaowe (big blind) folded before Flop
Seat 4: jan monster folded before Flop (didn't bet)
Seat 5: laiyitui folded before Flop (didn't bet)
Seat 6: stilio_al folded before Flop (didn't bet)
Seat 7: 88Xin88 collected (120)
Seat 8: Enio Pinho folded before Flop (didn't bet)
Seat 9: Robsn087 folded before Flop (didn't bet)



PokerStars Hand #157575058942: Tournament #1641817620, $7.50+$7.50+$1.50 USD Hold'em No Limit - Level I (15/30) - 2016/08/21 18:30:08 ET
Table '1641817620 60' 9-max Seat #1 is the button
Seat 1: C0rpsbal (5000 in chips) 
Seat 2: LuckyRin (5000 in chips) 
Seat 3: Mattzy1 (5000 in chips) 
Seat 4: loco2202 (5000 in chips) 
Seat 5: SaoJorge2222 (5000 in chips) 
Seat 6: sexyhands (5000 in chips) 
Seat 7: vodao1 (5000 in chips) 
Seat 8: TarDinaCash (5000 in chips) 
Seat 9: Eibsee08 (5000 in chips) 
C0rpsbal: posts the ante 5
LuckyRin: posts the ante 5
Mattzy1: posts the ante 5
loco2202: posts the ante 5
SaoJorge2222: posts the ante 5
sexyhands: posts the ante 5
vodao1: posts the ante 5
TarDinaCash: posts the ante 5
Eibsee08: posts the ante 5
LuckyRin: posts small blind 15
Mattzy1: posts big blind 30
*** HOLE CARDS ***
loco2202: folds 
SaoJorge2222: raises 60 to 90
sexyhands: folds 
vodao1: calls 90
TarDinaCash: folds 
Eibsee08: folds 
C0rpsbal: folds 
LuckyRin: folds 
Mattzy1: calls 60
*** FLOP *** [4h 7d 3c]
Mattzy1: checks 
SaoJorge2222: bets 181
vodao1: calls 181
Mattzy1: calls 181
*** TURN *** [4h 7d 3c] [2c]
Mattzy1: checks 
SaoJorge2222: checks 
vodao1: bets 349
Mattzy1: calls 349
SaoJorge2222: folds 
*** RIVER *** [4h 7d 3c 2c] [4s]
Mattzy1: bets 870
vodao1: folds [Ac 6c]
Uncalled bet (870) returned to Mattzy1
Mattzy1 collected 1571 from pot
Mattzy1: doesn't show hand 
*** SUMMARY ***
Total pot 1571 | Rake 0 
Board [4h 7d 3c 2c 4s]
Seat 1: C0rpsbal (button) folded before Flop (didn't bet)
Seat 2: LuckyRin (small blind) folded before Flop
Seat 3: Mattzy1 (big blind) collected (1571)
Seat 4: loco2202 folded before Flop (didn't bet)
Seat 5: SaoJorge2222 folded on the Turn
Seat 6: sexyhands folded before Flop (didn't bet)
Seat 7: vodao1 folded on the River
Seat 8: TarDinaCash folded before Flop (didn't bet)
Seat 9: Eibsee08 folded before Flop (didn't bet)



PokerStars Hand #157575058943: Tournament #1641817620, $7.50+$7.50+$1.50 USD Hold'em No Limit - Level I (15/30) - 2016/08/21 18:30:08 ET
Table '1641817620 61' 9-max Seat #1 is the button
Seat 1: talga421 (5000 in chips) 
Seat 2: evgenia19591 (5000 in chips) 
Seat 3: ElliNelly (5000 in chips) 
Seat 4: theManiAKo (5000 in chips) 
Seat 5: sasha.yush (5000 in chips) 
Seat 6: houtenboog (5000 in chips) 
Seat 7: setarcos1234 (5000 in chips) 
Seat 8: Dan Mimar (5000 in chips) 
Seat 9: vininicolato (5000 in chips) 
talga421: posts the ante 5
evgenia19591: posts the ante 5
ElliNelly: posts the ante 5
theManiAKo: posts the ante 5
sasha.yush: posts the ante 5
houtenboog: posts the ante 5
setarcos1234: posts the ante 5
Dan Mimar: posts the ante 5
vininicolato: posts the ante 5
evgenia19591: posts small blind 15
ElliNelly: posts big blind 30
*** HOLE CARDS ***
theManiAKo: folds 
sasha.yush: folds 
houtenboog: folds 
setarcos1234: folds 
Dan Mimar: folds 
vininicolato: raises 60 to 90
talga421: calls 90
evgenia19591: calls 75
ElliNelly: calls 60
*** FLOP *** [6h 8s 4c]
evgenia19591: checks 
ElliNelly: checks 
vininicolato: checks 
talga421: bets 202
evgenia19591: folds 
ElliNelly: calls 202
vininicolato: folds 
*** TURN *** [6h 8s 4c] [Qs]
ElliNelly: checks 
talga421: checks 
*** RIVER *** [6h 8s 4c Qs] [Kd]
ElliNelly: bets 480
talga421: calls 480
*** SHOW DOWN ***
ElliNelly: shows [8c Ah] (a pair of Eights)
talga421: mucks hand 
ElliNelly collected 1769 from pot
*** SUMMARY ***
Total pot 1769 | Rake 0 
Board [6h 8s 4c Qs Kd]
Seat 1: talga421 (button) mucked
Seat 2: evgenia19591 (small blind) folded on the Flop
Seat 3: ElliNelly (big blind) showed [8c Ah] and won (1769) with a pair of Eights
Seat 4: theManiAKo folded before Flop (didn't bet)
Seat 5: sasha.yush folded before Flop (didn't bet)
Seat 6: houtenboog folded before Flop (didn't bet)
Seat 7: setarcos1234 folded before Flop (didn't bet)
Seat 8: Dan Mimar folded before Flop (didn't bet)
Seat 9: vininicolato folded on the Flop



PokerStars Hand #157575058944: Tournament #1641817620, $7.50+$7.50+$1.50 USD Hold'em No Limit - Level I (15/30) - 2016/08/21 18:30:08 ET
Table '1641817620 6' 9-max Seat #1 is the button
Seat 1: ASTRAXANSKI (5000 in chips) 
Seat 2: KOT-BEGEMOT6 (5000 in chips) 
Seat 4: mekkoramarha (5000 in chips) 
Seat 5: Phisch90 (5000 in chips) 
Seat 6: brown1967 (5000 in chips) 
Seat 7: Balotelli195 (5000 in chips) 
Seat 8: linoleum006 (5000 in chips) 
Seat 9: Jelsomino79 (5000 in chips) 
ASTRAXANSKI: posts the ante 5
KOT-BEGEMOT6: posts the ante 5
mekkoramarha: posts the ante 5
Phisch90: posts the ante 5
brown1967: posts the ante 5
Balotelli195: posts the ante 5
linoleum006: posts the ante 5
Jelsomino79: posts the ante 5
KOT-BEGEMOT6: posts small blind 15
mekkoramarha: posts big blind 30
*** HOLE CARDS ***
Phisch90: folds 
brown1967: folds 
Balotelli195: folds 
linoleum006: raises 30 to 60
Jelsomino79: folds 
ASTRAXANSKI: folds 
KOT-BEGEMOT6: folds 
mekkoramarha: folds 
Uncalled bet (30) returned to linoleum006
linoleum006 collected 115 from pot
linoleum006: doesn't show hand 
*** SUMMARY ***
Total pot 115 | Rake 0 
Seat 1: ASTRAXANSKI (button) folded before Flop (didn't bet)
Seat 2: KOT-BEGEMOT6 (small blind) folded before Flop
Seat 4: mekkoramarha (big blind) folded before Flop
Seat 5: Phisch90 folded before Flop (didn't bet)
Seat 6: brown1967 folded before Flop (didn't bet)
Seat 7: Balotelli195 folded before Flop (didn't bet)
Seat 8: linoleum006 collected (115)
Seat 9: Jelsomino79 folded before Flop (didn't bet)



PokerStars Hand #157575058945: Tournament #1641817620, $7.50+$7.50+$1.50 USD Hold'em No Limit - Level I (15/30) - 2016/08/21 18:30:08 ET
Table '1641817620 7' 9-max Seat #2 is the button
Seat 2: ricar1749 (5000 in chips) 
Seat 3: Steve G009 (5000 in chips) 
Seat 4: nbmom (5000 in chips) 
Seat 5: ch.rev. (5000 in chips) 
Seat 6: POKEMONSTRO (5000 in chips) 
Seat 7: NemeanDanny (5000 in chips) 
Seat 8: Original02 (5000 in chips) 
Seat 9: cjgarceau (5000 in chips) 
ricar1749: posts the ante 5
Steve G009: posts the ante 5
nbmom: posts the ante 5
ch.rev.: posts the ante 5
POKEMONSTRO: posts the ante 5
NemeanDanny: posts the ante 5
Original02: posts the ante 5
cjgarceau: posts the ante 5
Steve G009: posts small blind 15
nbmom: posts big blind 30
*** HOLE CARDS ***
ch.rev.: raises 60 to 90
POKEMONSTRO: folds 
NemeanDanny: folds 
Original02: calls 90
cjgarceau: folds 
ricar1749: folds 
Steve G009: folds 
nbmom: calls 60
*** FLOP *** [9s 3h Ts]
nbmom: checks 
ch.rev.: checks 
Original02: checks 
*** TURN *** [9s 3h Ts] [8s]
nbmom: checks 
ch.rev.: bets 150
Original02: calls 150
nbmom: folds 
*** RIVER *** [9s 3h Ts 8s] [2h]
ch.rev.: checks 
Original02: bets 510
ch.rev.: folds 
Uncalled bet (510) returned to Original02
Original02 collected 625 from pot
Original02: doesn't show hand 
*** SUMMARY ***
Total pot 625 | Rake 0 
Board [9s 3h Ts 8s 2h]
Seat 2: ricar1749 (button) folded before Flop (didn't bet)
Seat 3: Steve G009 (small blind) folded before Flop
Seat 4: nbmom (big blind) folded on the Turn
Seat 5: ch.rev. folded on the River
Seat 6: POKEMONSTRO folded before Flop (didn't bet)
Seat 7: NemeanDanny folded before Flop (didn't bet)
Seat 8: Original02 collected (625)
Seat 9: cjgarceau folded before Flop (didn't bet)



PokerStars Hand #157575058946: Tournament #1641817620, $7.50+$7.50+$1.50 USD Hold'em No Limit - Level I (15/30) - 2016/08/21 18:30:08 ET
Table '1641817620 8' 9-max Seat #1 is the button
Seat 1: inkjoh (5000 in chips) 
Seat 2: MarcosCLMO (5000 in chips) 
Seat 3: HundTore (5000 in chips) 
Seat 5: SODTALL7 (5000 in chips) 
Seat 6: Batovs (5000 in chips) 
Seat 7: pavaopics (5000 in chips) 
Seat 8: FastEdiddy (5000 in chips) 
Seat 9: Pokerofwind (5000 in chips) 
inkjoh: posts the ante 5
MarcosCLMO: posts the ante 5
HundTore: posts the ante 5
SODTALL7: posts the ante 5
Batovs: posts the ante 5
pavaopics: posts the ante 5
FastEdiddy: posts the ante 5
Pokerofwind: posts the ante 5
MarcosCLMO: posts small blind 15
HundTore: posts big blind 30
*** HOLE CARDS ***
SODTALL7: folds 
Batovs: folds 
pavaopics: folds 
FastEdiddy: folds 
Pokerofwind: folds 
inkjoh: raises 30 to 60
MarcosCLMO: folds 
HundTore: folds 
Uncalled bet (30) returned to inkjoh
inkjoh collected 115 from pot
inkjoh: doesn't show hand 
*** SUMMARY ***
Total pot 115 | Rake 0 
Seat 1: inkjoh (button) collected (115)
Seat 2: MarcosCLMO (small blind) folded before Flop
Seat 3: HundTore (big blind) folded before Flop
Seat 5: SODTALL7 folded before Flop (didn't bet)
Seat 6: Batovs folded before Flop (didn't bet)
Seat 7: pavaopics folded before Flop (didn't bet)
Seat 8: FastEdiddy folded before Flop (didn't bet)
Seat 9: Pokerofwind folded before Flop (didn't bet)



PokerStars Hand #157575058947: Tournament #1641817620, $7.50+$7.50+$1.50 USD Hold'em No Limit - Level I (15/30) - 2016/08/21 18:30:08 ET
Table '1641817620 9' 9-max Seat #1 is the button
Seat 1: kake40 (5000 in chips) 
Seat 2: Cergey1387 (5000 in chips) 
Seat 3: portugajr007 (5000 in chips) 
Seat 4: punkhead89 (5000 in chips) 
Seat 5: nO bUsTeD (5000 in chips) 
Seat 6: edizzz903 (5000 in chips) 
Seat 7: Cuzco83 (5000 in chips) 
Seat 8: maurogynppp (5000 in chips) 
Seat 9: N1COLOSO (5000 in chips) 
kake40: posts the ante 5
Cergey1387: posts the ante 5
portugajr007: posts the ante 5
punkhead89: posts the ante 5
nO bUsTeD: posts the ante 5
edizzz903: posts the ante 5
Cuzco83: posts the ante 5
maurogynppp: posts the ante 5
N1COLOSO: posts the ante 5
Cergey1387: posts small blind 15
portugajr007: posts big blind 30
*** HOLE CARDS ***
punkhead89: raises 60 to 90
nO bUsTeD: folds 
edizzz903: folds 
Cuzco83: folds 
maurogynppp: folds 
N1COLOSO: calls 90
kake40: calls 90
Cergey1387: calls 75
portugajr007: folds 
*** FLOP *** [9c 8d 9s]
Cergey1387: checks 
punkhead89: checks 
N1COLOSO: checks 
kake40: checks 
*** TURN *** [9c 8d 9s] [3c]
Cergey1387: checks 
punkhead89: bets 90
N1COLOSO: calls 90
kake40: folds 
Cergey1387: calls 90
*** RIVER *** [9c 8d 9s 3c] [8c]
Cergey1387: bets 150
punkhead89: folds 
N1COLOSO: folds 
Uncalled bet (150) returned to Cergey1387
Cergey1387 collected 705 from pot
*** SUMMARY ***
Total pot 705 | Rake 0 
Board [9c 8d 9s 3c 8c]
Seat 1: kake40 (button) folded on the Turn
Seat 2: Cergey1387 (small blind) collected (705)
Seat 3: portugajr007 (big blind) folded before Flop
Seat 4: punkhead89 folded on the River
Seat 5: nO bUsTeD folded before Flop (didn't bet)
Seat 6: edizzz903 folded before Flop (didn't bet)
Seat 7: Cuzco83 folded before Flop (didn't bet)
Seat 8: maurogynppp folded before Flop (didn't bet)
Seat 9: N1COLOSO folded on the River



PokerStars Hand #157575058948: Tournament #1641817620, $7.50+$7.50+$1.50 USD Hold'em No Limit - Level I (15/30) - 2016/08/21 18:30:08 ET
Table '1641817620 10' 9-max Seat #1 is the button
Seat 1: VANDECO174 (5000 in chips) 
Seat 2: Be Anger (5000 in chips) 
Seat 3: mickyryan (5000 in chips) 
Seat 4: silveira1879 (5000 in chips) 
Seat 5: AndyLou27 (5000 in chips) 
Seat 6: I M GOIN OFF (5000 in chips) 
Seat 7: Nuazo (5000 in chips) 
Seat 8: damibor (5000 in chips) 
Seat 9: Stokesy05 (5000 in chips) 
VANDECO174: posts the ante 5
Be Anger: posts the ante 5
mickyryan: posts the ante 5
silveira1879: posts the ante 5
AndyLou27: posts the ante 5
I M GOIN OFF: posts the ante 5
Nuazo: posts the ante 5
damibor: posts the ante 5
Stokesy05: posts the ante 5
Be Anger: posts small blind 15
mickyryan: posts big blind 30
*** HOLE CARDS ***
silveira1879: folds 
AndyLou27: folds 
I M GOIN OFF: folds 
Nuazo: folds 
damibor: folds 
Stokesy05: folds 
VANDECO174: folds 
Be Anger: folds 
Uncalled bet (15) returned to mickyryan
mickyryan collected 75 from pot
mickyryan: doesn't show hand 
*** SUMMARY ***
Total pot 75 | Rake 0 
Seat 1: VANDECO174 (button) folded before Flop (didn't bet)
Seat 2: Be Anger (small blind) folded before Flop
Seat 3: mickyryan (big blind) collected (75)
Seat 4: silveira1879 folded before Flop (didn't bet)
Seat 5: AndyLou27 folded before Flop (didn't bet)
Seat 6: I M GOIN OFF folded before Flop (didn't bet)
Seat 7: Nuazo folded before Flop (didn't bet)
Seat 8: damibor folded before Flop (didn't bet)
Seat 9: Stokesy05 folded before Flop (didn't bet)



PokerStars Hand #157575058949: Tournament #1641817620, $7.50+$7.50+$1.50 USD Hold'em No Limit - Level I (15/30) - 2016/08/21 18:30:08 ET
Table '1641817620 11' 9-max Seat #1 is the button
Seat 1: GambleGrill (5000 in chips) 
Seat 2: Dionakabarbi (5000 in chips) 
Seat 3: TriviGn'R (5000 in chips) 
Seat 4: rapo007 (5000 in chips) 
Seat 5: vanilaice88 (5000 in chips) 
Seat 6: buzios38 (5000 in chips) 
Seat 8: luisnrd (5000 in chips) 
Seat 9: kylix42 (5000 in chips) 
GambleGrill: posts the ante 5
Dionakabarbi: posts the ante 5
TriviGn'R: posts the ante 5
rapo007: posts the ante 5
vanilaice88: posts the ante 5
buzios38: posts the ante 5
luisnrd: posts the ante 5
kylix42: posts the ante 5
Dionakabarbi: posts small blind 15
TriviGn'R: posts big blind 30
*** HOLE CARDS ***
rapo007: folds 
vanilaice88: folds 
buzios38: folds 
luisnrd: folds 
kylix42: folds 
GambleGrill: folds 
Dionakabarbi has timed out
Dionakabarbi: folds 
Uncalled bet (15) returned to TriviGn'R
Dionakabarbi is sitting out
TriviGn'R collected 70 from pot
TriviGn'R: doesn't show hand 
*** SUMMARY ***
Total pot 70 | Rake 0 
Seat 1: GambleGrill (button) folded before Flop (didn't bet)
Seat 2: Dionakabarbi (small blind) folded before Flop
Seat 3: TriviGn'R (big blind) collected (70)
Seat 4: rapo007 folded before Flop (didn't bet)
Seat 5: vanilaice88 folded before Flop (didn't bet)
Seat 6: buzios38 folded before Flop (didn't bet)
Seat 8: luisnrd folded before Flop (didn't bet)
Seat 9: kylix42 folded before Flop (didn't bet)



PokerStars Hand #157575058950: Tournament #1641817620, $7.50+$7.50+$1.50 USD Hold'em No Limit - Level I (15/30) - 2016/08/21 18:30:08 ET
Table '1641817620 12' 9-max Seat #1 is the button
Seat 1: Vlacerda (5000 in chips) 
Seat 2: aiaolinda (5000 in chips) 
Seat 3: faza29 (5000 in chips) 
Seat 4: Gottlieb007 (5000 in chips) 
Seat 5: ALEX-RSN (5000 in chips) 
Seat 6: MANJUS89 (5000 in chips) 
Seat 7: Mr. Burns501 (5000 in chips) 
Seat 8: CHARRUA1122 (5000 in chips) 
Seat 9: FrankLDrex (5000 in chips) 
Vlacerda: posts the ante 5
aiaolinda: posts the ante 5
faza29: posts the ante 5
Gottlieb007: posts the ante 5
ALEX-RSN: posts the ante 5
MANJUS89: posts the ante 5
Mr. Burns501: posts the ante 5
CHARRUA1122: posts the ante 5
FrankLDrex: posts the ante 5
aiaolinda: posts small blind 15
faza29: posts big blind 30
*** HOLE CARDS ***
Gottlieb007: folds 
ALEX-RSN: folds 
MANJUS89: folds 
Mr. Burns501: folds 
CHARRUA1122: folds 
FrankLDrex: folds 
Vlacerda: raises 49 to 79
aiaolinda: folds 
faza29: calls 49
*** FLOP *** [2h Kc 5h]
faza29: checks 
Vlacerda: bets 145
faza29: folds 
Uncalled bet (145) returned to Vlacerda
Vlacerda collected 218 from pot
Vlacerda: doesn't show hand 
*** SUMMARY ***
Total pot 218 | Rake 0 
Board [2h Kc 5h]
Seat 1: Vlacerda (button) collected (218)
Seat 2: aiaolinda (small blind) folded before Flop
Seat 3: faza29 (big blind) folded on the Flop
Seat 4: Gottlieb007 folded before Flop (didn't bet)
Seat 5: ALEX-RSN folded before Flop (didn't bet)
Seat 6: MANJUS89 folded before Flop (didn't bet)
Seat 7: Mr. Burns501 folded before Flop (didn't bet)
Seat 8: CHARRUA1122 folded before Flop (didn't bet)
Seat 9: FrankLDrex folded before Flop (didn't bet)



PokerStars Hand #157575058951: Tournament #1641817620, $7.50+$7.50+$1.50 USD Hold'em No Limit - Level I (15/30) - 2016/08/21 18:30:08 ET
Table '1641817620 13' 9-max Seat #1 is the button
Seat 1: Mindthis (5000 in chips) 
Seat 2: nicka501 (5000 in chips) 
Seat 3: POG_Q4 (5000 in chips) 
Seat 5: Soul4444 (5000 in chips) 
Seat 6: MicroStaker5 (5000 in chips) 
Seat 7: MrMalaLeche (5000 in chips) 
Seat 8: EdsonPecly (5000 in chips) 
Seat 9: w4lrusk4ne (5000 in chips) 
Mindthis: posts the ante 5
nicka501: posts the ante 5
POG_Q4: posts the ante 5
Soul4444: posts the ante 5
MicroStaker5: posts the ante 5
MrMalaLeche: posts the ante 5
EdsonPecly: posts the ante 5
w4lrusk4ne: posts the ante 5
nicka501: posts small blind 15
POG_Q4: posts big blind 30
*** HOLE CARDS ***
Soul4444: folds 
MicroStaker5: folds 
MrMalaLeche: folds 
EdsonPecly: raises 51 to 81
w4lrusk4ne: calls 81
Mindthis: folds 
nicka501: calls 66
POG_Q4: calls 51
*** FLOP *** [Js 3c 4d]
nicka501: bets 182
POG_Q4: folds 
EdsonPecly: folds 
w4lrusk4ne: raises 553 to 735
nicka501: calls 553
*** TURN *** [Js 3c 4d] [2s]
nicka501: checks 
w4lrusk4ne: bets 1393
nicka501: calls 1393
*** RIVER *** [Js 3c 4d 2s] [Qc]
nicka501: bets 2786 and is all-in
w4lrusk4ne: calls 2786 and is all-in
*** SHOW DOWN ***
nicka501: shows [Jh Qd] (two pair, Queens and Jacks)
w4lrusk4ne: shows [Jd Ad] (a pair of Jacks)
nicka501 collected 10192 from pot
nicka501 wins $3.75 for eliminating w4lrusk4ne and their own bounty increases by $3.75 to $11.25
w4lrusk4ne finished the tournament in 999999999th place
*** SUMMARY ***
Total pot 10192 | Rake 0 
Board [Js 3c 4d 2s Qc]
Seat 1: Mindthis (button) folded before Flop (didn't bet)
Seat 2: nicka501 (small blind) showed [Jh Qd] and won (10192) with two pair, Queens and Jacks
Seat 3: POG_Q4 (big blind) folded on the Flop
Seat 5: Soul4444 folded before Flop (didn't bet)
Seat 6: MicroStaker5 folded before Flop (didn't bet)
Seat 7: MrMalaLeche folded before Flop (didn't bet)
Seat 8: EdsonPecly folded on the Flop
Seat 9: w4lrusk4ne showed [Jd Ad] and lost with a pair of Jacks



PokerStars Hand #157575058952: Tournament #1641817620, $7.50+$7.50+$1.50 USD Hold'em No Limit - Level I (15/30) - 2016/08/21 18:30:08 ET
Table '1641817620 14' 9-max Seat #1 is the button
Seat 1: japazzz1001 (5000 in chips) 
Seat 2: zigolo77 (5000 in chips) 
Seat 3: $Koha$88 (5000 in chips) 
Seat 4: Ed_brisal (5000 in chips) 
Seat 6: sweetlips6 (5000 in chips) 
Seat 7: zerowiec (5000 in chips) 
Seat 8: tim_pro_405! (5000 in chips) 
Seat 9: bacibaci67 (5000 in chips) 
japazzz1001: posts the ante 5
zigolo77: posts the ante 5
$Koha$88: posts the ante 5
Ed_brisal: posts the ante 5
sweetlips6: posts the ante 5
zerowiec: posts the ante 5
tim_pro_405!: posts the ante 5
bacibaci67: posts the ante 5
zigolo77: posts small blind 15
$Koha$88: posts big blind 30
*** HOLE CARDS ***
Ed_brisal: folds 
sweetlips6: raises 60 to 90
zerowiec: folds 
tim_pro_405!: folds 
bacibaci67: folds 
japazzz1001: folds 
zigolo77: calls 75
$Koha$88: folds 
*** FLOP *** [Kh 9c 4c]
zigolo77: checks 
sweetlips6: bets 125
zigolo77: calls 125
*** TURN *** [Kh 9c 4c] [2h]
zigolo77: checks 
sweetlips6: checks 
*** RIVER *** [Kh 9c 4c 2h] [Js]
zigolo77: bets 250
sweetlips6: folds 
Uncalled bet (250) returned to zigolo77
zigolo77 collected 500 from pot
zigolo77: doesn't show hand 
*** SUMMARY ***
Total pot 500 | Rake 0 
Board [Kh 9c 4c 2h Js]
Seat 1: japazzz1001 (button) folded before Flop (didn't bet)
Seat 2: zigolo77 (small blind) collected (500)
Seat 3: $Koha$88 (big blind) folded before Flop
Seat 4: Ed_brisal folded before Flop (didn't bet)
Seat 6: sweetlips6 folded on the River
Seat 7: zerowiec folded before Flop (didn't bet)
Seat 8: tim_pro_405! folded before Flop (didn't bet)
Seat 9: bacibaci67 folded before Flop (didn't bet)



PokerStars Hand #157575058953: Tournament #1641817620, $7.50+$7.50+$1.50 USD Hold'em No Limit - Level I (15/30) - 2016/08/21 18:30:08 ET
Table '1641817620 15' 9-max Seat #1 is the button
Seat 1: WRussia (5000 in chips) 
Seat 2: miche1301 (5000 in chips) 
Seat 3: tsolias87 (5000 in chips) 
Seat 4: WickedJuggla (5000 in chips) 
Seat 5: mdf92 (5000 in chips) 
Seat 6: becky88 (5000 in chips) 
Seat 7: Yokiro (5000 in chips) 
Seat 8: Rob.nl (5000 in chips) 
Seat 9: mfalmeidacs (5000 in chips) 
WRussia: posts the ante 5
miche1301: posts the ante 5
tsolias87: posts the ante 5
WickedJuggla: posts the ante 5
mdf92: posts the ante 5
becky88: posts the ante 5
Yokiro: posts the ante 5
Rob.nl: posts the ante 5
mfalmeidacs: posts the ante 5
miche1301: posts small blind 15
tsolias87: posts big blind 30
*** HOLE CARDS ***
WickedJuggla: folds 
mdf92: folds 
becky88: folds 
Yokiro: folds 
Rob.nl: raises 45 to 75
mfalmeidacs: raises 105 to 180
WRussia: calls 180
miche1301: folds 
tsolias87: folds 
Rob.nl: calls 105
*** FLOP *** [5h 3c 3h]
Rob.nl: checks 
mfalmeidacs: bets 210
WRussia: folds 
Rob.nl: folds 
Uncalled bet (210) returned to mfalmeidacs
mfalmeidacs collected 630 from pot
mfalmeidacs: doesn't show hand 
*** SUMMARY ***
Total pot 630 | Rake 0 
Board [5h 3c 3h]
Seat 1: WRussia (button) folded on the Flop
Seat 2: miche1301 (small blind) folded before Flop
Seat 3: tsolias87 (big blind) folded before Flop
Seat 4: WickedJuggla folded before Flop (didn't bet)
Seat 5: mdf92 folded before Flop (didn't bet)
Seat 6: becky88 folded before Flop (didn't bet)
Seat 7: Yokiro folded before Flop (didn't bet)
Seat 8: Rob.nl folded on the Flop
Seat 9: mfalmeidacs collected (630)



PokerStars Hand #157575058954: Tournament #1641817620, $7.50+$7.50+$1.50 USD Hold'em No Limit - Level I (15/30) - 2016/08/21 18:30:08 ET
Table '1641817620 16' 9-max Seat #1 is the button
Seat 1: Kugelbohne79 (5000 in chips) 
Seat 2: Sergei0384 (5000 in chips) 
Seat 3: paschalisbg (5000 in chips) 
Seat 4: Maisiewin (5000 in chips) 
Seat 5: alemaozl (5000 in chips) 
Seat 6: malenkaya17 (5000 in chips) 
Seat 7: burton14 (5000 in chips) 
Seat 8: Miky_Man993 (5000 in chips) 
Seat 9: ziboin (5000 in chips) 
Kugelbohne79: posts the ante 5
Sergei0384: posts the ante 5
paschalisbg: posts the ante 5
Maisiewin: posts the ante 5
alemaozl: posts the ante 5
malenkaya17: posts the ante 5
burton14: posts the ante 5
Miky_Man993: posts the ante 5
ziboin: posts the ante 5
Sergei0384: posts small blind 15
paschalisbg: posts big blind 30
*** HOLE CARDS ***
Maisiewin: raises 30 to 60
alemaozl: folds 
malenkaya17: folds 
burton14: folds 
Miky_Man993: calls 60
ziboin: raises 4935 to 4995 and is all-in
Kugelbohne79: folds 
Sergei0384: folds 
paschalisbg: folds 
Maisiewin: folds 
Miky_Man993: folds 
Uncalled bet (4935) returned to ziboin
ziboin collected 270 from pot
ziboin: doesn't show hand 
*** SUMMARY ***
Total pot 270 | Rake 0 
Seat 1: Kugelbohne79 (button) folded before Flop (didn't bet)
Seat 2: Sergei0384 (small blind) folded before Flop
Seat 3: paschalisbg (big blind) folded before Flop
Seat 4: Maisiewin folded before Flop
Seat 5: alemaozl folded before Flop (didn't bet)
Seat 6: malenkaya17 folded before Flop (didn't bet)
Seat 7: burton14 folded before Flop (didn't bet)
Seat 8: Miky_Man993 folded before Flop
Seat 9: ziboin collected (270)



PokerStars Hand #157575058955: Tournament #1641817620, $7.50+$7.50+$1.50 USD Hold'em No Limit - Level I (15/30) - 2016/08/21 18:30:08 ET
Table '1641817620 17' 9-max Seat #1 is the button
Seat 1: guitarist68 (5000 in chips) 
Seat 2: Anton163reg (5000 in chips) 
Seat 3: GoldenBeeM (5000 in chips) 
Seat 4: PETER BEATZ (5000 in chips) 
Seat 5: Brisni (5000 in chips) 
Seat 6: dekota222 (5000 in chips) 
Seat 7: rooney69 (5000 in chips) 
Seat 8: uuvvrr (5000 in chips) 
Seat 9: Samburger514 (5000 in chips) 
guitarist68: posts the ante 5
Anton163reg: posts the ante 5
GoldenBeeM: posts the ante 5
PETER BEATZ: posts the ante 5
Brisni: posts the ante 5
dekota222: posts the ante 5
rooney69: posts the ante 5
uuvvrr: posts the ante 5
Samburger514: posts the ante 5
Anton163reg: posts small blind 15
GoldenBeeM: posts big blind 30
*** HOLE CARDS ***
PETER BEATZ: calls 30
Brisni: folds 
dekota222: folds 
rooney69: raises 120 to 150
uuvvrr: folds 
Samburger514: folds 
guitarist68: folds 
Anton163reg: folds 
GoldenBeeM: folds 
PETER BEATZ: calls 120
*** FLOP *** [Qh 5h 4d]
PETER BEATZ: checks 
rooney69: bets 249
PETER BEATZ: folds 
Uncalled bet (249) returned to rooney69
rooney69 collected 390 from pot
*** SUMMARY ***
Total pot 390 | Rake 0 
Board [Qh 5h 4d]
Seat 1: guitarist68 (button) folded before Flop (didn't bet)
Seat 2: Anton163reg (small blind) folded before Flop
Seat 3: GoldenBeeM (big blind) folded before Flop
Seat 4: PETER BEATZ folded on the Flop
Seat 5: Brisni folded before Flop (didn't bet)
Seat 6: dekota222 folded before Flop (didn't bet)
Seat 7: rooney69 collected (390)
Seat 8: uuvvrr folded before Flop (didn't bet)
Seat 9: Samburger514 folded before Flop (didn't bet)



PokerStars Hand #157575058956: Tournament #1641817620, $7.50+$7.50+$1.50 USD Hold'em No Limit - Level I (15/30) - 2016/08/21 18:30:08 ET
Table '1641817620 18' 9-max Seat #1 is the button
Seat 1: Declan387 (5000 in chips) 
Seat 2: silvina35 (5000 in chips) 
Seat 3: TBP23 (5000 in chips) 
Seat 4: One_Cigar (5000 in chips) 
Seat 5: 111santos (5000 in chips) 
Seat 6: Krauser2589 (5000 in chips) 
Seat 7: shaxmatiist (5000 in chips) 
Seat 8: Lestatdiego (5000 in chips) 
Seat 9: kokandija (5000 in chips) 
Declan387: posts the ante 5
silvina35: posts the ante 5
TBP23: posts the ante 5
One_Cigar: posts the ante 5
111santos: posts the ante 5
Krauser2589: posts the ante 5
shaxmatiist: posts the ante 5
Lestatdiego: posts the ante 5
kokandija: posts the ante 5
silvina35: posts small blind 15
TBP23: posts big blind 30
*** HOLE CARDS ***
One_Cigar: folds 
111santos: folds 
Krauser2589: folds 
shaxmatiist: folds 
Lestatdiego: raises 33 to 63
kokandija: calls 63
Declan387: calls 63
silvina35: calls 48
TBP23: calls 33
*** FLOP *** [Td 2s 2d]
silvina35: checks 
TBP23: checks 
Lestatdiego: bets 180
kokandija: calls 180
Declan387: raises 270 to 450
silvina35: folds 
TBP23: calls 450
Lestatdiego: folds 
kokandija: raises 4482 to 4932 and is all-in
Declan387: folds 
TBP23: folds 
Uncalled bet (4482) returned to kokandija
kokandija collected 1890 from pot
*** SUMMARY ***
Total pot 1890 | Rake 0 
Board [Td 2s 2d]
Seat 1: Declan387 (button) folded on the Flop
Seat 2: silvina35 (small blind) folded on the Flop
Seat 3: TBP23 (big blind) folded on the Flop
Seat 4: One_Cigar folded before Flop (didn't bet)
Seat 5: 111santos folded before Flop (didn't bet)
Seat 6: Krauser2589 folded before Flop (didn't bet)
Seat 7: shaxmatiist folded before Flop (didn't bet)
Seat 8: Lestatdiego folded on the Flop
Seat 9: kokandija collected (1890)



PokerStars Hand #157575058957: Tournament #1641817620, $7.50+$7.50+$1.50 USD Hold'em No Limit - Level I (15/30) - 2016/08/21 18:30:08 ET
Table '1641817620 19' 9-max Seat #1 is the button
Seat 1: ArskaTheMan (5000 in chips) 
Seat 2: renem24 (5000 in chips) 
Seat 3: Paparazzi507 (5000 in chips) is sitting out
Seat 4: amondelo (5000 in chips) 
Seat 5: guydoune1 (5000 in chips) 
Seat 6: flutzke90 (5000 in chips) 
Seat 7: MrSerks78 (5000 in chips) 
Seat 8: le_chefe28 (5000 in chips) 
Seat 9: naumans (5000 in chips) 
ArskaTheMan: posts the ante 5
renem24: posts the ante 5
Paparazzi507: posts the ante 5
amondelo: posts the ante 5
guydoune1: posts the ante 5
flutzke90: posts the ante 5
MrSerks78: posts the ante 5
le_chefe28: posts the ante 5
naumans: posts the ante 5
renem24: posts small blind 15
Paparazzi507: posts big blind 30
*** HOLE CARDS ***
amondelo: folds 
guydoune1: raises 30 to 60
flutzke90: folds 
Paparazzi507 has returned
MrSerks78: calls 60
le_chefe28: folds 
naumans: folds 
ArskaTheMan: folds 
renem24: folds 
Paparazzi507: calls 30
*** FLOP *** [Ah 7d Ts]
Paparazzi507: bets 65
guydoune1: folds 
MrSerks78: calls 65
*** TURN *** [Ah 7d Ts] [Kd]
Paparazzi507: checks 
MrSerks78: bets 360
Paparazzi507: calls 360
*** RIVER *** [Ah 7d Ts Kd] [4s]
Paparazzi507: checks 
MrSerks78: checks 
*** SHOW DOWN ***
Paparazzi507: shows [7s Qs] (a pair of Sevens)
MrSerks78: shows [Ad 8c] (a pair of Aces)
MrSerks78 collected 1090 from pot
*** SUMMARY ***
Total pot 1090 | Rake 0 
Board [Ah 7d Ts Kd 4s]
Seat 1: ArskaTheMan (button) folded before Flop (didn't bet)
Seat 2: renem24 (small blind) folded before Flop
Seat 3: Paparazzi507 (big blind) showed [7s Qs] and lost with a pair of Sevens
Seat 4: amondelo folded before Flop (didn't bet)
Seat 5: guydoune1 folded on the Flop
Seat 6: flutzke90 folded before Flop (didn't bet)
Seat 7: MrSerks78 showed [Ad 8c] and won (1090) with a pair of Aces
Seat 8: le_chefe28 folded before Flop (didn't bet)
Seat 9: naumans folded before Flop (didn't bet)



PokerStars Hand #157575058958: Tournament #1641817620, $7.50+$7.50+$1.50 USD Hold'em No Limit - Level I (15/30) - 2016/08/21 18:30:08 ET
Table '1641817620 20' 9-max Seat #1 is the button
Seat 1: Showdown pl (5000 in chips) 
Seat 2: tomus_ero (5000 in chips) 
Seat 3: Tiffany8888 (5000 in chips) 
Seat 4: brainpleaser (5000 in chips) 
Seat 5: msantos0123 (5000 in chips) 
Seat 6: TuckYouIn (5000 in chips) 
Seat 7: anniczka (5000 in chips) 
Seat 8: profChaos780 (5000 in chips) 
Seat 9: chezzetcook2 (5000 in chips) 
Showdown pl: posts the ante 5
tomus_ero: posts the ante 5
Tiffany8888: posts the ante 5
brainpleaser: posts the ante 5
msantos0123: posts the ante 5
TuckYouIn: posts the ante 5
anniczka: posts the ante 5
profChaos780: posts the ante 5
chezzetcook2: posts the ante 5
tomus_ero: posts small blind 15
Tiffany8888: posts big blind 30
*** HOLE CARDS ***
brainpleaser: calls 30
msantos0123: folds 
TuckYouIn: raises 120 to 150
anniczka: calls 150
profChaos780: calls 150
chezzetcook2: folds 
Showdown pl: folds 
tomus_ero: folds 
Tiffany8888: folds 
brainpleaser: calls 120
*** FLOP *** [5c As 7s]
brainpleaser: checks 
TuckYouIn: checks 
anniczka: checks 
profChaos780: bets 372
brainpleaser: calls 372
TuckYouIn: folds 
anniczka: calls 372
*** TURN *** [5c As 7s] [Kh]
brainpleaser: checks 
anniczka: checks 
profChaos780: checks 
*** RIVER *** [5c As 7s Kh] [Kd]
brainpleaser: checks 
anniczka: checks 
profChaos780: checks 
*** SHOW DOWN ***
brainpleaser: shows [Jc 7c] (two pair, Kings and Sevens)
anniczka: shows [8d 8s] (two pair, Kings and Eights)
profChaos780: mucks hand 
anniczka collected 1806 from pot
*** SUMMARY ***
Total pot 1806 | Rake 0 
Board [5c As 7s Kh Kd]
Seat 1: Showdown pl (button) folded before Flop (didn't bet)
Seat 2: tomus_ero (small blind) folded before Flop
Seat 3: Tiffany8888 (big blind) folded before Flop
Seat 4: brainpleaser showed [Jc 7c] and lost with two pair, Kings and Sevens
Seat 5: msantos0123 folded before Flop (didn't bet)
Seat 6: TuckYouIn folded on the Flop
Seat 7: anniczka showed [8d 8s] and won (1806) with two pair, Kings and Eights
Seat 8: profChaos780 mucked
Seat 9: chezzetcook2 folded before Flop (didn't bet)



PokerStars Hand #157575058959: Tournament #1641817620, $7.50+$7.50+$1.50 USD Hold'em No Limit - Level I (15/30) - 2016/08/21 18:30:08 ET
Table '1641817620 21' 9-max Seat #1 is the button
Seat 1: apaixtos1 (5000 in chips) 
Seat 2: ukr_durrrr (5000 in chips) 
Seat 3: ultgamb (5000 in chips) 
Seat 4: fishin1981 (5000 in chips) 
Seat 5: jeroma123 (5000 in chips) 
Seat 6: olleggi (5000 in chips) 
Seat 7: pokerlazik (5000 in chips) 
Seat 8: pokerist2692 (5000 in chips) 
Seat 9: Ferrazz (5000 in chips) 
apaixtos1: posts the ante 5
ukr_durrrr: posts the ante 5
ultgamb: posts the ante 5
fishin1981: posts the ante 5
jeroma123: posts the ante 5
olleggi: posts the ante 5
pokerlazik: posts the ante 5
pokerist2692: posts the ante 5
Ferrazz: posts the ante 5
ukr_durrrr: posts small blind 15
ultgamb: posts big blind 30
*** HOLE CARDS ***
fishin1981: folds 
jeroma123: folds 
olleggi: raises 60 to 90
pokerlazik: folds 
pokerist2692: folds 
Ferrazz: folds 
apaixtos1: folds 
ukr_durrrr: folds 
ultgamb: folds 
Uncalled bet (60) returned to olleggi
olleggi collected 120 from pot
olleggi: doesn't show hand 
*** SUMMARY ***
Total pot 120 | Rake 0 
Seat 1: apaixtos1 (button) folded before Flop (didn't bet)
Seat 2: ukr_durrrr (small blind) folded before Flop
Seat 3: ultgamb (big blind) folded before Flop
Seat 4: fishin1981 folded before Flop (didn't bet)
Seat 5: jeroma123 folded before Flop (didn't bet)
Seat 6: olleggi collected (120)
Seat 7: pokerlazik folded before Flop (didn't bet)
Seat 8: pokerist2692 folded before Flop (didn't bet)
Seat 9: Ferrazz folded before Flop (didn't bet)



PokerStars Hand #157575058960: Tournament #1641817620, $7.50+$7.50+$1.50 USD Hold'em No Limit - Level I (15/30) - 2016/08/21 18:30:08 ET
Table '1641817620 22' 9-max Seat #1 is the button
Seat 1: glangglang (5000 in chips) 
Seat 2: skalistair (5000 in chips) 
Seat 3: CHININ118 (5000 in chips) 
Seat 4: Jaliplay (5000 in chips) 
Seat 5: hewx (5000 in chips) 
Seat 6: xxSTORMZYxx (5000 in chips) 
Seat 7: ogotop76 (5000 in chips) 
Seat 8: monterreymx (5000 in chips) 
Seat 9: cash4king (5000 in chips) 
glangglang: posts the ante 5
skalistair: posts the ante 5
CHININ118: posts the ante 5
Jaliplay: posts the ante 5
hewx: posts the ante 5
xxSTORMZYxx: posts the ante 5
ogotop76: posts the ante 5
monterreymx: posts the ante 5
cash4king: posts the ante 5
skalistair: posts small blind 15
CHININ118: posts big blind 30
*** HOLE CARDS ***
Jaliplay: raises 60 to 90
hewx: folds 
xxSTORMZYxx: folds 
ogotop76: folds 
monterreymx: folds 
cash4king: folds 
glangglang: folds 
skalistair: calls 75
CHININ118: folds 
*** FLOP *** [Ah 5s 9c]
skalistair: checks 
Jaliplay: bets 150
skalistair: folds 
Uncalled bet (150) returned to Jaliplay
Jaliplay collected 255 from pot
*** SUMMARY ***
Total pot 255 | Rake 0 
Board [Ah 5s 9c]
Seat 1: glangglang (button) folded before Flop (didn't bet)
Seat 2: skalistair (small blind) folded on the Flop
Seat 3: CHININ118 (big blind) folded before Flop
Seat 4: Jaliplay collected (255)
Seat 5: hewx folded before Flop (didn't bet)
Seat 6: xxSTORMZYxx folded before Flop (didn't bet)
Seat 7: ogotop76 folded before Flop (didn't bet)
Seat 8: monterreymx folded before Flop (didn't bet)
Seat 9: cash4king folded before Flop (didn't bet)



PokerStars Hand #157575058961: Tournament #1641817620, $7.50+$7.50+$1.50 USD Hold'em No Limit - Level I (15/30) - 2016/08/21 18:30:08 ET
Table '1641817620 23' 9-max Seat #1 is the button
Seat 1: Cepillo (5000 in chips) 
Seat 2: erfan86 (5000 in chips) 
Seat 3: derkimos (5000 in chips) 
Seat 4: Carlos11497 (5000 in chips) 
Seat 5: MickJagger86 (5000 in chips) 
Seat 6: Feyenoord0020 (5000 in chips) 
Seat 7: jradjo21 (5000 in chips) 
Seat 8: kajarana (5000 in chips) 
Seat 9: -MCASLAN7- (5000 in chips) 
Cepillo: posts the ante 5
erfan86: posts the ante 5
derkimos: posts the ante 5
Carlos11497: posts the ante 5
MickJagger86: posts the ante 5
Feyenoord0020: posts the ante 5
jradjo21: posts the ante 5
kajarana: posts the ante 5
-MCASLAN7-: posts the ante 5
erfan86: posts small blind 15
derkimos: posts big blind 30
*** HOLE CARDS ***
Carlos11497: folds 
MickJagger86: folds 
Feyenoord0020: folds 
jradjo21: folds 
kajarana: folds 
-MCASLAN7-: calls 30
Cepillo: folds 
erfan86: folds 
derkimos: checks 
*** FLOP *** [Ts 2s Jd]
derkimos: checks 
-MCASLAN7-: checks 
*** TURN *** [Ts 2s Jd] [9c]
derkimos: bets 30
-MCASLAN7-: calls 30
*** RIVER *** [Ts 2s Jd 9c] [8c]
derkimos: checks 
-MCASLAN7-: bets 126
derkimos: folds 
Uncalled bet (126) returned to -MCASLAN7-
-MCASLAN7- collected 180 from pot
-MCASLAN7-: doesn't show hand 
*** SUMMARY ***
Total pot 180 | Rake 0 
Board [Ts 2s Jd 9c 8c]
Seat 1: Cepillo (button) folded before Flop (didn't bet)
Seat 2: erfan86 (small blind) folded before Flop
Seat 3: derkimos (big blind) folded on the River
Seat 4: Carlos11497 folded before Flop (didn't bet)
Seat 5: MickJagger86 folded before Flop (didn't bet)
Seat 6: Feyenoord0020 folded before Flop (didn't bet)
Seat 7: jradjo21 folded before Flop (didn't bet)
Seat 8: kajarana folded before Flop (didn't bet)
Seat 9: -MCASLAN7- collected (180)



PokerStars Hand #157575058962: Tournament #1641817620, $7.50+$7.50+$1.50 USD Hold'em No Limit - Level I (15/30) - 2016/08/21 18:30:08 ET
Table '1641817620 24' 9-max Seat #1 is the button
Seat 1: heyyy presto (5000 in chips) 
Seat 2: BOW300 (5000 in chips) 
Seat 3: muskto (5000 in chips) 
Seat 4: jt3x87 (5000 in chips) 
Seat 5: PhaniaX (5000 in chips) 
Seat 6: pisti801 (5000 in chips) 
Seat 7: luckydayn (5000 in chips) 
Seat 8: trabey (5000 in chips) 
Seat 9: Quickcard (5000 in chips) is sitting out
heyyy presto: posts the ante 5
BOW300: posts the ante 5
muskto: posts the ante 5
jt3x87: posts the ante 5
PhaniaX: posts the ante 5
pisti801: posts the ante 5
luckydayn: posts the ante 5
trabey: posts the ante 5
Quickcard: posts the ante 5
BOW300: posts small blind 15
muskto: posts big blind 30
*** HOLE CARDS ***
jt3x87: folds 
PhaniaX: folds 
pisti801: folds 
luckydayn: raises 30 to 60
trabey: folds 
Quickcard: folds 
heyyy presto: folds 
BOW300: calls 45
muskto: calls 30
*** FLOP *** [Ac 5d 5s]
BOW300: checks 
muskto: checks 
luckydayn: bets 90
BOW300: folds 
muskto: folds 
Uncalled bet (90) returned to luckydayn
luckydayn collected 225 from pot
luckydayn: doesn't show hand 
*** SUMMARY ***
Total pot 225 | Rake 0 
Board [Ac 5d 5s]
Seat 1: heyyy presto (button) folded before Flop (didn't bet)
Seat 2: BOW300 (small blind) folded on the Flop
Seat 3: muskto (big blind) folded on the Flop
Seat 4: jt3x87 folded before Flop (didn't bet)
Seat 5: PhaniaX folded before Flop (didn't bet)
Seat 6: pisti801 folded before Flop (didn't bet)
Seat 7: luckydayn collected (225)
Seat 8: trabey folded before Flop (didn't bet)
Seat 9: Quickcard folded before Flop (didn't bet)



PokerStars Hand #157575058963: Tournament #1641817620, $7.50+$7.50+$1.50 USD Hold'em No Limit - Level I (15/30) - 2016/08/21 18:30:08 ET
Table '1641817620 25' 9-max Seat #1 is the button
Seat 1: MoW3R (5000 in chips) 
Seat 2: pirus157 (5000 in chips) 
Seat 3: MaxBracht (5000 in chips) 
Seat 4: Rex Nelson (5000 in chips) 
Seat 5: ArKip (5000 in chips) 
Seat 6: xxxDOUxxx (5000 in chips) 
Seat 7: AAnaKKonda (5000 in chips) 
Seat 8: Mad Dionysus (5000 in chips) 
Seat 9: IwillCall3 (5000 in chips) 
MoW3R: posts the ante 5
pirus157: posts the ante 5
MaxBracht: posts the ante 5
Rex Nelson: posts the ante 5
ArKip: posts the ante 5
xxxDOUxxx: posts the ante 5
AAnaKKonda: posts the ante 5
Mad Dionysus: posts the ante 5
IwillCall3: posts the ante 5
pirus157: posts small blind 15
MaxBracht: posts big blind 30
*** HOLE CARDS ***
Rex Nelson: raises 60 to 90
ArKip: folds 
xxxDOUxxx: folds 
AAnaKKonda: folds 
Mad Dionysus: folds 
IwillCall3: folds 
MoW3R: folds 
pirus157: calls 75
MaxBracht: calls 60
*** FLOP *** [9c 3d 5s]
pirus157: bets 315
MaxBracht: folds 
Rex Nelson: folds 
Uncalled bet (315) returned to pirus157
pirus157 collected 315 from pot
pirus157: doesn't show hand 
*** SUMMARY ***
Total pot 315 | Rake 0 
Board [9c 3d 5s]
Seat 1: MoW3R (button) folded before Flop (didn't bet)
Seat 2: pirus157 (small blind) collected (315)
Seat 3: MaxBracht (big blind) folded on the Flop
Seat 4: Rex Nelson folded on the Flop
Seat 5: ArKip folded before Flop (didn't bet)
Seat 6: xxxDOUxxx folded before Flop (didn't bet)
Seat 7: AAnaKKonda folded before Flop (didn't bet)
Seat 8: Mad Dionysus folded before Flop (didn't bet)
Seat 9: IwillCall3 folded before Flop (didn't bet)



PokerStars Hand #157575058964: Tournament #1641817620, $7.50+$7.50+$1.50 USD Hold'em No Limit - Level I (15/30) - 2016/08/21 18:30:08 ET
Table '1641817620 26' 9-max Seat #1 is the button
Seat 1: duplo1182 (5000 in chips) 
Seat 2: Heretic66688 (5000 in chips) 
Seat 3: Axkj (5000 in chips) 
Seat 4: h1per1on (5000 in chips) 
Seat 5: xmommybearx (5000 in chips) 
Seat 6: Archibal_17 (5000 in chips) 
Seat 7: GDLW26 (5000 in chips) 
Seat 8: LongTermTILT (5000 in chips) 
Seat 9: danius111 (5000 in chips) 
duplo1182: posts the ante 5
Heretic66688: posts the ante 5
Axkj: posts the ante 5
h1per1on: posts the ante 5
xmommybearx: posts the ante 5
Archibal_17: posts the ante 5
GDLW26: posts the ante 5
LongTermTILT: posts the ante 5
danius111: posts the ante 5
Heretic66688: posts small blind 15
Axkj: posts big blind 30
*** HOLE CARDS ***
h1per1on: folds 
xmommybearx: calls 30
Archibal_17: calls 30
GDLW26: folds 
LongTermTILT: raises 120 to 150
danius111: folds 
duplo1182: folds 
Heretic66688: folds 
Axkj: folds 
xmommybearx: calls 120
Archibal_17: calls 120
*** FLOP *** [Th 6h 2d]
xmommybearx: checks 
Archibal_17: checks 
LongTermTILT: bets 420
xmommybearx: folds 
Archibal_17: folds 
Uncalled bet (420) returned to LongTermTILT
LongTermTILT collected 540 from pot
LongTermTILT: doesn't show hand 
*** SUMMARY ***
Total pot 540 | Rake 0 
Board [Th 6h 2d]
Seat 1: duplo1182 (button) folded before Flop (didn't bet)
Seat 2: Heretic66688 (small blind) folded before Flop
Seat 3: Axkj (big blind) folded before Flop
Seat 4: h1per1on folded before Flop (didn't bet)
Seat 5: xmommybearx folded on the Flop
Seat 6: Archibal_17 folded on the Flop
Seat 7: GDLW26 folded before Flop (didn't bet)
Seat 8: LongTermTILT collected (540)
Seat 9: danius111 folded before Flop (didn't bet)



PokerStars Hand #157575058965: Tournament #1641817620, $7.50+$7.50+$1.50 USD Hold'em No Limit - Level I (15/30) - 2016/08/21 18:30:08 ET
Table '1641817620 27' 9-max Seat #1 is the button
Seat 1: TheKaisa87 (5000 in chips) 
Seat 2: msksevart (5000 in chips) 
Seat 3: SweetieSpy (5000 in chips) 
Seat 4: Mr_Buckworth (5000 in chips) 
Seat 5: ladymadon107 (5000 in chips) 
Seat 6: 6aDyHtry (5000 in chips) 
Seat 7: csfreak (5000 in chips) 
Seat 8: PavelGav1 (5000 in chips) 
Seat 9: kyzyldurrr (5000 in chips) 
TheKaisa87: posts the ante 5
msksevart: posts the ante 5
SweetieSpy: posts the ante 5
Mr_Buckworth: posts the ante 5
ladymadon107: posts the ante 5
6aDyHtry: posts the ante 5
csfreak: posts the ante 5
PavelGav1: posts the ante 5
kyzyldurrr: posts the ante 5
msksevart: posts small blind 15
SweetieSpy: posts big blind 30
*** HOLE CARDS ***
Mr_Buckworth: folds 
ladymadon107: raises 60 to 90
6aDyHtry: calls 90
csfreak: folds 
PavelGav1: folds 
kyzyldurrr: folds 
TheKaisa87: folds 
msksevart: folds 
SweetieSpy: calls 60
*** FLOP *** [2d Qc Ts]
SweetieSpy: bets 150
ladymadon107: calls 150
6aDyHtry: calls 150
*** TURN *** [2d Qc Ts] [9h]
SweetieSpy: bets 390
ladymadon107: calls 390
6aDyHtry: calls 390
*** RIVER *** [2d Qc Ts 9h] [Qs]
SweetieSpy: bets 960
ladymadon107: folds 
6aDyHtry: folds 
Uncalled bet (960) returned to SweetieSpy
SweetieSpy collected 1950 from pot
*** SUMMARY ***
Total pot 1950 | Rake 0 
Board [2d Qc Ts 9h Qs]
Seat 1: TheKaisa87 (button) folded before Flop (didn't bet)
Seat 2: msksevart (small blind) folded before Flop
Seat 3: SweetieSpy (big blind) collected (1950)
Seat 4: Mr_Buckworth folded before Flop (didn't bet)
Seat 5: ladymadon107 folded on the River
Seat 6: 6aDyHtry folded on the River
Seat 7: csfreak folded before Flop (didn't bet)
Seat 8: PavelGav1 folded before Flop (didn't bet)
Seat 9: kyzyldurrr folded before Flop (didn't bet)



PokerStars Hand #157575058966: Tournament #1641817620, $7.50+$7.50+$1.50 USD Hold'em No Limit - Level I (15/30) - 2016/08/21 18:30:08 ET
Table '1641817620 28' 9-max Seat #1 is the button
Seat 1: kidprodigy44 (5000 in chips) 
Seat 2: jamaika high (5000 in chips) 
Seat 3: cairob (5000 in chips) 
Seat 4: NIKOLACG (5000 in chips) 
Seat 5: neckbr4ke (5000 in chips) 
Seat 6: Quaysie (5000 in chips) 
Seat 7: d3ment0r (5000 in chips) 
Seat 8: papan9_p$ (5000 in chips) 
Seat 9: benjicleo (5000 in chips) 
kidprodigy44: posts the ante 5
jamaika high: posts the ante 5
cairob: posts the ante 5
NIKOLACG: posts the ante 5
neckbr4ke: posts the ante 5
Quaysie: posts the ante 5
d3ment0r: posts the ante 5
papan9_p$: posts the ante 5
benjicleo: posts the ante 5
jamaika high: posts small blind 15
cairob: posts big blind 30
*** HOLE CARDS ***
jamaika high said, "Hi öschi"
NIKOLACG: raises 30 to 60
neckbr4ke: folds 
Quaysie: folds 
d3ment0r: calls 60
papan9_p$: folds 
benjicleo: folds 
kidprodigy44: folds 
jamaika high: calls 45
cairob: folds 
*** FLOP *** [Jh 7h 2d]
jamaika high: checks 
NIKOLACG: bets 127
d3ment0r: calls 127
jamaika high: calls 127
*** TURN *** [Jh 7h 2d] [8h]
jamaika high: checks 
NIKOLACG: bets 318
d3ment0r: calls 318
jamaika high: calls 318
*** RIVER *** [Jh 7h 2d 8h] [9s]
jamaika high: checks 
NIKOLACG: checks 
d3ment0r: bets 1020
jamaika high: calls 1020
NIKOLACG: calls 1020
*** SHOW DOWN ***
d3ment0r: shows [Th 9h] (a straight flush, Seven to Jack)
jamaika high: mucks hand 
NIKOLACG: mucks hand 
d3ment0r collected 4650 from pot
*** SUMMARY ***
Total pot 4650 | Rake 0 
Board [Jh 7h 2d 8h 9s]
Seat 1: kidprodigy44 (button) folded before Flop (didn't bet)
Seat 2: jamaika high (small blind) mucked
Seat 3: cairob (big blind) folded before Flop
Seat 4: NIKOLACG mucked
Seat 5: neckbr4ke folded before Flop (didn't bet)
Seat 6: Quaysie folded before Flop (didn't bet)
Seat 7: d3ment0r showed [Th 9h] and won (4650) with a straight flush, Seven to Jack
Seat 8: papan9_p$ folded before Flop (didn't bet)
Seat 9: benjicleo folded before Flop (didn't bet)



PokerStars Hand #157575058967: Tournament #1641817620, $7.50+$7.50+$1.50 USD Hold'em No Limit - Level I (15/30) - 2016/08/21 18:30:08 ET
Table '1641817620 29' 9-max Seat #1 is the button
Seat 1: kidpokerjm89 (5000 in chips) 
Seat 2: niejowicz (5000 in chips) 
Seat 3: Ofbravetight (5000 in chips) 
Seat 4: Ottel (5000 in chips) 
Seat 5: puntoo (5000 in chips) 
Seat 6: Melady77777 (5000 in chips) 
Seat 7: fishfind000 (5000 in chips) 
Seat 8: AcePheres (5000 in chips) 
Seat 9: LAZO30 (5000 in chips) 
kidpokerjm89: posts the ante 5
niejowicz: posts the ante 5
Ofbravetight: posts the ante 5
Ottel: posts the ante 5
puntoo: posts the ante 5
Melady77777: posts the ante 5
fishfind000: posts the ante 5
AcePheres: posts the ante 5
LAZO30: posts the ante 5
niejowicz: posts small blind 15
Ofbravetight: posts big blind 30
*** HOLE CARDS ***
Ottel: folds 
puntoo: raises 60 to 90
Melady77777: folds 
fishfind000: folds 
AcePheres: folds 
LAZO30: folds 
kidpokerjm89: folds 
niejowicz: folds 
Ofbravetight: folds 
Uncalled bet (60) returned to puntoo
puntoo collected 120 from pot
*** SUMMARY ***
Total pot 120 | Rake 0 
Seat 1: kidpokerjm89 (button) folded before Flop (didn't bet)
Seat 2: niejowicz (small blind) folded before Flop
Seat 3: Ofbravetight (big blind) folded before Flop
Seat 4: Ottel folded before Flop (didn't bet)
Seat 5: puntoo collected (120)
Seat 6: Melady77777 folded before Flop (didn't bet)
Seat 7: fishfind000 folded before Flop (didn't bet)
Seat 8: AcePheres folded before Flop (didn't bet)
Seat 9: LAZO30 folded before Flop (didn't bet)



PokerStars Hand #157575058968: Tournament #1641817620, $7.50+$7.50+$1.50 USD Hold'em No Limit - Level I (15/30) - 2016/08/21 18:30:08 ET
Table '1641817620 30' 9-max Seat #1 is the button
Seat 1: riginvl (5000 in chips) 
Seat 2: flashesflash (5000 in chips) 
Seat 3: Drogbaaaaaaa (5000 in chips) 
Seat 4: lordzefiro (5000 in chips) 
Seat 5: islidur99 (5000 in chips) 
Seat 6: jeanjrg1 (5000 in chips) 
Seat 7: GazRaz21 (5000 in chips) 
Seat 8: karlson1986 (5000 in chips) 
Seat 9: YNWA UA (5000 in chips) 
riginvl: posts the ante 5
flashesflash: posts the ante 5
Drogbaaaaaaa: posts the ante 5
lordzefiro: posts the ante 5
islidur99: posts the ante 5
jeanjrg1: posts the ante 5
GazRaz21: posts the ante 5
karlson1986: posts the ante 5
YNWA UA: posts the ante 5
flashesflash: posts small blind 15
Drogbaaaaaaa: posts big blind 30
*** HOLE CARDS ***
lordzefiro: folds 
islidur99: folds 
jeanjrg1: folds 
GazRaz21: calls 30
karlson1986: calls 30
YNWA UA: calls 30
riginvl: folds 
flashesflash: calls 15
Drogbaaaaaaa: checks 
*** FLOP *** [Js Qd 4s]
flashesflash: checks 
Drogbaaaaaaa: checks 
GazRaz21: checks 
karlson1986: bets 90
YNWA UA: folds 
flashesflash: folds 
Drogbaaaaaaa: folds 
GazRaz21: folds 
Uncalled bet (90) returned to karlson1986
karlson1986 collected 195 from pot
*** SUMMARY ***
Total pot 195 | Rake 0 
Board [Js Qd 4s]
Seat 1: riginvl (button) folded before Flop (didn't bet)
Seat 2: flashesflash (small blind) folded on the Flop
Seat 3: Drogbaaaaaaa (big blind) folded on the Flop
Seat 4: lordzefiro folded before Flop (didn't bet)
Seat 5: islidur99 folded before Flop (didn't bet)
Seat 6: jeanjrg1 folded before Flop (didn't bet)
Seat 7: GazRaz21 folded on the Flop
Seat 8: karlson1986 collected (195)
Seat 9: YNWA UA folded on the Flop



PokerStars Hand #157575058969: Tournament #1641817620, $7.50+$7.50+$1.50 USD Hold'em No Limit - Level I (15/30) - 2016/08/21 18:30:08 ET
Table '1641817620 31' 9-max Seat #1 is the button
Seat 1: JmanRz (5000 in chips) 
Seat 2: Esp2011 (5000 in chips) 
Seat 3: karanikolass (5000 in chips) 
Seat 4: Dam4666 (5000 in chips) 
Seat 5: jucielitheco (5000 in chips) 
Seat 6: Ant_md (5000 in chips) 
Seat 7: fkamus (5000 in chips) 
Seat 8: RENA79 (5000 in chips) 
Seat 9: Jack.Siete (5000 in chips) 
JmanRz: posts the ante 5
Esp2011: posts the ante 5
karanikolass: posts the ante 5
Dam4666: posts the ante 5
jucielitheco: posts the ante 5
Ant_md: posts the ante 5
fkamus: posts the ante 5
RENA79: posts the ante 5
Jack.Siete: posts the ante 5
Esp2011: posts small blind 15
karanikolass: posts big blind 30
*** HOLE CARDS ***
Dam4666: folds 
jucielitheco: folds 
Ant_md: folds 
fkamus: folds 
RENA79: folds 
Jack.Siete: folds 
JmanRz: folds 
Esp2011: raises 75 to 105
karanikolass: calls 75
*** FLOP *** [Ad 4h 2h]
Esp2011: bets 109
karanikolass: raises 221 to 330
Esp2011: folds 
Uncalled bet (221) returned to karanikolass
karanikolass collected 473 from pot
karanikolass: doesn't show hand 
*** SUMMARY ***
Total pot 473 | Rake 0 
Board [Ad 4h 2h]
Seat 1: JmanRz (button) folded before Flop (didn't bet)
Seat 2: Esp2011 (small blind) folded on the Flop
Seat 3: karanikolass (big blind) collected (473)
Seat 4: Dam4666 folded before Flop (didn't bet)
Seat 5: jucielitheco folded before Flop (didn't bet)
Seat 6: Ant_md folded before Flop (didn't bet)
Seat 7: fkamus folded before Flop (didn't bet)
Seat 8: RENA79 folded before Flop (didn't bet)
Seat 9: Jack.Siete folded before Flop (didn't bet)



PokerStars Hand #157575058970: Tournament #1641817620, $7.50+$7.50+$1.50 USD Hold'em No Limit - Level I (15/30) - 2016/08/21 18:30:08 ET
Table '1641817620 32' 9-max Seat #1 is the button
Seat 1: RoribeiroS (5000 in chips) 
Seat 2: tomgan (5000 in chips) 
Seat 3: patou99957 (5000 in chips) 
Seat 4: Ferran789999 (5000 in chips) 
Seat 5: bdiddy1313 (5000 in chips) 
Seat 6: 69 hearts 69 (5000 in chips) 
Seat 7: rimis9999 (5000 in chips) 
Seat 8: noah5555 (5000 in chips) 
Seat 9: gamesAREover (5000 in chips) 
RoribeiroS: posts the ante 5
tomgan: posts the ante 5
patou99957: posts the ante 5
Ferran789999: posts the ante 5
bdiddy1313: posts the ante 5
69 hearts 69: posts the ante 5
rimis9999: posts the ante 5
noah5555: posts the ante 5
gamesAREover: posts the ante 5
tomgan: posts small blind 15
patou99957: posts big blind 30
*** HOLE CARDS ***
Ferran789999: folds 
bdiddy1313: folds 
69 hearts 69: folds 
rimis9999: folds 
noah5555: folds 
gamesAREover: raises 60 to 90
RoribeiroS: folds 
tomgan: folds 
patou99957: raises 240 to 330
gamesAREover: folds 
Uncalled bet (240) returned to patou99957
patou99957 collected 240 from pot
patou99957: doesn't show hand 
*** SUMMARY ***
Total pot 240 | Rake 0 
Seat 1: RoribeiroS (button) folded before Flop (didn't bet)
Seat 2: tomgan (small blind) folded before Flop
Seat 3: patou99957 (big blind) collected (240)
Seat 4: Ferran789999 folded before Flop (didn't bet)
Seat 5: bdiddy1313 folded before Flop (didn't bet)
Seat 6: 69 hearts 69 folded before Flop (didn't bet)
Seat 7: rimis9999 folded before Flop (didn't bet)
Seat 8: noah5555 folded before Flop (didn't bet)
Seat 9: gamesAREover folded before Flop



PokerStars Hand #157575058971: Tournament #1641817620, $7.50+$7.50+$1.50 USD Hold'em No Limit - Level I (15/30) - 2016/08/21 18:30:08 ET
Table '1641817620 33' 9-max Seat #1 is the button
Seat 1: fungyou (5000 in chips) 
Seat 2: titauhu (5000 in chips) is sitting out
Seat 3: gmdef.2001 (5000 in chips) 
Seat 4: Charverzard (5000 in chips) 
Seat 5: T@keItDown (5000 in chips) 
Seat 6: REPPARTFLOW (5000 in chips) 
Seat 7: dennismitru (5000 in chips) 
Seat 8: Joao Valli (5000 in chips) 
Seat 9: Pablos701 (5000 in chips) 
fungyou: posts the ante 5
titauhu: posts the ante 5
gmdef.2001: posts the ante 5
Charverzard: posts the ante 5
T@keItDown: posts the ante 5
REPPARTFLOW: posts the ante 5
dennismitru: posts the ante 5
Joao Valli: posts the ante 5
Pablos701: posts the ante 5
titauhu: posts small blind 15
gmdef.2001: posts big blind 30
*** HOLE CARDS ***
Charverzard: folds 
T@keItDown: folds 
REPPARTFLOW: folds 
dennismitru: raises 36 to 66
Joao Valli: folds 
Pablos701: folds 
fungyou: folds 
titauhu: folds 
gmdef.2001: folds 
Uncalled bet (36) returned to dennismitru
dennismitru collected 120 from pot
*** SUMMARY ***
Total pot 120 | Rake 0 
Seat 1: fungyou (button) folded before Flop (didn't bet)
Seat 2: titauhu (small blind) folded before Flop
Seat 3: gmdef.2001 (big blind) folded before Flop
Seat 4: Charverzard folded before Flop (didn't bet)
Seat 5: T@keItDown folded before Flop (didn't bet)
Seat 6: REPPARTFLOW folded before Flop (didn't bet)
Seat 7: dennismitru collected (120)
Seat 8: Joao Valli folded before Flop (didn't bet)
Seat 9: Pablos701 folded before Flop (didn't bet)



PokerStars Hand #157575058972: Tournament #1641817620, $7.50+$7.50+$1.50 USD Hold'em No Limit - Level I (15/30) - 2016/08/21 18:30:08 ET
Table '1641817620 34' 9-max Seat #1 is the button
Seat 1: Zukertort (5000 in chips) is sitting out
Seat 2: AngelBerley (5000 in chips) 
Seat 3: Zigslick (5000 in chips) 
Seat 4: Snabers (5000 in chips) 
Seat 5: juggaletto (5000 in chips) 
Seat 6: virtus213 (5000 in chips) 
Seat 7: Poher42 (5000 in chips) 
Seat 8: S.FILTH (5000 in chips) 
Seat 9: omar miete (5000 in chips) 
Zukertort: posts the ante 5
AngelBerley: posts the ante 5
Zigslick: posts the ante 5
Snabers: posts the ante 5
juggaletto: posts the ante 5
virtus213: posts the ante 5
Poher42: posts the ante 5
S.FILTH: posts the ante 5
omar miete: posts the ante 5
AngelBerley: posts small blind 15
Zigslick: posts big blind 30
*** HOLE CARDS ***
Snabers: folds 
juggaletto: calls 30
virtus213: folds 
Poher42: folds 
S.FILTH: folds 
omar miete: raises 60 to 90
Zukertort: folds 
AngelBerley: folds 
Zigslick: folds 
juggaletto: calls 60
*** FLOP *** [Td 5c 3s]
juggaletto: checks 
omar miete: checks 
*** TURN *** [Td 5c 3s] [2c]
juggaletto: checks 
omar miete: bets 189
juggaletto: folds 
Uncalled bet (189) returned to omar miete
omar miete collected 270 from pot
*** SUMMARY ***
Total pot 270 | Rake 0 
Board [Td 5c 3s 2c]
Seat 1: Zukertort (button) folded before Flop (didn't bet)
Seat 2: AngelBerley (small blind) folded before Flop
Seat 3: Zigslick (big blind) folded before Flop
Seat 4: Snabers folded before Flop (didn't bet)
Seat 5: juggaletto folded on the Turn
Seat 6: virtus213 folded before Flop (didn't bet)
Seat 7: Poher42 folded before Flop (didn't bet)
Seat 8: S.FILTH folded before Flop (didn't bet)
Seat 9: omar miete collected (270)



PokerStars Hand #157575058973: Tournament #1641817620, $7.50+$7.50+$1.50 USD Hold'em No Limit - Level I (15/30) - 2016/08/21 18:30:08 ET
Table '1641817620 35' 9-max Seat #1 is the button
Seat 1: wantuirpoker (5000 in chips) 
Seat 2: Diegodel79 (5000 in chips) 
Seat 3: brunoeffect (5000 in chips) 
Seat 4: PPOrphan (5000 in chips) 
Seat 5: Maza&Lunja (5000 in chips) 
Seat 6: brett88987 (5000 in chips) 
Seat 7: IcaLm (5000 in chips) 
Seat 8: ximenesb (5000 in chips) 
Seat 9: Cosacoman (5000 in chips) 
wantuirpoker: posts the ante 5
Diegodel79: posts the ante 5
brunoeffect: posts the ante 5
PPOrphan: posts the ante 5
Maza&Lunja: posts the ante 5
brett88987: posts the ante 5
IcaLm: posts the ante 5
ximenesb: posts the ante 5
Cosacoman: posts the ante 5
Diegodel79: posts small blind 15
brunoeffect: posts big blind 30
*** HOLE CARDS ***
PPOrphan: folds 
Maza&Lunja: raises 46 to 76
brett88987: folds 
IcaLm: folds 
ximenesb: folds 
Cosacoman: folds 
wantuirpoker: folds 
Diegodel79: folds 
brunoeffect: folds 
Uncalled bet (46) returned to Maza&Lunja
Maza&Lunja collected 120 from pot
*** SUMMARY ***
Total pot 120 | Rake 0 
Seat 1: wantuirpoker (button) folded before Flop (didn't bet)
Seat 2: Diegodel79 (small blind) folded before Flop
Seat 3: brunoeffect (big blind) folded before Flop
Seat 4: PPOrphan folded before Flop (didn't bet)
Seat 5: Maza&Lunja collected (120)
Seat 6: brett88987 folded before Flop (didn't bet)
Seat 7: IcaLm folded before Flop (didn't bet)
Seat 8: ximenesb folded before Flop (didn't bet)
Seat 9: Cosacoman folded before Flop (didn't bet)



PokerStars Hand #157575058974: Tournament #1641817620, $7.50+$7.50+$1.50 USD Hold'em No Limit - Level I (15/30) - 2016/08/21 18:30:08 ET
Table '1641817620 36' 9-max Seat #1 is the button
Seat 1: craiger1976 (5000 in chips) 
Seat 2: Winston4ever (5000 in chips) 
Seat 3: sarxa (5000 in chips) 
Seat 4: titi1984 (5000 in chips) 
Seat 5: blufface88 (5000 in chips) 
Seat 6: xanja (5000 in chips) 
Seat 7: jadrankokec (5000 in chips) 
Seat 8: ruben marley (5000 in chips) 
Seat 9: wowbizz2 (5000 in chips) 
craiger1976: posts the ante 5
Winston4ever: posts the ante 5
sarxa: posts the ante 5
titi1984: posts the ante 5
blufface88: posts the ante 5
xanja: posts the ante 5
jadrankokec: posts the ante 5
ruben marley: posts the ante 5
wowbizz2: posts the ante 5
Winston4ever: posts small blind 15
sarxa: posts big blind 30
*** HOLE CARDS ***
titi1984: folds 
blufface88: raises 60 to 90
xanja: folds 
jadrankokec: folds 
ruben marley: folds 
wowbizz2: folds 
craiger1976: folds 
Winston4ever: calls 75
sarxa: folds 
*** FLOP *** [Qc 4s 5h]
Winston4ever: checks 
blufface88: bets 180
Winston4ever: folds 
Uncalled bet (180) returned to blufface88
blufface88 collected 255 from pot
*** SUMMARY ***
Total pot 255 | Rake 0 
Board [Qc 4s 5h]
Seat 1: craiger1976 (button) folded before Flop (didn't bet)
Seat 2: Winston4ever (small blind) folded on the Flop
Seat 3: sarxa (big blind) folded before Flop
Seat 4: titi1984 folded before Flop (didn't bet)
Seat 5: blufface88 collected (255)
Seat 6: xanja folded before Flop (didn't bet)
Seat 7: jadrankokec folded before Flop (didn't bet)
Seat 8: ruben marley folded before Flop (didn't bet)
Seat 9: wowbizz2 folded before Flop (didn't bet)



PokerStars Hand #157575058975: Tournament #1641817620, $7.50+$7.50+$1.50 USD Hold'em No Limit - Level I (15/30) - 2016/08/21 18:30:08 ET
Table '1641817620 37' 9-max Seat #1 is the button
Seat 1: Youbetipush1 (5000 in chips) 
Seat 2: SouzaEduardo (5000 in chips) 
Seat 3: Maisteri (5000 in chips) 
Seat 4: qball911 (5000 in chips) 
Seat 5: cammyboy777 (5000 in chips) is sitting out
Seat 6: ColdFire_200 (5000 in chips) 
Seat 7: WascllyWabit (5000 in chips) 
Seat 8: Starvinghelp (5000 in chips) 
Seat 9: carabason (5000 in chips) 
Youbetipush1: posts the ante 5
SouzaEduardo: posts the ante 5
Maisteri: posts the ante 5
qball911: posts the ante 5
cammyboy777: posts the ante 5
ColdFire_200: posts the ante 5
WascllyWabit: posts the ante 5
Starvinghelp: posts the ante 5
carabason: posts the ante 5
SouzaEduardo: posts small blind 15
Maisteri: posts big blind 30
*** HOLE CARDS ***
qball911: folds 
cammyboy777: folds 
ColdFire_200: folds 
WascllyWabit: folds 
Starvinghelp: raises 30 to 60
carabason: raises 90 to 150
Youbetipush1: folds 
SouzaEduardo: folds 
Maisteri: folds 
Starvinghelp: calls 90
*** FLOP *** [2c 2s Jc]
Starvinghelp: checks 
carabason: bets 255
Starvinghelp: calls 255
*** TURN *** [2c 2s Jc] [6d]
Starvinghelp: checks 
carabason: bets 645
Starvinghelp: calls 645
*** RIVER *** [2c 2s Jc 6d] [Th]
Starvinghelp: checks 
carabason: bets 2070
Starvinghelp: calls 2070
*** SHOW DOWN ***
carabason: shows [Ks Kc] (two pair, Kings and Deuces)
Starvinghelp: mucks hand 
carabason collected 6330 from pot
*** SUMMARY ***
Total pot 6330 | Rake 0 
Board [2c 2s Jc 6d Th]
Seat 1: Youbetipush1 (button) folded before Flop (didn't bet)
Seat 2: SouzaEduardo (small blind) folded before Flop
Seat 3: Maisteri (big blind) folded before Flop
Seat 4: qball911 folded before Flop (didn't bet)
Seat 5: cammyboy777 folded before Flop (didn't bet)
Seat 6: ColdFire_200 folded before Flop (didn't bet)
Seat 7: WascllyWabit folded before Flop (didn't bet)
Seat 8: Starvinghelp mucked
Seat 9: carabason showed [Ks Kc] and won (6330) with two pair, Kings and Deuces



PokerStars Hand #157575058976: Tournament #1641817620, $7.50+$7.50+$1.50 USD Hold'em No Limit - Level I (15/30) - 2016/08/21 18:30:08 ET
Table '1641817620 38' 9-max Seat #1 is the button
Seat 1: chechako#8 (5000 in chips) 
Seat 2: kristofxm8 (5000 in chips) 
Seat 3: persephoney (5000 in chips) 
Seat 4: BrunoBezerr4 (5000 in chips) 
Seat 5: jager1987 (5000 in chips) 
Seat 6: Dr.Durrrq (5000 in chips) 
Seat 7: Myschkin_Lev (5000 in chips) 
Seat 8: Bon_Choueur (5000 in chips) 
Seat 9: dtb1978 (5000 in chips) 
chechako#8: posts the ante 5
kristofxm8: posts the ante 5
persephoney: posts the ante 5
BrunoBezerr4: posts the ante 5
jager1987: posts the ante 5
Dr.Durrrq: posts the ante 5
Myschkin_Lev: posts the ante 5
Bon_Choueur: posts the ante 5
dtb1978: posts the ante 5
kristofxm8: posts small blind 15
persephoney: posts big blind 30
*** HOLE CARDS ***
BrunoBezerr4: folds 
jager1987: folds 
Dr.Durrrq: raises 45 to 75
Myschkin_Lev: folds 
Bon_Choueur: folds 
dtb1978: folds 
chechako#8: folds 
kristofxm8: folds 
persephoney: calls 45
*** FLOP *** [Jc 6c 8s]
persephoney: checks 
Dr.Durrrq: checks 
*** TURN *** [Jc 6c 8s] [2s]
persephoney: checks 
Dr.Durrrq: checks 
*** RIVER *** [Jc 6c 8s 2s] [6h]
persephoney: checks 
Dr.Durrrq: checks 
*** SHOW DOWN ***
persephoney: shows [7s Ad] (a pair of Sixes)
Dr.Durrrq: shows [Ah 9h] (a pair of Sixes - Ace+Jack+Nine kicker)
Dr.Durrrq collected 210 from pot
*** SUMMARY ***
Total pot 210 | Rake 0 
Board [Jc 6c 8s 2s 6h]
Seat 1: chechako#8 (button) folded before Flop (didn't bet)
Seat 2: kristofxm8 (small blind) folded before Flop
Seat 3: persephoney (big blind) showed [7s Ad] and lost with a pair of Sixes
Seat 4: BrunoBezerr4 folded before Flop (didn't bet)
Seat 5: jager1987 folded before Flop (didn't bet)
Seat 6: Dr.Durrrq showed [Ah 9h] and won (210) with a pair of Sixes
Seat 7: Myschkin_Lev folded before Flop (didn't bet)
Seat 8: Bon_Choueur folded before Flop (didn't bet)
Seat 9: dtb1978 folded before Flop (didn't bet)



PokerStars Hand #157575058977: Tournament #1641817620, $7.50+$7.50+$1.50 USD Hold'em No Limit - Level I (15/30) - 2016/08/21 18:30:08 ET
Table '1641817620 39' 9-max Seat #1 is the button
Seat 1: BuyMeBMW (5000 in chips) 
Seat 2: ahaknh (5000 in chips) 
Seat 3: Crim44 (5000 in chips) 
Seat 4: Neo_gracz (5000 in chips) 
Seat 5: Euan_x (5000 in chips) 
Seat 6: TxsFrUrMoney (5000 in chips) 
Seat 7: j.williams94 (5000 in chips) 
Seat 8: 88K@la88 (5000 in chips) 
Seat 9: Foggy56 (5000 in chips) 
BuyMeBMW: posts the ante 5
ahaknh: posts the ante 5
Crim44: posts the ante 5
Neo_gracz: posts the ante 5
Euan_x: posts the ante 5
TxsFrUrMoney: posts the ante 5
j.williams94: posts the ante 5
88K@la88: posts the ante 5
Foggy56: posts the ante 5
ahaknh: posts small blind 15
Crim44: posts big blind 30
*** HOLE CARDS ***
Neo_gracz: folds 
Euan_x: calls 30
TxsFrUrMoney: folds 
j.williams94: folds 
88K@la88: folds 
Foggy56: calls 30
BuyMeBMW: folds 
ahaknh: calls 15
Crim44: checks 
*** FLOP *** [7c Qd 7h]
ahaknh: checks 
Crim44: checks 
Euan_x: checks 
Foggy56: checks 
*** TURN *** [7c Qd 7h] [6h]
ahaknh: checks 
Crim44: checks 
Euan_x: bets 120
Foggy56: calls 120
ahaknh: folds 
Crim44: folds 
*** RIVER *** [7c Qd 7h 6h] [4c]
Euan_x: checks 
Foggy56: checks 
*** SHOW DOWN ***
Euan_x: shows [Ac 7s] (three of a kind, Sevens)
Foggy56: mucks hand 
Euan_x collected 405 from pot
*** SUMMARY ***
Total pot 405 | Rake 0 
Board [7c Qd 7h 6h 4c]
Seat 1: BuyMeBMW (button) folded before Flop (didn't bet)
Seat 2: ahaknh (small blind) folded on the Turn
Seat 3: Crim44 (big blind) folded on the Turn
Seat 4: Neo_gracz folded before Flop (didn't bet)
Seat 5: Euan_x showed [Ac 7s] and won (405) with three of a kind, Sevens
Seat 6: TxsFrUrMoney folded before Flop (didn't bet)
Seat 7: j.williams94 folded before Flop (didn't bet)
Seat 8: 88K@la88 folded before Flop (didn't bet)
Seat 9: Foggy56 mucked



PokerStars Hand #157575058978: Tournament #1641817620, $7.50+$7.50+$1.50 USD Hold'em No Limit - Level I (15/30) - 2016/08/21 18:30:08 ET
Table '1641817620 40' 9-max Seat #1 is the button
Seat 1: Shiryu100 (5000 in chips) 
Seat 2: nico122527 (5000 in chips) 
Seat 3: ilico (5000 in chips) 
Seat 4: Mr_Giiba (5000 in chips) 
Seat 5: mario342 (5000 in chips) 
Seat 6: MON3Y$HOT (5000 in chips) 
Seat 7: hyratsch (5000 in chips) 
Seat 8: vaggelis1982 (5000 in chips) 
Seat 9: kafu123 (5000 in chips) is sitting out
Shiryu100: posts the ante 5
nico122527: posts the ante 5
ilico: posts the ante 5
Mr_Giiba: posts the ante 5
mario342: posts the ante 5
MON3Y$HOT: posts the ante 5
hyratsch: posts the ante 5
vaggelis1982: posts the ante 5
kafu123: posts the ante 5
nico122527: posts small blind 15
ilico: posts big blind 30
*** HOLE CARDS ***
Mr_Giiba: folds 
mario342: raises 90 to 120
MON3Y$HOT: folds 
hyratsch: calls 120
vaggelis1982: folds 
kafu123: folds 
Shiryu100: folds 
nico122527: folds 
ilico: calls 90
*** FLOP *** [4d 6h 3s]
ilico: checks 
mario342: bets 390
hyratsch: folds 
ilico: folds 
Uncalled bet (390) returned to mario342
mario342 collected 420 from pot
mario342: doesn't show hand 
*** SUMMARY ***
Total pot 420 | Rake 0 
Board [4d 6h 3s]
Seat 1: Shiryu100 (button) folded before Flop (didn't bet)
Seat 2: nico122527 (small blind) folded before Flop
Seat 3: ilico (big blind) folded on the Flop
Seat 4: Mr_Giiba folded before Flop (didn't bet)
Seat 5: mario342 collected (420)
Seat 6: MON3Y$HOT folded before Flop (didn't bet)
Seat 7: hyratsch folded on the Flop
Seat 8: vaggelis1982 folded before Flop (didn't bet)
Seat 9: kafu123 folded before Flop (didn't bet)



PokerStars Hand #157575058979: Tournament #1641817620, $7.50+$7.50+$1.50 USD Hold'em No Limit - Level I (15/30) - 2016/08/21 18:30:08 ET
Table '1641817620 41' 9-max Seat #1 is the button
Seat 1: vettecha (5000 in chips) 
Seat 2: ARAVNOA (5000 in chips) 
Seat 3: FlaxonJin (5000 in chips) 
Seat 4: gigibaston (5000 in chips) 
Seat 5: Jujubh (5000 in chips) 
Seat 6: Matiellão (5000 in chips) 
Seat 7: MayFuNg1979 (5000 in chips) 
Seat 8: relmat (5000 in chips) 
Seat 9: Gwermort (5000 in chips) 
vettecha: posts the ante 5
ARAVNOA: posts the ante 5
FlaxonJin: posts the ante 5
gigibaston: posts the ante 5
Jujubh: posts the ante 5
Matiellão: posts the ante 5
MayFuNg1979: posts the ante 5
relmat: posts the ante 5
Gwermort: posts the ante 5
ARAVNOA: posts small blind 15
FlaxonJin: posts big blind 30
*** HOLE CARDS ***
gigibaston: folds 
Jujubh: raises 60 to 90
Matiellão: folds 
MayFuNg1979: raises 60 to 150
relmat: folds 
Gwermort: folds 
vettecha: folds 
ARAVNOA: folds 
FlaxonJin: folds 
Jujubh: calls 60
*** FLOP *** [2s 8s Qd]
Jujubh: checks 
MayFuNg1979: checks 
*** TURN *** [2s 8s Qd] [2d]
Jujubh: bets 206
MayFuNg1979: calls 206
*** RIVER *** [2s 8s Qd 2d] [Ah]
Jujubh: checks 
MayFuNg1979: checks 
*** SHOW DOWN ***
Jujubh: shows [Ts 9s] (a pair of Deuces)
MayFuNg1979: shows [Td Jd] (a pair of Deuces - Ace+Queen+Jack kicker)
MayFuNg1979 collected 802 from pot
*** SUMMARY ***
Total pot 802 | Rake 0 
Board [2s 8s Qd 2d Ah]
Seat 1: vettecha (button) folded before Flop (didn't bet)
Seat 2: ARAVNOA (small blind) folded before Flop
Seat 3: FlaxonJin (big blind) folded before Flop
Seat 4: gigibaston folded before Flop (didn't bet)
Seat 5: Jujubh showed [Ts 9s] and lost with a pair of Deuces
Seat 6: Matiellão folded before Flop (didn't bet)
Seat 7: MayFuNg1979 showed [Td Jd] and won (802) with a pair of Deuces
Seat 8: relmat folded before Flop (didn't bet)
Seat 9: Gwermort folded before Flop (didn't bet)



PokerStars Hand #157575058980: Tournament #1641817620, $7.50+$7.50+$1.50 USD Hold'em No Limit - Level I (15/30) - 2016/08/21 18:30:08 ET
Table '1641817620 42' 9-max Seat #1 is the button
Seat 1: killa187187 (5000 in chips) 
Seat 2: lmiotto88 (5000 in chips) 
Seat 3: Piiirat (5000 in chips) 
Seat 4: skjørring (5000 in chips) 
Seat 5: AcabeiDeSair (5000 in chips) 
Seat 6: MasterInsekt (5000 in chips) 
Seat 7: ThirtyTw0 (5000 in chips) 
Seat 8: FeFeFeFeFEDE (5000 in chips) 
Seat 9: radekvv777 (5000 in chips) 
killa187187: posts the ante 5
lmiotto88: posts the ante 5
Piiirat: posts the ante 5
skjørring: posts the ante 5
AcabeiDeSair: posts the ante 5
MasterInsekt: posts the ante 5
ThirtyTw0: posts the ante 5
FeFeFeFeFEDE: posts the ante 5
radekvv777: posts the ante 5
lmiotto88: posts small blind 15
Piiirat: posts big blind 30
*** HOLE CARDS ***
skjørring: folds 
AcabeiDeSair: folds 
MasterInsekt: folds 
ThirtyTw0: folds 
FeFeFeFeFEDE: folds 
radekvv777: folds 
killa187187: raises 60 to 90
lmiotto88: calls 75
Piiirat: folds 
*** FLOP *** [Js Jh 4c]
lmiotto88: checks 
killa187187: bets 120
lmiotto88: calls 120
*** TURN *** [Js Jh 4c] [6h]
lmiotto88: checks 
killa187187: checks 
*** RIVER *** [Js Jh 4c 6h] [2s]
lmiotto88: checks 
killa187187: checks 
*** SHOW DOWN ***
lmiotto88: shows [Td As] (a pair of Jacks)
killa187187: mucks hand 
lmiotto88 collected 495 from pot
*** SUMMARY ***
Total pot 495 | Rake 0 
Board [Js Jh 4c 6h 2s]
Seat 1: killa187187 (button) mucked
Seat 2: lmiotto88 (small blind) showed [Td As] and won (495) with a pair of Jacks
Seat 3: Piiirat (big blind) folded before Flop
Seat 4: skjørring folded before Flop (didn't bet)
Seat 5: AcabeiDeSair folded before Flop (didn't bet)
Seat 6: MasterInsekt folded before Flop (didn't bet)
Seat 7: ThirtyTw0 folded before Flop (didn't bet)
Seat 8: FeFeFeFeFEDE folded before Flop (didn't bet)
Seat 9: radekvv777 folded before Flop (didn't bet)



PokerStars Hand #157575058981: Tournament #1641817620, $7.50+$7.50+$1.50 USD Hold'em No Limit - Level I (15/30) - 2016/08/21 18:30:08 ET
Table '1641817620 43' 9-max Seat #1 is the button
Seat 1: VeniG95 (5000 in chips) 
Seat 2: alanyamil (5000 in chips) 
Seat 3: Raulop (5000 in chips) 
Seat 4: SoulSlaye166 (5000 in chips) is sitting out
Seat 5: DimaRu777 (5000 in chips) 
Seat 6: Taima (5000 in chips) 
Seat 7: Caville88 (5000 in chips) 
Seat 8: BetoFolhaCMC (5000 in chips) 
Seat 9: cajool (5000 in chips) 
VeniG95: posts the ante 5
alanyamil: posts the ante 5
Raulop: posts the ante 5
SoulSlaye166: posts the ante 5
DimaRu777: posts the ante 5
Taima: posts the ante 5
Caville88: posts the ante 5
BetoFolhaCMC: posts the ante 5
cajool: posts the ante 5
alanyamil: posts small blind 15
Raulop: posts big blind 30
*** HOLE CARDS ***
SoulSlaye166: folds 
DimaRu777: folds 
SoulSlaye166 has returned
Taima: folds 
Caville88: folds 
BetoFolhaCMC: folds 
cajool: folds 
VeniG95: folds 
alanyamil: calls 15
Raulop: checks 
*** FLOP *** [8c Ad 8d]
alanyamil: checks 
Raulop: checks 
*** TURN *** [8c Ad 8d] [Ks]
alanyamil: bets 60
Raulop: folds 
Uncalled bet (60) returned to alanyamil
alanyamil collected 105 from pot
alanyamil: doesn't show hand 
*** SUMMARY ***
Total pot 105 | Rake 0 
Board [8c Ad 8d Ks]
Seat 1: VeniG95 (button) folded before Flop (didn't bet)
Seat 2: alanyamil (small blind) collected (105)
Seat 3: Raulop (big blind) folded on the Turn
Seat 4: SoulSlaye166 folded before Flop (didn't bet)
Seat 5: DimaRu777 folded before Flop (didn't bet)
Seat 6: Taima folded before Flop (didn't bet)
Seat 7: Caville88 folded before Flop (didn't bet)
Seat 8: BetoFolhaCMC folded before Flop (didn't bet)
Seat 9: cajool folded before Flop (didn't bet)



PokerStars Hand #157575058982: Tournament #1641817620, $7.50+$7.50+$1.50 USD Hold'em No Limit - Level I (15/30) - 2016/08/21 18:30:08 ET
Table '1641817620 44' 9-max Seat #1 is the button
Seat 1: BurrGrylls (5000 in chips) 
Seat 2: moisesgosu (5000 in chips) 
Seat 3: kduwork (5000 in chips) 
Seat 4: starkstud (5000 in chips) 
Seat 5: 55antivirus (5000 in chips) 
Seat 6: lesley hu (5000 in chips) is sitting out
Seat 7: aihongepji32 (5000 in chips) 
Seat 8: heynow21 (5000 in chips) 
Seat 9: Pro_Tunis (5000 in chips) 
BurrGrylls: posts the ante 5
moisesgosu: posts the ante 5
kduwork: posts the ante 5
starkstud: posts the ante 5
55antivirus: posts the ante 5
lesley hu: posts the ante 5
aihongepji32: posts the ante 5
heynow21: posts the ante 5
Pro_Tunis: posts the ante 5
moisesgosu: posts small blind 15
kduwork: posts big blind 30
*** HOLE CARDS ***
starkstud: folds 
55antivirus: folds 
lesley hu: folds 
aihongepji32: folds 
heynow21: folds 
Pro_Tunis: folds 
BurrGrylls: folds 
moisesgosu: folds 
Uncalled bet (15) returned to kduwork
kduwork collected 75 from pot
kduwork: doesn't show hand 
*** SUMMARY ***
Total pot 75 | Rake 0 
Seat 1: BurrGrylls (button) folded before Flop (didn't bet)
Seat 2: moisesgosu (small blind) folded before Flop
Seat 3: kduwork (big blind) collected (75)
Seat 4: starkstud folded before Flop (didn't bet)
Seat 5: 55antivirus folded before Flop (didn't bet)
Seat 6: lesley hu folded before Flop (didn't bet)
Seat 7: aihongepji32 folded before Flop (didn't bet)
Seat 8: heynow21 folded before Flop (didn't bet)
Seat 9: Pro_Tunis folded before Flop (didn't bet)



PokerStars Hand #157575058983: Tournament #1641817620, $7.50+$7.50+$1.50 USD Hold'em No Limit - Level I (15/30) - 2016/08/21 18:30:08 ET
Table '1641817620 45' 9-max Seat #1 is the button
Seat 1: rocky 7 (5000 in chips) 
Seat 2: ldf58 (5000 in chips) 
Seat 3: LifFtD (5000 in chips) 
Seat 4: Grasquet (5000 in chips) 
Seat 5: Mr.Bob-su (5000 in chips) 
Seat 6: CHIT4 (5000 in chips) 
Seat 7: R4ID3R12 (5000 in chips) 
Seat 8: mrbandito27 (5000 in chips) 
Seat 9: Andre Ortega (5000 in chips) 
rocky 7: posts the ante 5
ldf58: posts the ante 5
LifFtD: posts the ante 5
Grasquet: posts the ante 5
Mr.Bob-su: posts the ante 5
CHIT4: posts the ante 5
R4ID3R12: posts the ante 5
mrbandito27: posts the ante 5
Andre Ortega: posts the ante 5
ldf58: posts small blind 15
LifFtD: posts big blind 30
*** HOLE CARDS ***
Grasquet: folds 
Mr.Bob-su: raises 60 to 90
CHIT4: folds 
R4ID3R12: folds 
mrbandito27: calls 90
Andre Ortega: calls 90
rocky 7: folds 
ldf58: folds 
LifFtD has timed out
LifFtD: folds 
*** FLOP *** [3h 4s Td]
LifFtD is sitting out
LifFtD has returned
Mr.Bob-su: bets 180
mrbandito27: folds 
Andre Ortega: calls 180
*** TURN *** [3h 4s Td] [2h]
Mr.Bob-su: bets 360
Andre Ortega: raises 480 to 840
Mr.Bob-su: calls 480
*** RIVER *** [3h 4s Td 2h] [3d]
Mr.Bob-su: bets 1200
Andre Ortega: raises 2685 to 3885 and is all-in
Mr.Bob-su: folds 
Uncalled bet (2685) returned to Andre Ortega
Andre Ortega collected 4800 from pot
*** SUMMARY ***
Total pot 4800 | Rake 0 
Board [3h 4s Td 2h 3d]
Seat 1: rocky 7 (button) folded before Flop (didn't bet)
Seat 2: ldf58 (small blind) folded before Flop
Seat 3: LifFtD (big blind) folded before Flop
Seat 4: Grasquet folded before Flop (didn't bet)
Seat 5: Mr.Bob-su folded on the River
Seat 6: CHIT4 folded before Flop (didn't bet)
Seat 7: R4ID3R12 folded before Flop (didn't bet)
Seat 8: mrbandito27 folded on the Flop
Seat 9: Andre Ortega collected (4800)



PokerStars Hand #157575058984: Tournament #1641817620, $7.50+$7.50+$1.50 USD Hold'em No Limit - Level I (15/30) - 2016/08/21 18:30:08 ET
Table '1641817620 46' 9-max Seat #1 is the button
Seat 1: Kotakera (5000 in chips) 
Seat 2: estebangocu (5000 in chips) 
Seat 3: butler992 (5000 in chips) 
Seat 4: ZuzanaM (5000 in chips) 
Seat 5: pentman (5000 in chips) 
Seat 6: BredaBreda (5000 in chips) 
Seat 7: clavito691 (5000 in chips) 
Seat 8: Violetarose (5000 in chips) 
Seat 9: staknchips83 (5000 in chips) 
Kotakera: posts the ante 5
estebangocu: posts the ante 5
butler992: posts the ante 5
ZuzanaM: posts the ante 5
pentman: posts the ante 5
BredaBreda: posts the ante 5
clavito691: posts the ante 5
Violetarose: posts the ante 5
staknchips83: posts the ante 5
estebangocu: posts small blind 15
butler992: posts big blind 30
*** HOLE CARDS ***
ZuzanaM: folds 
pentman: folds 
BredaBreda: folds 
clavito691: raises 39 to 69
Violetarose: folds 
staknchips83: folds 
Kotakera: folds 
estebangocu: folds 
butler992: folds 
Uncalled bet (39) returned to clavito691
clavito691 collected 120 from pot
*** SUMMARY ***
Total pot 120 | Rake 0 
Seat 1: Kotakera (button) folded before Flop (didn't bet)
Seat 2: estebangocu (small blind) folded before Flop
Seat 3: butler992 (big blind) folded before Flop
Seat 4: ZuzanaM folded before Flop (didn't bet)
Seat 5: pentman folded before Flop (didn't bet)
Seat 6: BredaBreda folded before Flop (didn't bet)
Seat 7: clavito691 collected (120)
Seat 8: Violetarose folded before Flop (didn't bet)
Seat 9: staknchips83 folded before Flop (didn't bet)



PokerStars Hand #157575058985: Tournament #1641817620, $7.50+$7.50+$1.50 USD Hold'em No Limit - Level I (15/30) - 2016/08/21 18:30:08 ET
Table '1641817620 47' 9-max Seat #1 is the button
Seat 1: sovikeen (5000 in chips) 
Seat 2: RipperRooo (5000 in chips) 
Seat 3: gtavares10 (5000 in chips) 
Seat 4: moojjang (5000 in chips) 
Seat 5: IvnAK (5000 in chips) 
Seat 6: sergiooker (5000 in chips) 
Seat 7: T3chnojunk (5000 in chips) 
Seat 8: bruff3l (5000 in chips) 
Seat 9: ppmaster (5000 in chips) 
sovikeen: posts the ante 5
RipperRooo: posts the ante 5
gtavares10: posts the ante 5
moojjang: posts the ante 5
IvnAK: posts the ante 5
sergiooker: posts the ante 5
T3chnojunk: posts the ante 5
bruff3l: posts the ante 5
ppmaster: posts the ante 5
RipperRooo: posts small blind 15
gtavares10: posts big blind 30
*** HOLE CARDS ***
moojjang: folds 
IvnAK: raises 45 to 75
sergiooker: folds 
T3chnojunk: folds 
bruff3l: folds 
ppmaster: folds 
sovikeen: folds 
RipperRooo: raises 225 to 300
gtavares10: folds 
IvnAK: calls 225
*** FLOP *** [Kd 2c Ah]
RipperRooo: bets 337
IvnAK: folds 
Uncalled bet (337) returned to RipperRooo
RipperRooo collected 675 from pot
RipperRooo: doesn't show hand 
*** SUMMARY ***
Total pot 675 | Rake 0 
Board [Kd 2c Ah]
Seat 1: sovikeen (button) folded before Flop (didn't bet)
Seat 2: RipperRooo (small blind) collected (675)
Seat 3: gtavares10 (big blind) folded before Flop
Seat 4: moojjang folded before Flop (didn't bet)
Seat 5: IvnAK folded on the Flop
Seat 6: sergiooker folded before Flop (didn't bet)
Seat 7: T3chnojunk folded before Flop (didn't bet)
Seat 8: bruff3l folded before Flop (didn't bet)
Seat 9: ppmaster folded before Flop (didn't bet)



PokerStars Hand #157575058986: Tournament #1641817620, $7.50+$7.50+$1.50 USD Hold'em No Limit - Level I (15/30) - 2016/08/21 18:30:08 ET
Table '1641817620 48' 9-max Seat #1 is the button
Seat 1: soft8981 (5000 in chips) 
Seat 2: getatore (5000 in chips) 
Seat 3: Serg2407 (5000 in chips) 
Seat 4: Zareta (5000 in chips) 
Seat 5: NSStefan (5000 in chips) 
Seat 6: ATE13 (5000 in chips) 
Seat 7: BRUCE999999 (5000 in chips) 
Seat 8: howtown (5000 in chips) 
Seat 9: qcouest (5000 in chips) 
soft8981: posts the ante 5
getatore: posts the ante 5
Serg2407: posts the ante 5
Zareta: posts the ante 5
NSStefan: posts the ante 5
ATE13: posts the ante 5
BRUCE999999: posts the ante 5
howtown: posts the ante 5
qcouest: posts the ante 5
getatore: posts small blind 15
Serg2407: posts big blind 30
*** HOLE CARDS ***
Zareta: folds 
NSStefan: folds 
ATE13: folds 
BRUCE999999: raises 90 to 120
howtown: folds 
qcouest: folds 
soft8981: folds 
getatore: calls 105
Serg2407: calls 90
*** FLOP *** [5h 5c 3s]
getatore: checks 
Serg2407: checks 
BRUCE999999: bets 150
getatore: folds 
Serg2407: folds 
Uncalled bet (150) returned to BRUCE999999
BRUCE999999 collected 405 from pot
*** SUMMARY ***
Total pot 405 | Rake 0 
Board [5h 5c 3s]
Seat 1: soft8981 (button) folded before Flop (didn't bet)
Seat 2: getatore (small blind) folded on the Flop
Seat 3: Serg2407 (big blind) folded on the Flop
Seat 4: Zareta folded before Flop (didn't bet)
Seat 5: NSStefan folded before Flop (didn't bet)
Seat 6: ATE13 folded before Flop (didn't bet)
Seat 7: BRUCE999999 collected (405)
Seat 8: howtown folded before Flop (didn't bet)
Seat 9: qcouest folded before Flop (didn't bet)



PokerStars Hand #157575058987: Tournament #1641817620, $7.50+$7.50+$1.50 USD Hold'em No Limit - Level I (15/30) - 2016/08/21 18:30:08 ET
Table '1641817620 49' 9-max Seat #1 is the button
Seat 1: Mi2xa (5000 in chips) 
Seat 2: abig89 (5000 in chips) 
Seat 3: nickviso (5000 in chips) 
Seat 4: dzoqer (5000 in chips) 
Seat 5: Can'tStopMee (5000 in chips) 
Seat 6: PaulDaPole (5000 in chips) 
Seat 7: Prebendk (5000 in chips) 
Seat 8: VixenKoala (5000 in chips) 
Seat 9: logos1428 (5000 in chips) 
Mi2xa: posts the ante 5
abig89: posts the ante 5
nickviso: posts the ante 5
dzoqer: posts the ante 5
Can'tStopMee: posts the ante 5
PaulDaPole: posts the ante 5
Prebendk: posts the ante 5
VixenKoala: posts the ante 5
logos1428: posts the ante 5
abig89: posts small blind 15
nickviso: posts big blind 30
*** HOLE CARDS ***
dzoqer: folds 
Can'tStopMee: folds 
PaulDaPole: folds 
Prebendk: raises 60 to 90
VixenKoala: folds 
logos1428: calls 90
Mi2xa: folds 
abig89: calls 75
nickviso: folds 
*** FLOP *** [3d 4s Td]
abig89: checks 
Prebendk: bets 172
logos1428: calls 172
abig89: calls 172
*** TURN *** [3d 4s Td] [Qc]
abig89: bets 861
Prebendk: folds 
logos1428: folds 
Uncalled bet (861) returned to abig89
abig89 collected 861 from pot
abig89: doesn't show hand 
*** SUMMARY ***
Total pot 861 | Rake 0 
Board [3d 4s Td Qc]
Seat 1: Mi2xa (button) folded before Flop (didn't bet)
Seat 2: abig89 (small blind) collected (861)
Seat 3: nickviso (big blind) folded before Flop
Seat 4: dzoqer folded before Flop (didn't bet)
Seat 5: Can'tStopMee folded before Flop (didn't bet)
Seat 6: PaulDaPole folded before Flop (didn't bet)
Seat 7: Prebendk folded on the Turn
Seat 8: VixenKoala folded before Flop (didn't bet)
Seat 9: logos1428 folded on the Turn



PokerStars Hand #157575058988: Tournament #1641817620, $7.50+$7.50+$1.50 USD Hold'em No Limit - Level I (15/30) - 2016/08/21 18:30:08 ET
Table '1641817620 50' 9-max Seat #1 is the button
Seat 1: Alpentraum (5000 in chips) 
Seat 2: FrEmpireAk (5000 in chips) 
Seat 3: hat_coates (5000 in chips) 
Seat 4: Nandinhojah (5000 in chips) 
Seat 5: Herbettigre (5000 in chips) 
Seat 6: saintP20 (5000 in chips) 
Seat 7: Shab26 (5000 in chips) 
Seat 8: thinkfeeldo (5000 in chips) 
Seat 9: ziomekek (5000 in chips) 
Alpentraum: posts the ante 5
FrEmpireAk: posts the ante 5
hat_coates: posts the ante 5
Nandinhojah: posts the ante 5
Herbettigre: posts the ante 5
saintP20: posts the ante 5
Shab26: posts the ante 5
thinkfeeldo: posts the ante 5
ziomekek: posts the ante 5
FrEmpireAk: posts small blind 15
hat_coates: posts big blind 30
*** HOLE CARDS ***
Nandinhojah: folds 
Herbettigre: folds 
saintP20: calls 30
Shab26: folds 
thinkfeeldo: folds 
ziomekek: folds 
Alpentraum: calls 30
FrEmpireAk: folds 
hat_coates: checks 
*** FLOP *** [Js 2d Ah]
hat_coates: checks 
saintP20: checks 
Alpentraum: checks 
*** TURN *** [Js 2d Ah] [8d]
hat_coates: checks 
saintP20: bets 90
Alpentraum: folds 
hat_coates: folds 
Uncalled bet (90) returned to saintP20
saintP20 collected 150 from pot
saintP20: doesn't show hand 
*** SUMMARY ***
Total pot 150 | Rake 0 
Board [Js 2d Ah 8d]
Seat 1: Alpentraum (button) folded on the Turn
Seat 2: FrEmpireAk (small blind) folded before Flop
Seat 3: hat_coates (big blind) folded on the Turn
Seat 4: Nandinhojah folded before Flop (didn't bet)
Seat 5: Herbettigre folded before Flop (didn't bet)
Seat 6: saintP20 collected (150)
Seat 7: Shab26 folded before Flop (didn't bet)
Seat 8: thinkfeeldo folded before Flop (didn't bet)
Seat 9: ziomekek folded before Flop (didn't bet)



PokerStars Hand #157575069287: Tournament #1641817620, $7.50+$7.50+$1.50 USD Hold'em No Limit - Level I (15/30) - 2016/08/21 18:30:24 ET
Table '1641817620 51' 9-max Seat #2 is the button
Seat 1: yys000 (4995 in chips) 
Seat 2: paulotury (4980 in chips) 
Seat 3: kozloeric (5055 in chips) 
Seat 4: bastef79 (4995 in chips) 
Seat 5: cusirc (4995 in chips) 
Seat 6: demonas05 (4995 in chips) 
Seat 7: boostyz (4995 in chips) 
Seat 8: Garfild740 (4995 in chips) 
Seat 9: Kalvar1 (4995 in chips) 
yys000: posts the ante 5
paulotury: posts the ante 5
kozloeric: posts the ante 5
bastef79: posts the ante 5
cusirc: posts the ante 5
demonas05: posts the ante 5
boostyz: posts the ante 5
Garfild740: posts the ante 5
Kalvar1: posts the ante 5
kozloeric: posts small blind 15
bastef79: posts big blind 30
*** HOLE CARDS ***
cusirc: folds 
demonas05: raises 30 to 60
boostyz: folds 
Garfild740: folds 
Kalvar1: folds 
yys000: folds 
paulotury: folds 
kozloeric: calls 45
bastef79: calls 30
*** FLOP *** [Qc 8s Ah]
kozloeric: checks 
bastef79: checks 
demonas05: bets 112
kozloeric: calls 112
bastef79: calls 112
*** TURN *** [Qc 8s Ah] [2d]
kozloeric: checks 
bastef79: checks 
demonas05: bets 270
kozloeric: folds 
bastef79: folds 
Uncalled bet (270) returned to demonas05
demonas05 collected 561 from pot
demonas05: doesn't show hand 
*** SUMMARY ***
Total pot 561 | Rake 0 
Board [Qc 8s Ah 2d]
Seat 1: yys000 folded before Flop (didn't bet)
Seat 2: paulotury (button) folded before Flop (didn't bet)
Seat 3: kozloeric (small blind) folded on the Turn
Seat 4: bastef79 (big blind) folded on the Turn
Seat 5: cusirc folded before Flop (didn't bet)
Seat 6: demonas05 collected (561)
Seat 7: boostyz folded before Flop (didn't bet)
Seat 8: Garfild740 folded before Flop (didn't bet)
Seat 9: Kalvar1 folded before Flop (didn't bet)



PokerStars Hand #157575069996: Tournament #1641817620, $7.50+$7.50+$1.50 USD Hold'em No Limit - Level I (15/30) - 2016/08/21 18:30:25 ET
Table '1641817620 44' 9-max Seat #2 is the button
Seat 1: BurrGrylls (4995 in chips) 
Seat 2: moisesgosu (4980 in chips) 
Seat 3: kduwork (5055 in chips) 
Seat 4: starkstud (4995 in chips) 
Seat 5: 55antivirus (4995 in chips) 
Seat 6: lesley hu (4995 in chips) is sitting out
Seat 7: aihongepji32 (4995 in chips) 
Seat 8: heynow21 (4995 in chips) 
Seat 9: Pro_Tunis (4995 in chips) 
BurrGrylls: posts the ante 5
moisesgosu: posts the ante 5
kduwork: posts the ante 5
starkstud: posts the ante 5
55antivirus: posts the ante 5
lesley hu: posts the ante 5
aihongepji32: posts the ante 5
heynow21: posts the ante 5
Pro_Tunis: posts the ante 5
kduwork: posts small blind 15
starkstud: posts big blind 30
*** HOLE CARDS ***
55antivirus: folds 
lesley hu: folds 
aihongepji32: calls 30
heynow21: folds 
Pro_Tunis: folds 
BurrGrylls: folds 
moisesgosu: folds 
kduwork: folds 
starkstud: checks 
*** FLOP *** [Ad Kh 9c]
starkstud: checks 
aihongepji32: bets 60
starkstud: calls 60
*** TURN *** [Ad Kh 9c] [6s]
starkstud: checks 
aihongepji32: checks 
*** RIVER *** [Ad Kh 9c 6s] [Jd]
starkstud: checks 
aihongepji32: checks 
*** SHOW DOWN ***
starkstud: shows [Kd 2c] (a pair of Kings)
aihongepji32: mucks hand 
starkstud collected 240 from pot
*** SUMMARY ***
Total pot 240 | Rake 0 
Board [Ad Kh 9c 6s Jd]
Seat 1: BurrGrylls folded before Flop (didn't bet)
Seat 2: moisesgosu (button) folded before Flop (didn't bet)
Seat 3: kduwork (small blind) folded before Flop
Seat 4: starkstud (big blind) showed [Kd 2c] and won (240) with a pair of Kings
Seat 5: 55antivirus folded before Flop (didn't bet)
Seat 6: lesley hu folded before Flop (didn't bet)
Seat 7: aihongepji32 mucked
Seat 8: heynow21 folded before Flop (didn't bet)
Seat 9: Pro_Tunis folded before Flop (didn't bet)



PokerStars Hand #157575074859: Tournament #1641817620, $7.50+$7.50+$1.50 USD Hold'em No Limit - Level I (15/30) - 2016/08/21 18:30:32 ET
Table '1641817620 6' 9-max Seat #2 is the button
Seat 1: ASTRAXANSKI (4995 in chips) 
Seat 2: KOT-BEGEMOT6 (4980 in chips) 
Seat 3: agneseagnese (5000 in chips) out of hand (moved from another table into small blind)
Seat 4: mekkoramarha (4965 in chips) 
Seat 6: brown1967 (4995 in chips) 
Seat 7: Balotelli195 (4995 in chips) 
Seat 8: linoleum006 (5080 in chips) 
Seat 9: Jelsomino79 (4995 in chips) 
ASTRAXANSKI: posts the ante 5
KOT-BEGEMOT6: posts the ante 5
mekkoramarha: posts the ante 5
brown1967: posts the ante 5
Balotelli195: posts the ante 5
linoleum006: posts the ante 5
Jelsomino79: posts the ante 5
mekkoramarha: posts small blind 15
brown1967: posts big blind 30
*** HOLE CARDS ***
Balotelli195: folds 
linoleum006: folds 
Jelsomino79: folds 
ASTRAXANSKI: folds 
KOT-BEGEMOT6: folds 
mekkoramarha: folds 
Uncalled bet (15) returned to brown1967
brown1967 collected 65 from pot
brown1967: doesn't show hand 
*** SUMMARY ***
Total pot 65 | Rake 0 
Seat 1: ASTRAXANSKI folded before Flop (didn't bet)
Seat 2: KOT-BEGEMOT6 (button) folded before Flop (didn't bet)
Seat 4: mekkoramarha (small blind) folded before Flop
Seat 6: brown1967 (big blind) collected (65)
Seat 7: Balotelli195 folded before Flop (didn't bet)
Seat 8: linoleum006 folded before Flop (didn't bet)
Seat 9: Jelsomino79 folded before Flop (didn't bet)



PokerStars Hand #157575075965: Tournament #1641817620, $7.50+$7.50+$1.50 USD Hold'em No Limit - Level I (15/30) - 2016/08/21 18:30:34 ET
Table '1641817620 8' 9-max Seat #2 is the button
Seat 1: inkjoh (5080 in chips) 
Seat 2: MarcosCLMO (4980 in chips) 
Seat 3: HundTore (4965 in chips) 
Seat 4: Kamikase1805 (5000 in chips) 
Seat 6: Batovs (4995 in chips) 
Seat 7: pavaopics (4995 in chips) 
Seat 8: FastEdiddy (4995 in chips) 
Seat 9: Pokerofwind (4995 in chips) 
inkjoh: posts the ante 5
MarcosCLMO: posts the ante 5
HundTore: posts the ante 5
Kamikase1805: posts the ante 5
Batovs: posts the ante 5
pavaopics: posts the ante 5
FastEdiddy: posts the ante 5
Pokerofwind: posts the ante 5
HundTore: posts small blind 15
Kamikase1805: posts big blind 30
*** HOLE CARDS ***
Batovs: folds 
pavaopics: folds 
FastEdiddy: folds 
Pokerofwind: folds 
inkjoh: folds 
MarcosCLMO: folds 
HundTore: folds 
Uncalled bet (15) returned to Kamikase1805
Kamikase1805 collected 70 from pot
*** SUMMARY ***
Total pot 70 | Rake 0 
Seat 1: inkjoh folded before Flop (didn't bet)
Seat 2: MarcosCLMO (button) folded before Flop (didn't bet)
Seat 3: HundTore (small blind) folded before Flop
Seat 4: Kamikase1805 (big blind) collected (70)
Seat 6: Batovs folded before Flop (didn't bet)
Seat 7: pavaopics folded before Flop (didn't bet)
Seat 8: FastEdiddy folded before Flop (didn't bet)
Seat 9: Pokerofwind folded before Flop (didn't bet)



PokerStars Hand #157575081375: Tournament #1641817620, $7.50+$7.50+$1.50 USD Hold'em No Limit - Level I (15/30) - 2016/08/21 18:30:42 ET
Table '1641817620 35' 9-max Seat #2 is the button
Seat 1: wantuirpoker (4995 in chips) 
Seat 2: Diegodel79 (4980 in chips) 
Seat 3: brunoeffect (4965 in chips) 
Seat 4: PPOrphan (4995 in chips) 
Seat 6: brett88987 (4995 in chips) 
Seat 7: IcaLm (4995 in chips) 
Seat 8: ximenesb (4995 in chips) 
Seat 9: Cosacoman (4995 in chips) 
wantuirpoker: posts the ante 5
Diegodel79: posts the ante 5
brunoeffect: posts the ante 5
PPOrphan: posts the ante 5
brett88987: posts the ante 5
IcaLm: posts the ante 5
ximenesb: posts the ante 5
Cosacoman: posts the ante 5
brunoeffect: posts small blind 15
PPOrphan: posts big blind 30
*** HOLE CARDS ***
brett88987: folds 
IcaLm: folds 
ximenesb: folds 
Cosacoman: raises 30 to 60
wantuirpoker: folds 
Diegodel79: folds 
brunoeffect: folds 
PPOrphan: calls 30
*** FLOP *** [2c Jh Qc]
PPOrphan: checks 
Cosacoman: bets 60
PPOrphan: folds 
Uncalled bet (60) returned to Cosacoman
Cosacoman collected 175 from pot
Cosacoman: doesn't show hand 
*** SUMMARY ***
Total pot 175 | Rake 0 
Board [2c Jh Qc]
Seat 1: wantuirpoker folded before Flop (didn't bet)
Seat 2: Diegodel79 (button) folded before Flop (didn't bet)
Seat 3: brunoeffect (small blind) folded before Flop
Seat 4: PPOrphan (big blind) folded on the Flop
Seat 6: brett88987 folded before Flop (didn't bet)
Seat 7: IcaLm folded before Flop (didn't bet)
Seat 8: ximenesb folded before Flop (didn't bet)
Seat 9: Cosacoman collected (175)



PokerStars Hand #157575081884: Tournament #1641817620, $7.50+$7.50+$1.50 USD Hold'em No Limit - Level I (15/30) - 2016/08/21 18:30:43 ET
Table '1641817620 10' 9-max Seat #2 is the button
Seat 1: VANDECO174 (4995 in chips) 
Seat 2: Be Anger (4980 in chips) 
Seat 3: mickyryan (5055 in chips) 
Seat 4: silveira1879 (4995 in chips) 
Seat 5: AndyLou27 (4995 in chips) 
Seat 6: I M GOIN OFF (4995 in chips) 
Seat 7: Nuazo (4995 in chips) 
Seat 8: damibor (4995 in chips) 
Seat 9: Stokesy05 (4995 in chips) 
VANDECO174: posts the ante 5
Be Anger: posts the ante 5
mickyryan: posts the ante 5
silveira1879: posts the ante 5
AndyLou27: posts the ante 5
I M GOIN OFF: posts the ante 5
Nuazo: posts the ante 5
damibor: posts the ante 5
Stokesy05: posts the ante 5
mickyryan: posts small blind 15
silveira1879: posts big blind 30
*** HOLE CARDS ***
AndyLou27: folds 
I M GOIN OFF: folds 
Nuazo: folds 
damibor: folds 
Stokesy05: folds 
VANDECO174: folds 
Be Anger: folds 
mickyryan: folds 
Uncalled bet (15) returned to silveira1879
silveira1879 collected 75 from pot
silveira1879: doesn't show hand 
*** SUMMARY ***
Total pot 75 | Rake 0 
Seat 1: VANDECO174 folded before Flop (didn't bet)
Seat 2: Be Anger (button) folded before Flop (didn't bet)
Seat 3: mickyryan (small blind) folded before Flop
Seat 4: silveira1879 (big blind) collected (75)
Seat 5: AndyLou27 folded before Flop (didn't bet)
Seat 6: I M GOIN OFF folded before Flop (didn't bet)
Seat 7: Nuazo folded before Flop (didn't bet)
Seat 8: damibor folded before Flop (didn't bet)
Seat 9: Stokesy05 folded before Flop (didn't bet)



PokerStars Hand #157575081986: Tournament #1641817620, $7.50+$7.50+$1.50 USD Hold'em No Limit - Level I (15/30) - 2016/08/21 18:30:43 ET
Table '1641817620 29' 9-max Seat #2 is the button
Seat 1: kidpokerjm89 (4995 in chips) 
Seat 2: niejowicz (4980 in chips) 
Seat 3: Ofbravetight (4965 in chips) 
Seat 4: Ottel (4995 in chips) 
Seat 5: puntoo (5085 in chips) 
Seat 6: Melady77777 (4995 in chips) 
Seat 7: fishfind000 (4995 in chips) 
Seat 8: AcePheres (4995 in chips) 
Seat 9: LAZO30 (4995 in chips) 
kidpokerjm89: posts the ante 5
niejowicz: posts the ante 5
Ofbravetight: posts the ante 5
Ottel: posts the ante 5
puntoo: posts the ante 5
Melady77777: posts the ante 5
fishfind000: posts the ante 5
AcePheres: posts the ante 5
LAZO30: posts the ante 5
Ofbravetight: posts small blind 15
Ottel: posts big blind 30
*** HOLE CARDS ***
puntoo: raises 60 to 90
Melady77777: folds 
fishfind000: folds 
AcePheres: folds 
LAZO30: folds 
kidpokerjm89: folds 
niejowicz: folds 
Ofbravetight: folds 
Ottel: calls 60
*** FLOP *** [Qd Th 4s]
Ottel: checks 
puntoo: bets 240
Ottel: calls 240
*** TURN *** [Qd Th 4s] [9h]
Ottel: checks 
puntoo: checks 
*** RIVER *** [Qd Th 4s 9h] [5s]
Ottel: checks 
puntoo: bets 480
Ottel: calls 480
*** SHOW DOWN ***
puntoo: shows [Ah Qs] (a pair of Queens)
Ottel: mucks hand 
puntoo collected 1680 from pot
*** SUMMARY ***
Total pot 1680 | Rake 0 
Board [Qd Th 4s 9h 5s]
Seat 1: kidpokerjm89 folded before Flop (didn't bet)
Seat 2: niejowicz (button) folded before Flop (didn't bet)
Seat 3: Ofbravetight (small blind) folded before Flop
Seat 4: Ottel (big blind) mucked
Seat 5: puntoo showed [Ah Qs] and won (1680) with a pair of Queens
Seat 6: Melady77777 folded before Flop (didn't bet)
Seat 7: fishfind000 folded before Flop (didn't bet)
Seat 8: AcePheres folded before Flop (didn't bet)
Seat 9: LAZO30 folded before Flop (didn't bet)



PokerStars Hand #157575083265: Tournament #1641817620, $7.50+$7.50+$1.50 USD Hold'em No Limit - Level I (15/30) - 2016/08/21 18:30:45 ET
Table '1641817620 46' 9-max Seat #2 is the button
Seat 1: Kotakera (4995 in chips) 
Seat 2: estebangocu (4980 in chips) 
Seat 3: butler992 (4965 in chips) 
Seat 4: ZuzanaM (4995 in chips) 
Seat 5: Koeike (5000 in chips) 
Seat 6: BredaBreda (4995 in chips) 
Seat 7: clavito691 (5085 in chips) 
Seat 8: Violetarose (4995 in chips) 
Seat 9: staknchips83 (4995 in chips) 
Kotakera: posts the ante 5
estebangocu: posts the ante 5
butler992: posts the ante 5
ZuzanaM: posts the ante 5
Koeike: posts the ante 5
BredaBreda: posts the ante 5
clavito691: posts the ante 5
Violetarose: posts the ante 5
staknchips83: posts the ante 5
butler992: posts small blind 15
ZuzanaM: posts big blind 30
*** HOLE CARDS ***
Koeike: folds 
BredaBreda: folds 
clavito691: raises 39 to 69
Violetarose: calls 69
staknchips83: folds 
Kotakera: calls 69
estebangocu: folds 
butler992: folds 
ZuzanaM: folds 
*** FLOP *** [Qd Qs 7h]
clavito691: bets 98
Violetarose: folds 
Kotakera: calls 98
*** TURN *** [Qd Qs 7h] [7s]
clavito691: bets 241
Kotakera: folds 
Uncalled bet (241) returned to clavito691
clavito691 collected 493 from pot
*** SUMMARY ***
Total pot 493 | Rake 0 
Board [Qd Qs 7h 7s]
Seat 1: Kotakera folded on the Turn
Seat 2: estebangocu (button) folded before Flop (didn't bet)
Seat 3: butler992 (small blind) folded before Flop
Seat 4: ZuzanaM (big blind) folded before Flop
Seat 5: Koeike folded before Flop (didn't bet)
Seat 6: BredaBreda folded before Flop (didn't bet)
Seat 7: clavito691 collected (493)
Seat 8: Violetarose folded on the Flop
Seat 9: staknchips83 folded before Flop (didn't bet)



PokerStars Hand #157575084193: Tournament #1641817620, $7.50+$7.50+$1.50 USD Hold'em No Limit - Level I (15/30) - 2016/08/21 18:30:47 ET
Table '1641817620 25' 9-max Seat #2 is the button
Seat 1: MoW3R (4995 in chips) 
Seat 2: pirus157 (5220 in chips) 
Seat 3: MaxBracht (4905 in chips) 
Seat 4: Rex Nelson (4905 in chips) 
Seat 5: ArKip (4995 in chips) 
Seat 6: xxxDOUxxx (4995 in chips) 
Seat 7: AAnaKKonda (4995 in chips) 
Seat 8: Mad Dionysus (4995 in chips) 
Seat 9: IwillCall3 (4995 in chips) 
MoW3R: posts the ante 5
pirus157: posts the ante 5
MaxBracht: posts the ante 5
Rex Nelson: posts the ante 5
ArKip: posts the ante 5
xxxDOUxxx: posts the ante 5
AAnaKKonda: posts the ante 5
Mad Dionysus: posts the ante 5
IwillCall3: posts the ante 5
MaxBracht: posts small blind 15
Rex Nelson: posts big blind 30
*** HOLE CARDS ***
ArKip: folds 
xxxDOUxxx: folds 
AAnaKKonda: folds 
Mad Dionysus: folds 
IwillCall3: raises 60 to 90
MoW3R: folds 
pirus157: raises 5125 to 5215 and is all-in
MaxBracht: folds 
Rex Nelson: folds 
IwillCall3: folds 
Uncalled bet (5125) returned to pirus157
pirus157 collected 270 from pot
pirus157: doesn't show hand 
*** SUMMARY ***
Total pot 270 | Rake 0 
Seat 1: MoW3R folded before Flop (didn't bet)
Seat 2: pirus157 (button) collected (270)
Seat 3: MaxBracht (small blind) folded before Flop
Seat 4: Rex Nelson (big blind) folded before Flop
Seat 5: ArKip folded before Flop (didn't bet)
Seat 6: xxxDOUxxx folded before Flop (didn't bet)
Seat 7: AAnaKKonda folded before Flop (didn't bet)
Seat 8: Mad Dionysus folded before Flop (didn't bet)
Seat 9: IwillCall3 folded before Flop



PokerStars Hand #157575085423: Tournament #1641817620, $7.50+$7.50+$1.50 USD Hold'em No Limit - Level I (15/30) - 2016/08/21 18:30:49 ET
Table '1641817620 59' 9-max Seat #2 is the button
Seat 1: pitoco2012 (4995 in chips) 
Seat 2: M_ORBIT_M (4980 in chips) 
Seat 3: alemaowe (4965 in chips) 
Seat 4: jan monster (4995 in chips) 
Seat 5: laiyitui (4995 in chips) 
Seat 6: stilio_al (4995 in chips) 
Seat 7: 88Xin88 (5085 in chips) 
Seat 8: Enio Pinho (4995 in chips) 
Seat 9: Robsn087 (4995 in chips) 
pitoco2012: posts the ante 5
M_ORBIT_M: posts the ante 5
alemaowe: posts the ante 5
jan monster: posts the ante 5
laiyitui: posts the ante 5
stilio_al: posts the ante 5
88Xin88: posts the ante 5
Enio Pinho: posts the ante 5
Robsn087: posts the ante 5
alemaowe: posts small blind 15
jan monster: posts big blind 30
*** HOLE CARDS ***
laiyitui: folds 
stilio_al: folds 
88Xin88: folds 
Enio Pinho: raises 36 to 66
Robsn087: calls 66
pitoco2012: folds 
M_ORBIT_M: folds 
alemaowe: folds 
jan monster: calls 36
*** FLOP *** [6s 6h 9h]
jan monster: checks 
Enio Pinho: bets 77
Robsn087: folds 
jan monster: calls 77
*** TURN *** [6s 6h 9h] [5h]
jan monster: checks 
Enio Pinho: checks 
*** RIVER *** [6s 6h 9h 5h] [8h]
jan monster: bets 144
Enio Pinho: raises 144 to 288
jan monster: calls 144
*** SHOW DOWN ***
Enio Pinho: shows [Ah 9d] (a flush, Ace high)
jan monster: mucks hand 
Enio Pinho collected 988 from pot
*** SUMMARY ***
Total pot 988 | Rake 0 
Board [6s 6h 9h 5h 8h]
Seat 1: pitoco2012 folded before Flop (didn't bet)
Seat 2: M_ORBIT_M (button) folded before Flop (didn't bet)
Seat 3: alemaowe (small blind) folded before Flop
Seat 4: jan monster (big blind) mucked
Seat 5: laiyitui folded before Flop (didn't bet)
Seat 6: stilio_al folded before Flop (didn't bet)
Seat 7: 88Xin88 folded before Flop (didn't bet)
Seat 8: Enio Pinho showed [Ah 9d] and won (988) with a flush, Ace high
Seat 9: Robsn087 folded on the Flop



PokerStars Hand #157575085640: Tournament #1641817620, $7.50+$7.50+$1.50 USD Hold'em No Limit - Level I (15/30) - 2016/08/21 18:30:49 ET
Table '1641817620 54' 9-max Seat #2 is the button
Seat 1: nixx77 (4995 in chips) 
Seat 2: FábioC.p.br (4980 in chips) 
Seat 3: pinokkioOo (4965 in chips) 
Seat 4: ALLESC-114 (4995 in chips) 
Seat 5: appache55 (4995 in chips) 
Seat 6: hrabbi87 (4995 in chips) 
Seat 7: xpsbynoc (5085 in chips) 
Seat 8: MiltonMorais (4995 in chips) 
Seat 9: ZeckMaverick (4995 in chips) 
nixx77: posts the ante 5
FábioC.p.br: posts the ante 5
pinokkioOo: posts the ante 5
ALLESC-114: posts the ante 5
appache55: posts the ante 5
hrabbi87: posts the ante 5
xpsbynoc: posts the ante 5
MiltonMorais: posts the ante 5
ZeckMaverick: posts the ante 5
pinokkioOo: posts small blind 15
ALLESC-114: posts big blind 30
*** HOLE CARDS ***
appache55: calls 30
hrabbi87: calls 30
xpsbynoc: raises 30 to 60
MiltonMorais: folds 
ZeckMaverick: folds 
nixx77: folds 
FábioC.p.br: folds 
pinokkioOo: folds 
ALLESC-114: folds 
appache55: calls 30
hrabbi87: calls 30
*** FLOP *** [7s 4h 3c]
appache55: bets 270
hrabbi87: folds 
xpsbynoc: calls 270
*** TURN *** [7s 4h 3c] [6d]
appache55: checks 
xpsbynoc: checks 
*** RIVER *** [7s 4h 3c 6d] [Qh]
appache55: bets 810
xpsbynoc: raises 2187 to 2997
appache55: folds 
Uncalled bet (2187) returned to xpsbynoc
xpsbynoc collected 2430 from pot
*** SUMMARY ***
Total pot 2430 | Rake 0 
Board [7s 4h 3c 6d Qh]
Seat 1: nixx77 folded before Flop (didn't bet)
Seat 2: FábioC.p.br (button) folded before Flop (didn't bet)
Seat 3: pinokkioOo (small blind) folded before Flop
Seat 4: ALLESC-114 (big blind) folded before Flop
Seat 5: appache55 folded on the River
Seat 6: hrabbi87 folded on the Flop
Seat 7: xpsbynoc collected (2430)
Seat 8: MiltonMorais folded before Flop (didn't bet)
Seat 9: ZeckMaverick folded before Flop (didn't bet)



PokerStars Hand #157575086122: Tournament #1641817620, $7.50+$7.50+$1.50 USD Hold'em No Limit - Level I (15/30) - 2016/08/21 18:30:50 ET
Table '1641817620 40' 9-max Seat #2 is the button
Seat 1: Shiryu100 (4995 in chips) 
Seat 2: nico122527 (4980 in chips) 
Seat 3: ilico (4875 in chips) 
Seat 4: Mr_Giiba (4995 in chips) 
Seat 5: mario342 (5295 in chips) 
Seat 6: MON3Y$HOT (4995 in chips) 
Seat 7: hyratsch (4875 in chips) 
Seat 8: vaggelis1982 (4995 in chips) 
Seat 9: kafu123 (4995 in chips) is sitting out
Shiryu100: posts the ante 5
nico122527: posts the ante 5
ilico: posts the ante 5
Mr_Giiba: posts the ante 5
mario342: posts the ante 5
MON3Y$HOT: posts the ante 5
hyratsch: posts the ante 5
vaggelis1982: posts the ante 5
kafu123: posts the ante 5
ilico: posts small blind 15
Mr_Giiba: posts big blind 30
*** HOLE CARDS ***
mario342: calls 30
MON3Y$HOT: folds 
hyratsch: folds 
vaggelis1982: folds 
kafu123: folds 
Shiryu100: folds 
nico122527: calls 30
ilico: folds 
Mr_Giiba: checks 
*** FLOP *** [Th 3d 6s]
Mr_Giiba: checks 
mario342: checks 
nico122527: checks 
*** TURN *** [Th 3d 6s] [7c]
Mr_Giiba: bets 75
mario342: folds 
nico122527: folds 
Uncalled bet (75) returned to Mr_Giiba
Mr_Giiba collected 150 from pot
Mr_Giiba: doesn't show hand 
*** SUMMARY ***
Total pot 150 | Rake 0 
Board [Th 3d 6s 7c]
Seat 1: Shiryu100 folded before Flop (didn't bet)
Seat 2: nico122527 (button) folded on the Turn
Seat 3: ilico (small blind) folded before Flop
Seat 4: Mr_Giiba (big blind) collected (150)
Seat 5: mario342 folded on the Turn
Seat 6: MON3Y$HOT folded before Flop (didn't bet)
Seat 7: hyratsch folded before Flop (didn't bet)
Seat 8: vaggelis1982 folded before Flop (didn't bet)
Seat 9: kafu123 folded before Flop (didn't bet)



PokerStars Hand #157575086758: Tournament #1641817620, $7.50+$7.50+$1.50 USD Hold'em No Limit - Level I (15/30) - 2016/08/21 18:30:51 ET
Table '1641817620 33' 9-max Seat #2 is the button
Seat 1: fungyou (4995 in chips) 
Seat 2: titauhu (4980 in chips) is sitting out
Seat 3: gmdef.2001 (4965 in chips) 
Seat 5: T@keItDown (4995 in chips) 
Seat 6: REPPARTFLOW (4995 in chips) 
Seat 7: dennismitru (5085 in chips) 
Seat 8: Joao Valli (4995 in chips) 
Seat 9: Pablos701 (4995 in chips) 
fungyou: posts the ante 5
titauhu: posts the ante 5
gmdef.2001: posts the ante 5
T@keItDown: posts the ante 5
REPPARTFLOW: posts the ante 5
dennismitru: posts the ante 5
Joao Valli: posts the ante 5
Pablos701: posts the ante 5
gmdef.2001: posts small blind 15
T@keItDown: posts big blind 30
*** HOLE CARDS ***
REPPARTFLOW: folds 
dennismitru: folds 
Joao Valli: folds 
Pablos701: raises 60 to 90
fungyou: folds 
titauhu: folds 
gmdef.2001: folds 
T@keItDown: folds 
Uncalled bet (60) returned to Pablos701
Pablos701 collected 115 from pot
Pablos701: doesn't show hand 
*** SUMMARY ***
Total pot 115 | Rake 0 
Seat 1: fungyou folded before Flop (didn't bet)
Seat 2: titauhu (button) folded before Flop (didn't bet)
Seat 3: gmdef.2001 (small blind) folded before Flop
Seat 5: T@keItDown (big blind) folded before Flop
Seat 6: REPPARTFLOW folded before Flop (didn't bet)
Seat 7: dennismitru folded before Flop (didn't bet)
Seat 8: Joao Valli folded before Flop (didn't bet)
Seat 9: Pablos701 collected (115)



PokerStars Hand #157575087142: Tournament #1641817620, $7.50+$7.50+$1.50 USD Hold'em No Limit - Level I (15/30) - 2016/08/21 18:30:51 ET
Table '1641817620 50' 9-max Seat #2 is the button
Seat 1: Alpentraum (4965 in chips) 
Seat 2: FrEmpireAk (4980 in chips) 
Seat 3: hat_coates (4965 in chips) 
Seat 5: Herbettigre (4995 in chips) 
Seat 6: saintP20 (5115 in chips) 
Seat 7: Shab26 (4995 in chips) 
Seat 8: thinkfeeldo (4995 in chips) 
Seat 9: ziomekek (4995 in chips) 
Alpentraum: posts the ante 5
FrEmpireAk: posts the ante 5
hat_coates: posts the ante 5
Herbettigre: posts the ante 5
saintP20: posts the ante 5
Shab26: posts the ante 5
thinkfeeldo: posts the ante 5
ziomekek: posts the ante 5
hat_coates: posts small blind 15
Herbettigre: posts big blind 30
*** HOLE CARDS ***
saintP20: calls 30
Shab26: raises 105 to 135
thinkfeeldo: folds 
ziomekek: folds 
Alpentraum: folds 
FrEmpireAk: calls 135
hat_coates: folds 
Herbettigre: calls 105
saintP20: calls 105
*** FLOP *** [2s 5d 7c]
Herbettigre: checks 
saintP20: checks 
Shab26: checks 
FrEmpireAk: checks 
*** TURN *** [2s 5d 7c] [Th]
Herbettigre: checks 
saintP20: bets 180
Shab26: folds 
FrEmpireAk: calls 180
Herbettigre: folds 
*** RIVER *** [2s 5d 7c Th] [2h]
saintP20: bets 1020
FrEmpireAk: folds 
Uncalled bet (1020) returned to saintP20
saintP20 collected 955 from pot
saintP20: doesn't show hand 
*** SUMMARY ***
Total pot 955 | Rake 0 
Board [2s 5d 7c Th 2h]
Seat 1: Alpentraum folded before Flop (didn't bet)
Seat 2: FrEmpireAk (button) folded on the River
Seat 3: hat_coates (small blind) folded before Flop
Seat 5: Herbettigre (big blind) folded on the Turn
Seat 6: saintP20 collected (955)
Seat 7: Shab26 folded on the Turn
Seat 8: thinkfeeldo folded before Flop (didn't bet)
Seat 9: ziomekek folded before Flop (didn't bet)



PokerStars Hand #157575087262: Tournament #1641817620, $7.50+$7.50+$1.50 USD Hold'em No Limit - Level I (15/30) - 2016/08/21 18:30:51 ET
Table '1641817620 8' 9-max Seat #3 is the button
Seat 1: inkjoh (5075 in chips) 
Seat 2: MarcosCLMO (4975 in chips) 
Seat 3: HundTore (4945 in chips) 
Seat 4: Kamikase1805 (5050 in chips) 
Seat 5: younesch (5000 in chips) 
Seat 7: pavaopics (4990 in chips) 
Seat 8: FastEdiddy (4990 in chips) 
Seat 9: Pokerofwind (4990 in chips) 
inkjoh: posts the ante 5
MarcosCLMO: posts the ante 5
HundTore: posts the ante 5
Kamikase1805: posts the ante 5
younesch: posts the ante 5
pavaopics: posts the ante 5
FastEdiddy: posts the ante 5
Pokerofwind: posts the ante 5
Kamikase1805: posts small blind 15
younesch: posts big blind 30
*** HOLE CARDS ***
pavaopics: folds 
FastEdiddy: folds 
Pokerofwind: folds 
inkjoh: folds 
MarcosCLMO: raises 30 to 60
HundTore: raises 90 to 150
Kamikase1805: folds 
younesch: folds 
MarcosCLMO: calls 90
*** FLOP *** [Ac Jh Th]
MarcosCLMO: checks 
HundTore: bets 188
MarcosCLMO: calls 188
*** TURN *** [Ac Jh Th] [3h]
MarcosCLMO: checks 
HundTore: bets 372
MarcosCLMO: folds 
Uncalled bet (372) returned to HundTore
HundTore collected 761 from pot
HundTore: doesn't show hand 
*** SUMMARY ***
Total pot 761 | Rake 0 
Board [Ac Jh Th 3h]
Seat 1: inkjoh folded before Flop (didn't bet)
Seat 2: MarcosCLMO folded on the Turn
Seat 3: HundTore (button) collected (761)
Seat 4: Kamikase1805 (small blind) folded before Flop
Seat 5: younesch (big blind) folded before Flop
Seat 7: pavaopics folded before Flop (didn't bet)
Seat 8: FastEdiddy folded before Flop (didn't bet)
Seat 9: Pokerofwind folded before Flop (didn't bet)



PokerStars Hand #157575089657: Tournament #1641817620, $7.50+$7.50+$1.50 USD Hold'em No Limit - Level I (15/30) - 2016/08/21 18:30:55 ET
Table '1641817620 32' 9-max Seat #2 is the button
Seat 1: RoribeiroS (4995 in chips) 
Seat 2: tomgan (4980 in chips) 
Seat 3: patou99957 (5145 in chips) 
Seat 5: bdiddy1313 (4995 in chips) 
Seat 6: 69 hearts 69 (4995 in chips) 
Seat 7: rimis9999 (4995 in chips) 
Seat 8: noah5555 (4995 in chips) 
Seat 9: gamesAREover (4905 in chips) 
RoribeiroS: posts the ante 5
tomgan: posts the ante 5
patou99957: posts the ante 5
bdiddy1313: posts the ante 5
69 hearts 69: posts the ante 5
rimis9999: posts the ante 5
noah5555: posts the ante 5
gamesAREover: posts the ante 5
patou99957: posts small blind 15
bdiddy1313: posts big blind 30
*** HOLE CARDS ***
69 hearts 69: folds 
rimis9999: folds 
noah5555: raises 60 to 90
gamesAREover: folds 
RoribeiroS: folds 
tomgan: folds 
patou99957: folds 
bdiddy1313: raises 210 to 300
noah5555: calls 210
*** FLOP *** [5h 9h As]
bdiddy1313: bets 216
noah5555: folds 
Uncalled bet (216) returned to bdiddy1313
bdiddy1313 collected 655 from pot
bdiddy1313: doesn't show hand 
*** SUMMARY ***
Total pot 655 | Rake 0 
Board [5h 9h As]
Seat 1: RoribeiroS folded before Flop (didn't bet)
Seat 2: tomgan (button) folded before Flop (didn't bet)
Seat 3: patou99957 (small blind) folded before Flop
Seat 5: bdiddy1313 (big blind) collected (655)
Seat 6: 69 hearts 69 folded before Flop (didn't bet)
Seat 7: rimis9999 folded before Flop (didn't bet)
Seat 8: noah5555 folded on the Flop
Seat 9: gamesAREover folded before Flop (didn't bet)



PokerStars Hand #157575090400: Tournament #1641817620, $7.50+$7.50+$1.50 USD Hold'em No Limit - Level I (15/30) - 2016/08/21 18:30:56 ET
Table '1641817620 12' 9-max Seat #2 is the button
Seat 1: Vlacerda (5134 in chips) 
Seat 2: aiaolinda (4980 in chips) 
Seat 3: faza29 (4916 in chips) 
Seat 4: Gottlieb007 (4995 in chips) 
Seat 5: ALEX-RSN (4995 in chips) 
Seat 6: MANJUS89 (4995 in chips) 
Seat 7: Mr. Burns501 (4995 in chips) 
Seat 8: CHARRUA1122 (4995 in chips) 
Seat 9: FrankLDrex (4995 in chips) 
Vlacerda: posts the ante 5
aiaolinda: posts the ante 5
faza29: posts the ante 5
Gottlieb007: posts the ante 5
ALEX-RSN: posts the ante 5
MANJUS89: posts the ante 5
Mr. Burns501: posts the ante 5
CHARRUA1122: posts the ante 5
FrankLDrex: posts the ante 5
faza29: posts small blind 15
Gottlieb007: posts big blind 30
*** HOLE CARDS ***
ALEX-RSN: folds 
MANJUS89: folds 
Mr. Burns501: folds 
CHARRUA1122: folds 
FrankLDrex: folds 
Vlacerda: folds 
aiaolinda: calls 30
faza29: folds 
Gottlieb007: checks 
*** FLOP *** [9s 5s 8c]
Gottlieb007: checks 
aiaolinda: bets 90
Gottlieb007: calls 90
*** TURN *** [9s 5s 8c] [8h]
Gottlieb007: checks 
aiaolinda: checks 
*** RIVER *** [9s 5s 8c 8h] [9h]
Gottlieb007: bets 360
aiaolinda: folds 
Uncalled bet (360) returned to Gottlieb007
Gottlieb007 collected 300 from pot
Gottlieb007: doesn't show hand 
*** SUMMARY ***
Total pot 300 | Rake 0 
Board [9s 5s 8c 8h 9h]
Seat 1: Vlacerda folded before Flop (didn't bet)
Seat 2: aiaolinda (button) folded on the River
Seat 3: faza29 (small blind) folded before Flop
Seat 4: Gottlieb007 (big blind) collected (300)
Seat 5: ALEX-RSN folded before Flop (didn't bet)
Seat 6: MANJUS89 folded before Flop (didn't bet)
Seat 7: Mr. Burns501 folded before Flop (didn't bet)
Seat 8: CHARRUA1122 folded before Flop (didn't bet)
Seat 9: FrankLDrex folded before Flop (didn't bet)



PokerStars Hand #157575090943: Tournament #1641817620, $7.50+$7.50+$1.50 USD Hold'em No Limit - Level I (15/30) - 2016/08/21 18:30:57 ET
Table '1641817620 53' 9-max Seat #2 is the button
Seat 1: star729 (5205 in chips) 
Seat 2: cebola77 (4980 in chips) 
Seat 3: Pekkosaurus (4965 in chips) 
Seat 4: -UNREGPRE- (4995 in chips) 
Seat 5: carlostrend (4875 in chips) 
Seat 6: The39player (4995 in chips) 
Seat 7: MingRey (4995 in chips) 
Seat 8: top@pokker (4995 in chips) 
Seat 9: cruiser5917 (4995 in chips) 
star729: posts the ante 5
cebola77: posts the ante 5
Pekkosaurus: posts the ante 5
-UNREGPRE-: posts the ante 5
carlostrend: posts the ante 5
The39player: posts the ante 5
MingRey: posts the ante 5
top@pokker: posts the ante 5
cruiser5917: posts the ante 5
Pekkosaurus: posts small blind 15
-UNREGPRE-: posts big blind 30
*** HOLE CARDS ***
carlostrend: raises 30 to 60
The39player: folds 
MingRey: folds 
top@pokker: folds 
cruiser5917: folds 
star729: raises 120 to 180
cebola77: folds 
Pekkosaurus: folds 
-UNREGPRE-: folds 
carlostrend: calls 120
*** FLOP *** [4d 5d 2c]
carlostrend: checks 
star729: bets 240
carlostrend: folds 
Uncalled bet (240) returned to star729
star729 collected 450 from pot
star729: doesn't show hand 
*** SUMMARY ***
Total pot 450 | Rake 0 
Board [4d 5d 2c]
Seat 1: star729 collected (450)
Seat 2: cebola77 (button) folded before Flop (didn't bet)
Seat 3: Pekkosaurus (small blind) folded before Flop
Seat 4: -UNREGPRE- (big blind) folded before Flop
Seat 5: carlostrend folded on the Flop
Seat 6: The39player folded before Flop (didn't bet)
Seat 7: MingRey folded before Flop (didn't bet)
Seat 8: top@pokker folded before Flop (didn't bet)
Seat 9: cruiser5917 folded before Flop (didn't bet)



PokerStars Hand #157575091182: Tournament #1641817620, $7.50+$7.50+$1.50 USD Hold'em No Limit - Level I (15/30) - 2016/08/21 18:30:57 ET
Table '1641817620 22' 9-max Seat #2 is the button
Seat 1: glangglang (4995 in chips) 
Seat 2: skalistair (4905 in chips) 
Seat 3: CHININ118 (4965 in chips) 
Seat 4: Jaliplay (5160 in chips) 
Seat 5: hewx (4995 in chips) 
Seat 6: xxSTORMZYxx (4995 in chips) 
Seat 7: ogotop76 (4995 in chips) 
Seat 8: monterreymx (4995 in chips) 
Seat 9: cash4king (4995 in chips) 
glangglang: posts the ante 5
skalistair: posts the ante 5
CHININ118: posts the ante 5
Jaliplay: posts the ante 5
hewx: posts the ante 5
xxSTORMZYxx: posts the ante 5
ogotop76: posts the ante 5
monterreymx: posts the ante 5
cash4king: posts the ante 5
CHININ118: posts small blind 15
Jaliplay: posts big blind 30
*** HOLE CARDS ***
hewx: folds 
xxSTORMZYxx: folds 
ogotop76: folds 
monterreymx: folds 
cash4king: raises 60 to 90
glangglang: folds 
skalistair: folds 
CHININ118: folds 
Jaliplay: calls 60
*** FLOP *** [Qs 5h Th]
Jaliplay: checks 
cash4king: bets 120
Jaliplay: folds 
Uncalled bet (120) returned to cash4king
cash4king collected 240 from pot
cash4king: doesn't show hand 
*** SUMMARY ***
Total pot 240 | Rake 0 
Board [Qs 5h Th]
Seat 1: glangglang folded before Flop (didn't bet)
Seat 2: skalistair (button) folded before Flop (didn't bet)
Seat 3: CHININ118 (small blind) folded before Flop
Seat 4: Jaliplay (big blind) folded on the Flop
Seat 5: hewx folded before Flop (didn't bet)
Seat 6: xxSTORMZYxx folded before Flop (didn't bet)
Seat 7: ogotop76 folded before Flop (didn't bet)
Seat 8: monterreymx folded before Flop (didn't bet)
Seat 9: cash4king collected (240)



PokerStars Hand #157575091502: Tournament #1641817620, $7.50+$7.50+$1.50 USD Hold'em No Limit - Level I (15/30) - 2016/08/21 18:30:58 ET
Table '1641817620 52' 9-max Seat #2 is the button
Seat 1: DoubleBBle (5400 in chips) 
Seat 2: FelipeMarlon (4980 in chips) 
Seat 3: michalis009 (4965 in chips) 
Seat 4: Daviderevan (4995 in chips) 
Seat 5: Armin2188 (4995 in chips) 
Seat 6: HORSEPOKER28 (4995 in chips) 
Seat 7: mopeeds87 (4680 in chips) 
Seat 8: vladvladutz (4995 in chips) 
Seat 9: leothefirm (4995 in chips) 
DoubleBBle: posts the ante 5
FelipeMarlon: posts the ante 5
michalis009: posts the ante 5
Daviderevan: posts the ante 5
Armin2188: posts the ante 5
HORSEPOKER28: posts the ante 5
mopeeds87: posts the ante 5
vladvladutz: posts the ante 5
leothefirm: posts the ante 5
michalis009: posts small blind 15
Daviderevan: posts big blind 30
*** HOLE CARDS ***
Armin2188: folds 
HORSEPOKER28: raises 45 to 75
mopeeds87: folds 
vladvladutz: folds 
leothefirm: calls 75
DoubleBBle: folds 
FelipeMarlon: folds 
michalis009: calls 60
Daviderevan: folds 
*** FLOP *** [2s 6h Ah]
michalis009: checks 
HORSEPOKER28: bets 125
leothefirm: folds 
michalis009: folds 
Uncalled bet (125) returned to HORSEPOKER28
HORSEPOKER28 collected 300 from pot
HORSEPOKER28: doesn't show hand 
*** SUMMARY ***
Total pot 300 | Rake 0 
Board [2s 6h Ah]
Seat 1: DoubleBBle folded before Flop (didn't bet)
Seat 2: FelipeMarlon (button) folded before Flop (didn't bet)
Seat 3: michalis009 (small blind) folded on the Flop
Seat 4: Daviderevan (big blind) folded before Flop
Seat 5: Armin2188 folded before Flop (didn't bet)
Seat 6: HORSEPOKER28 collected (300)
Seat 7: mopeeds87 folded before Flop (didn't bet)
Seat 8: vladvladutz folded before Flop (didn't bet)
Seat 9: leothefirm folded on the Flop



PokerStars Hand #157575091633: Tournament #1641817620, $7.50+$7.50+$1.50 USD Hold'em No Limit - Level I (15/30) - 2016/08/21 18:30:58 ET
Table '1641817620 21' 9-max Seat #2 is the button
Seat 1: apaixtos1 (4995 in chips) 
Seat 2: ukr_durrrr (4980 in chips) 
Seat 3: ultgamb (4965 in chips) 
Seat 4: fishin1981 (4995 in chips) 
Seat 5: jeroma123 (4995 in chips) 
Seat 6: olleggi (5085 in chips) 
Seat 7: pokerlazik (4995 in chips) 
Seat 8: pokerist2692 (4995 in chips) 
Seat 9: Ferrazz (4995 in chips) 
apaixtos1: posts the ante 5
ukr_durrrr: posts the ante 5
ultgamb: posts the ante 5
fishin1981: posts the ante 5
jeroma123: posts the ante 5
olleggi: posts the ante 5
pokerlazik: posts the ante 5
pokerist2692: posts the ante 5
Ferrazz: posts the ante 5
ultgamb: posts small blind 15
fishin1981: posts big blind 30
*** HOLE CARDS ***
jeroma123: folds 
olleggi: folds 
pokerlazik: folds 
pokerist2692: calls 30
Ferrazz: folds 
apaixtos1: folds 
ukr_durrrr: raises 90 to 120
ultgamb: folds 
fishin1981: folds 
pokerist2692: calls 90
*** FLOP *** [6h Kc 3h]
pokerist2692: checks 
ukr_durrrr: checks 
*** TURN *** [6h Kc 3h] [4d]
pokerist2692: bets 150
ukr_durrrr: folds 
Uncalled bet (150) returned to pokerist2692
pokerist2692 collected 330 from pot
*** SUMMARY ***
Total pot 330 | Rake 0 
Board [6h Kc 3h 4d]
Seat 1: apaixtos1 folded before Flop (didn't bet)
Seat 2: ukr_durrrr (button) folded on the Turn
Seat 3: ultgamb (small blind) folded before Flop
Seat 4: fishin1981 (big blind) folded before Flop
Seat 5: jeroma123 folded before Flop (didn't bet)
Seat 6: olleggi folded before Flop (didn't bet)
Seat 7: pokerlazik folded before Flop (didn't bet)
Seat 8: pokerist2692 collected (330)
Seat 9: Ferrazz folded before Flop (didn't bet)



PokerStars Hand #157575092129: Tournament #1641817620, $7.50+$7.50+$1.50 USD Hold'em No Limit - Level I (15/30) - 2016/08/21 18:30:59 ET
Table '1641817620 6' 9-max Seat #4 is the button
Seat 1: ASTRAXANSKI (4990 in chips) 
Seat 2: KOT-BEGEMOT6 (4975 in chips) 
Seat 3: agneseagnese (5000 in chips) 
Seat 4: mekkoramarha (4945 in chips) 
Seat 5: KKKistKKK (5000 in chips) out of hand (moved from another table into small blind)
Seat 6: brown1967 (5040 in chips) 
Seat 7: Balotelli195 (4990 in chips) 
Seat 8: linoleum006 (5075 in chips) 
Seat 9: Jelsomino79 (4990 in chips) 
ASTRAXANSKI: posts the ante 5
KOT-BEGEMOT6: posts the ante 5
agneseagnese: posts the ante 5
mekkoramarha: posts the ante 5
brown1967: posts the ante 5
Balotelli195: posts the ante 5
linoleum006: posts the ante 5
Jelsomino79: posts the ante 5
brown1967: posts small blind 15
Balotelli195: posts big blind 30
*** HOLE CARDS ***
linoleum006: folds 
Jelsomino79: folds 
ASTRAXANSKI: folds 
KOT-BEGEMOT6: folds 
agneseagnese: folds 
mekkoramarha: raises 34 to 64
brown1967: folds 
Balotelli195: folds 
Uncalled bet (34) returned to mekkoramarha
mekkoramarha collected 115 from pot
*** SUMMARY ***
Total pot 115 | Rake 0 
Seat 1: ASTRAXANSKI folded before Flop (didn't bet)
Seat 2: KOT-BEGEMOT6 folded before Flop (didn't bet)
Seat 3: agneseagnese folded before Flop (didn't bet)
Seat 4: mekkoramarha (button) collected (115)
Seat 6: brown1967 (small blind) folded before Flop
Seat 7: Balotelli195 (big blind) folded before Flop
Seat 8: linoleum006 folded before Flop (didn't bet)
Seat 9: Jelsomino79 folded before Flop (didn't bet)



PokerStars Hand #157575093414: Tournament #1641817620, $7.50+$7.50+$1.50 USD Hold'em No Limit - Level I (15/30) - 2016/08/21 18:31:01 ET
Table '1641817620 43' 9-max Seat #2 is the button
Seat 1: VeniG95 (4995 in chips) 
Seat 2: alanyamil (5070 in chips) 
Seat 3: Raulop (4965 in chips) 
Seat 4: SoulSlaye166 (4995 in chips) 
Seat 5: DimaRu777 (4995 in chips) 
Seat 6: Taima (4995 in chips) 
Seat 7: Caville88 (4995 in chips) 
Seat 8: BetoFolhaCMC (4995 in chips) 
Seat 9: cajool (4995 in chips) 
VeniG95: posts the ante 5
alanyamil: posts the ante 5
Raulop: posts the ante 5
SoulSlaye166: posts the ante 5
DimaRu777: posts the ante 5
Taima: posts the ante 5
Caville88: posts the ante 5
BetoFolhaCMC: posts the ante 5
cajool: posts the ante 5
Raulop: posts small blind 15
SoulSlaye166: posts big blind 30
*** HOLE CARDS ***
DimaRu777: folds 
Taima: folds 
Caville88: folds 
BetoFolhaCMC: folds 
cajool: folds 
VeniG95: folds 
alanyamil: folds 
Raulop: calls 15
SoulSlaye166: raises 150 to 180
Raulop: calls 150
*** FLOP *** [9s 4d Ac]
Raulop: checks 
SoulSlaye166: bets 259
Raulop: folds 
Uncalled bet (259) returned to SoulSlaye166
SoulSlaye166 collected 405 from pot
SoulSlaye166: doesn't show hand 
*** SUMMARY ***
Total pot 405 | Rake 0 
Board [9s 4d Ac]
Seat 1: VeniG95 folded before Flop (didn't bet)
Seat 2: alanyamil (button) folded before Flop (didn't bet)
Seat 3: Raulop (small blind) folded on the Flop
Seat 4: SoulSlaye166 (big blind) collected (405)
Seat 5: DimaRu777 folded before Flop (didn't bet)
Seat 6: Taima folded before Flop (didn't bet)
Seat 7: Caville88 folded before Flop (didn't bet)
Seat 8: BetoFolhaCMC folded before Flop (didn't bet)
Seat 9: cajool folded before Flop (didn't bet)



PokerStars Hand #157575093490: Tournament #1641817620, $7.50+$7.50+$1.50 USD Hold'em No Limit - Level I (15/30) - 2016/08/21 18:31:01 ET
Table '1641817620 17' 9-max Seat #2 is the button
Seat 1: guitarist68 (4995 in chips) 
Seat 2: Anton163reg (4980 in chips) 
Seat 3: GoldenBeeM (4965 in chips) 
Seat 4: PETER BEATZ (4845 in chips) 
Seat 5: Brisni (4995 in chips) 
Seat 6: dekota222 (4995 in chips) 
Seat 7: rooney69 (5235 in chips) 
Seat 8: uuvvrr (4995 in chips) 
Seat 9: Samburger514 (4995 in chips) 
guitarist68: posts the ante 5
Anton163reg: posts the ante 5
GoldenBeeM: posts the ante 5
PETER BEATZ: posts the ante 5
Brisni: posts the ante 5
dekota222: posts the ante 5
rooney69: posts the ante 5
uuvvrr: posts the ante 5
Samburger514: posts the ante 5
GoldenBeeM: posts small blind 15
PETER BEATZ: posts big blind 30
*** HOLE CARDS ***
Brisni: folds 
dekota222: folds 
rooney69: folds 
uuvvrr: folds 
Samburger514: calls 30
guitarist68: folds 
Anton163reg: folds 
GoldenBeeM: folds 
PETER BEATZ: checks 
*** FLOP *** [Th 7h Js]
PETER BEATZ: checks 
Samburger514: checks 
*** TURN *** [Th 7h Js] [9s]
PETER BEATZ: checks 
Samburger514: bets 120
PETER BEATZ: calls 120
*** RIVER *** [Th 7h Js 9s] [Jd]
PETER BEATZ: checks 
Samburger514: bets 360
PETER BEATZ: folds 
Uncalled bet (360) returned to Samburger514
Samburger514 collected 360 from pot
Samburger514: doesn't show hand 
*** SUMMARY ***
Total pot 360 | Rake 0 
Board [Th 7h Js 9s Jd]
Seat 1: guitarist68 folded before Flop (didn't bet)
Seat 2: Anton163reg (button) folded before Flop (didn't bet)
Seat 3: GoldenBeeM (small blind) folded before Flop
Seat 4: PETER BEATZ (big blind) folded on the River
Seat 5: Brisni folded before Flop (didn't bet)
Seat 6: dekota222 folded before Flop (didn't bet)
Seat 7: rooney69 folded before Flop (didn't bet)
Seat 8: uuvvrr folded before Flop (didn't bet)
Seat 9: Samburger514 collected (360)



PokerStars Hand #157575093698: Tournament #1641817620, $7.50+$7.50+$1.50 USD Hold'em No Limit - Level I (15/30) - 2016/08/21 18:31:01 ET
Table '1641817620 34' 9-max Seat #2 is the button
Seat 1: Zukertort (4995 in chips) is sitting out
Seat 2: AngelBerley (4980 in chips) 
Seat 3: Zigslick (4965 in chips) 
Seat 4: Snabers (4995 in chips) 
Seat 5: juggaletto (4905 in chips) 
Seat 6: virtus213 (4995 in chips) 
Seat 7: Poher42 (4995 in chips) 
Seat 8: S.FILTH (4995 in chips) 
Seat 9: omar miete (5175 in chips) 
Zukertort: posts the ante 5
AngelBerley: posts the ante 5
Zigslick: posts the ante 5
Snabers: posts the ante 5
juggaletto: posts the ante 5
virtus213: posts the ante 5
Poher42: posts the ante 5
S.FILTH: posts the ante 5
omar miete: posts the ante 5
Zigslick: posts small blind 15
Snabers: posts big blind 30
*** HOLE CARDS ***
juggaletto: folds 
virtus213: calls 30
Poher42: folds 
S.FILTH: folds 
omar miete: raises 45 to 75
Zukertort: folds 
AngelBerley: folds 
Zigslick: folds 
Snabers: folds 
virtus213: calls 45
*** FLOP *** [4s 5s 4c]
virtus213: checks 
omar miete: checks 
*** TURN *** [4s 5s 4c] [7c]
virtus213: checks 
omar miete: checks 
*** RIVER *** [4s 5s 4c 7c] [8s]
virtus213: checks 
omar miete: checks 
*** SHOW DOWN ***
virtus213: shows [Jh 3h] (a pair of Fours)
omar miete: shows [Jd Kd] (a pair of Fours - King kicker)
omar miete collected 240 from pot
*** SUMMARY ***
Total pot 240 | Rake 0 
Board [4s 5s 4c 7c 8s]
Seat 1: Zukertort folded before Flop (didn't bet)
Seat 2: AngelBerley (button) folded before Flop (didn't bet)
Seat 3: Zigslick (small blind) folded before Flop
Seat 4: Snabers (big blind) folded before Flop
Seat 5: juggaletto folded before Flop (didn't bet)
Seat 6: virtus213 showed [Jh 3h] and lost with a pair of Fours
Seat 7: Poher42 folded before Flop (didn't bet)
Seat 8: S.FILTH folded before Flop (didn't bet)
Seat 9: omar miete showed [Jd Kd] and won (240) with a pair of Fours



PokerStars Hand #157575093706: Tournament #1641817620, $7.50+$7.50+$1.50 USD Hold'em No Limit - Level I (15/30) - 2016/08/21 18:31:01 ET
Table '1641817620 24' 9-max Seat #2 is the button
Seat 1: heyyy presto (4995 in chips) 
Seat 2: BOW300 (4935 in chips) 
Seat 3: muskto (4935 in chips) 
Seat 4: jt3x87 (4995 in chips) 
Seat 5: PhaniaX (4995 in chips) 
Seat 6: pisti801 (4995 in chips) 
Seat 7: luckydayn (5160 in chips) 
Seat 8: trabey (4995 in chips) 
Seat 9: Quickcard (4995 in chips) is sitting out
heyyy presto: posts the ante 5
BOW300: posts the ante 5
muskto: posts the ante 5
jt3x87: posts the ante 5
PhaniaX: posts the ante 5
pisti801: posts the ante 5
luckydayn: posts the ante 5
trabey: posts the ante 5
Quickcard: posts the ante 5
muskto: posts small blind 15
jt3x87: posts big blind 30
*** HOLE CARDS ***
PhaniaX: folds 
pisti801: folds 
luckydayn: folds 
trabey: folds 
Quickcard: folds 
heyyy presto: folds 
BOW300: folds 
muskto: raises 30 to 60
jt3x87: calls 30
*** FLOP *** [8d 3s 6h]
muskto: bets 165
jt3x87: folds 
Uncalled bet (165) returned to muskto
muskto collected 165 from pot
muskto: doesn't show hand 
*** SUMMARY ***
Total pot 165 | Rake 0 
Board [8d 3s 6h]
Seat 1: heyyy presto folded before Flop (didn't bet)
Seat 2: BOW300 (button) folded before Flop (didn't bet)
Seat 3: muskto (small blind) collected (165)
Seat 4: jt3x87 (big blind) folded on the Flop
Seat 5: PhaniaX folded before Flop (didn't bet)
Seat 6: pisti801 folded before Flop (didn't bet)
Seat 7: luckydayn folded before Flop (didn't bet)
Seat 8: trabey folded before Flop (didn't bet)
Seat 9: Quickcard folded before Flop (didn't bet)



PokerStars Hand #157575094467: Tournament #1641817620, $7.50+$7.50+$1.50 USD Hold'em No Limit - Level I (15/30) - 2016/08/21 18:31:02 ET
Table '1641817620 57' 9-max Seat #2 is the button
Seat 1: pedroh2010 (4995 in chips) 
Seat 2: MasterTony77 (4980 in chips) 
Seat 3: ovekas (5145 in chips) 
Seat 4: ALWAYSBRAVES (4995 in chips) 
Seat 5: BaDBeaT_AK85 (4995 in chips) 
Seat 6: kachumban (4995 in chips) 
Seat 7: ZodiakGB (4995 in chips) 
Seat 8: MeortheMrs (4905 in chips) 
Seat 9: andreiuc (4995 in chips) 
pedroh2010: posts the ante 5
MasterTony77: posts the ante 5
ovekas: posts the ante 5
ALWAYSBRAVES: posts the ante 5
BaDBeaT_AK85: posts the ante 5
kachumban: posts the ante 5
ZodiakGB: posts the ante 5
MeortheMrs: posts the ante 5
andreiuc: posts the ante 5
ovekas: posts small blind 15
ALWAYSBRAVES: posts big blind 30
*** HOLE CARDS ***
BaDBeaT_AK85: folds 
kachumban: raises 45 to 75
ZodiakGB: folds 
MeortheMrs: folds 
andreiuc has timed out
andreiuc: folds 
andreiuc is sitting out
pedroh2010: raises 240 to 315
andreiuc has returned
MasterTony77: raises 510 to 825
ovekas: folds 
ALWAYSBRAVES: folds 
kachumban: folds 
pedroh2010: raises 1815 to 2640
MasterTony77: raises 2335 to 4975 and is all-in
pedroh2010: calls 2335
*** FLOP *** [Js 7d 8s]
*** TURN *** [Js 7d 8s] [6d]
*** RIVER *** [Js 7d 8s 6d] [Tc]
*** SHOW DOWN ***
pedroh2010: shows [Qs Qd] (a pair of Queens)
MasterTony77: shows [Kc As] (high card Ace)
pedroh2010 collected 10115 from pot
pedroh2010 wins $3.75 for eliminating MasterTony77 and their own bounty increases by $3.75 to $11.25
MasterTony77 finished the tournament in 999999996th place
*** SUMMARY ***
Total pot 10115 | Rake 0 
Board [Js 7d 8s 6d Tc]
Seat 1: pedroh2010 showed [Qs Qd] and won (10115) with a pair of Queens
Seat 2: MasterTony77 (button) showed [Kc As] and lost with high card Ace
Seat 3: ovekas (small blind) folded before Flop
Seat 4: ALWAYSBRAVES (big blind) folded before Flop
Seat 5: BaDBeaT_AK85 folded before Flop (didn't bet)
Seat 6: kachumban folded before Flop
Seat 7: ZodiakGB folded before Flop (didn't bet)
Seat 8: MeortheMrs folded before Flop (didn't bet)
Seat 9: andreiuc folded before Flop (didn't bet)



PokerStars Hand #157575094858: Tournament #1641817620, $7.50+$7.50+$1.50 USD Hold'em No Limit - Level I (15/30) - 2016/08/21 18:31:03 ET
Table '1641817620 10' 9-max Seat #3 is the button
Seat 1: VANDECO174 (4990 in chips) 
Seat 2: Be Anger (4975 in chips) 
Seat 3: mickyryan (5035 in chips) 
Seat 4: silveira1879 (5050 in chips) 
Seat 5: AndyLou27 (4990 in chips) 
Seat 6: I M GOIN OFF (4990 in chips) 
Seat 7: Nuazo (4990 in chips) 
Seat 8: damibor (4990 in chips) 
Seat 9: Stokesy05 (4990 in chips) 
VANDECO174: posts the ante 5
Be Anger: posts the ante 5
mickyryan: posts the ante 5
silveira1879: posts the ante 5
AndyLou27: posts the ante 5
I M GOIN OFF: posts the ante 5
Nuazo: posts the ante 5
damibor: posts the ante 5
Stokesy05: posts the ante 5
silveira1879: posts small blind 15
AndyLou27: posts big blind 30
*** HOLE CARDS ***
I M GOIN OFF: folds 
Nuazo: folds 
damibor: raises 30 to 60
Stokesy05: calls 60
VANDECO174: folds 
Be Anger: folds 
mickyryan: folds 
silveira1879: folds 
AndyLou27: folds 
*** FLOP *** [Ts 4s Th]
damibor: bets 105
Stokesy05: folds 
Uncalled bet (105) returned to damibor
damibor collected 210 from pot
damibor: doesn't show hand 
*** SUMMARY ***
Total pot 210 | Rake 0 
Board [Ts 4s Th]
Seat 1: VANDECO174 folded before Flop (didn't bet)
Seat 2: Be Anger folded before Flop (didn't bet)
Seat 3: mickyryan (button) folded before Flop (didn't bet)
Seat 4: silveira1879 (small blind) folded before Flop
Seat 5: AndyLou27 (big blind) folded before Flop
Seat 6: I M GOIN OFF folded before Flop (didn't bet)
Seat 7: Nuazo folded before Flop (didn't bet)
Seat 8: damibor collected (210)
Seat 9: Stokesy05 folded on the Flop



PokerStars Hand #157575095540: Tournament #1641817620, $7.50+$7.50+$1.50 USD Hold'em No Limit - Level I (15/30) - 2016/08/21 18:31:04 ET
Table '1641817620 3' 9-max Seat #2 is the button
Seat 1: IwantplayNL (4995 in chips) 
Seat 2: dufino (5166 in chips) 
Seat 3: zIggY-7-rAc3 (4965 in chips) 
Seat 4: gerald0jr (4995 in chips) 
Seat 5: sergiohbl (4995 in chips) 
Seat 6: BrunoCastroR (4995 in chips) 
Seat 7: alehirazawa (4995 in chips) 
Seat 8: markosharko (4899 in chips) 
Seat 9: VictorZh14 (4995 in chips) 
IwantplayNL: posts the ante 5
dufino: posts the ante 5
zIggY-7-rAc3: posts the ante 5
gerald0jr: posts the ante 5
sergiohbl: posts the ante 5
BrunoCastroR: posts the ante 5
alehirazawa: posts the ante 5
markosharko: posts the ante 5
VictorZh14: posts the ante 5
zIggY-7-rAc3: posts small blind 15
gerald0jr: posts big blind 30
*** HOLE CARDS ***
sergiohbl: folds 
BrunoCastroR: raises 45 to 75
alehirazawa: folds 
markosharko: folds 
VictorZh14: folds 
IwantplayNL: folds 
dufino: raises 240 to 315
zIggY-7-rAc3: folds 
gerald0jr: folds 
BrunoCastroR: calls 240
*** FLOP *** [4c 2s 2c]
BrunoCastroR: checks 
dufino: checks 
*** TURN *** [4c 2s 2c] [Ts]
BrunoCastroR: checks 
dufino: bets 720
BrunoCastroR: calls 720
*** RIVER *** [4c 2s 2c Ts] [4h]
BrunoCastroR: bets 1080
dufino: calls 1080
*** SHOW DOWN ***
BrunoCastroR: shows [8s 5s] (two pair, Fours and Deuces)
dufino: shows [Kc Kh] (two pair, Kings and Fours)
dufino collected 4320 from pot
*** SUMMARY ***
Total pot 4320 | Rake 0 
Board [4c 2s 2c Ts 4h]
Seat 1: IwantplayNL folded before Flop (didn't bet)
Seat 2: dufino (button) showed [Kc Kh] and won (4320) with two pair, Kings and Fours
Seat 3: zIggY-7-rAc3 (small blind) folded before Flop
Seat 4: gerald0jr (big blind) folded before Flop
Seat 5: sergiohbl folded before Flop (didn't bet)
Seat 6: BrunoCastroR showed [8s 5s] and lost with two pair, Fours and Deuces
Seat 7: alehirazawa folded before Flop (didn't bet)
Seat 8: markosharko folded before Flop (didn't bet)
Seat 9: VictorZh14 folded before Flop (didn't bet)



PokerStars Hand #157575096175: Tournament #1641817620, $7.50+$7.50+$1.50 USD Hold'em No Limit - Level I (15/30) - 2016/08/21 18:31:05 ET
Table '1641817620 5' 9-max Seat #2 is the button
Seat 2: jonesfi5sh (4980 in chips) 
Seat 3: PhenomPen1 (4965 in chips) 
Seat 4: GrimJoker77 (4935 in chips) 
Seat 5: NorocDeRoman (4995 in chips) 
Seat 6: Javicho9 (4995 in chips) 
Seat 7: athilapvh (10140 in chips) 
Seat 8: sloty27 (4995 in chips) 
Seat 9: chuny dealer (4995 in chips) 
jonesfi5sh: posts the ante 5
PhenomPen1: posts the ante 5
GrimJoker77: posts the ante 5
NorocDeRoman: posts the ante 5
Javicho9: posts the ante 5
athilapvh: posts the ante 5
sloty27: posts the ante 5
chuny dealer: posts the ante 5
PhenomPen1: posts small blind 15
GrimJoker77: posts big blind 30
*** HOLE CARDS ***
NorocDeRoman: folds 
Javicho9: folds 
athilapvh: folds 
sloty27: folds 
chuny dealer: folds 
jonesfi5sh: folds 
PhenomPen1: calls 15
GrimJoker77: raises 100 to 130
PhenomPen1: folds 
Uncalled bet (100) returned to GrimJoker77
GrimJoker77 collected 100 from pot
GrimJoker77: doesn't show hand 
*** SUMMARY ***
Total pot 100 | Rake 0 
Seat 2: jonesfi5sh (button) folded before Flop (didn't bet)
Seat 3: PhenomPen1 (small blind) folded before Flop
Seat 4: GrimJoker77 (big blind) collected (100)
Seat 5: NorocDeRoman folded before Flop (didn't bet)
Seat 6: Javicho9 folded before Flop (didn't bet)
Seat 7: athilapvh folded before Flop (didn't bet)
Seat 8: sloty27 folded before Flop (didn't bet)
Seat 9: chuny dealer folded before Flop (didn't bet)



PokerStars Hand #157575099947: Tournament #1641817620, $7.50+$7.50+$1.50 USD Hold'em No Limit - Level I (15/30) - 2016/08/21 18:31:10 ET
Table '1641817620 31' 9-max Seat #2 is the button
Seat 1: JmanRz (4995 in chips) 
Seat 2: Esp2011 (4781 in chips) 
Seat 3: karanikolass (5254 in chips) 
Seat 5: jucielitheco (4995 in chips) 
Seat 6: Ant_md (4995 in chips) 
Seat 7: fkamus (4995 in chips) 
Seat 8: RENA79 (4995 in chips) 
Seat 9: Jack.Siete (4995 in chips) 
JmanRz: posts the ante 5
Esp2011: posts the ante 5
karanikolass: posts the ante 5
jucielitheco: posts the ante 5
Ant_md: posts the ante 5
fkamus: posts the ante 5
RENA79: posts the ante 5
Jack.Siete: posts the ante 5
karanikolass: posts small blind 15
jucielitheco: posts big blind 30
*** HOLE CARDS ***
Ant_md: raises 30 to 60
fkamus: folds 
RENA79: folds 
Jack.Siete: folds 
JmanRz: calls 60
Esp2011: folds 
karanikolass: calls 45
jucielitheco: folds 
*** FLOP *** [5s 6h 3s]
karanikolass: checks 
Ant_md: bets 125
JmanRz: folds 
karanikolass: folds 
Uncalled bet (125) returned to Ant_md
Ant_md collected 250 from pot
*** SUMMARY ***
Total pot 250 | Rake 0 
Board [5s 6h 3s]
Seat 1: JmanRz folded on the Flop
Seat 2: Esp2011 (button) folded before Flop (didn't bet)
Seat 3: karanikolass (small blind) folded on the Flop
Seat 5: jucielitheco (big blind) folded before Flop
Seat 6: Ant_md collected (250)
Seat 7: fkamus folded before Flop (didn't bet)
Seat 8: RENA79 folded before Flop (didn't bet)
Seat 9: Jack.Siete folded before Flop (didn't bet)



PokerStars Hand #157575100297: Tournament #1641817620, $7.50+$7.50+$1.50 USD Hold'em No Limit - Level I (15/30) - 2016/08/21 18:31:11 ET
Table '1641817620 44' 9-max Seat #3 is the button
Seat 1: BurrGrylls (4990 in chips) 
Seat 2: moisesgosu (4975 in chips) 
Seat 3: kduwork (5035 in chips) 
Seat 4: starkstud (5140 in chips) 
Seat 6: lesley hu (4990 in chips) is sitting out
Seat 7: aihongepji32 (4900 in chips) 
Seat 8: heynow21 (4990 in chips) 
Seat 9: Pro_Tunis (4990 in chips) 
BurrGrylls: posts the ante 5
moisesgosu: posts the ante 5
kduwork: posts the ante 5
starkstud: posts the ante 5
lesley hu: posts the ante 5
aihongepji32: posts the ante 5
heynow21: posts the ante 5
Pro_Tunis: posts the ante 5
starkstud: posts small blind 15
lesley hu: posts big blind 30
*** HOLE CARDS ***
aihongepji32: folds 
heynow21: folds 
Pro_Tunis: raises 60 to 90
BurrGrylls: folds 
moisesgosu: folds 
kduwork: folds 
starkstud: folds 
lesley hu: folds 
Uncalled bet (60) returned to Pro_Tunis
Pro_Tunis collected 115 from pot
Pro_Tunis: doesn't show hand 
*** SUMMARY ***
Total pot 115 | Rake 0 
Seat 1: BurrGrylls folded before Flop (didn't bet)
Seat 2: moisesgosu folded before Flop (didn't bet)
Seat 3: kduwork (button) folded before Flop (didn't bet)
Seat 4: starkstud (small blind) folded before Flop
Seat 6: lesley hu (big blind) folded before Flop
Seat 7: aihongepji32 folded before Flop (didn't bet)
Seat 8: heynow21 folded before Flop (didn't bet)
Seat 9: Pro_Tunis collected (115)



PokerStars Hand #157575100468: Tournament #1641817620, $7.50+$7.50+$1.50 USD Hold'em No Limit - Level I (15/30) - 2016/08/21 18:31:11 ET
Table '1641817620 38' 9-max Seat #2 is the button
Seat 1: chechako#8 (4995 in chips) 
Seat 2: kristofxm8 (4980 in chips) 
Seat 3: persephoney (4920 in chips) 
Seat 5: jager1987 (4995 in chips) 
Seat 6: Dr.Durrrq (5130 in chips) 
Seat 7: Myschkin_Lev (4995 in chips) 
Seat 8: Bon_Choueur (4995 in chips) 
Seat 9: dtb1978 (4995 in chips) 
chechako#8: posts the ante 5
kristofxm8: posts the ante 5
persephoney: posts the ante 5
jager1987: posts the ante 5
Dr.Durrrq: posts the ante 5
Myschkin_Lev: posts the ante 5
Bon_Choueur: posts the ante 5
dtb1978: posts the ante 5
persephoney: posts small blind 15
jager1987: posts big blind 30
*** HOLE CARDS ***
Dr.Durrrq: folds 
Myschkin_Lev: calls 30
Bon_Choueur: raises 60 to 90
dtb1978: folds 
chechako#8: raises 210 to 300
kristofxm8: calls 300
persephoney: folds 
jager1987: folds 
Myschkin_Lev: folds 
Bon_Choueur: calls 210
*** FLOP *** [Ts 5d 7d]
Bon_Choueur: checks 
chechako#8: checks 
kristofxm8: checks 
*** TURN *** [Ts 5d 7d] [4d]
Bon_Choueur: checks 
chechako#8: checks 
kristofxm8: checks 
*** RIVER *** [Ts 5d 7d 4d] [6d]
Bon_Choueur: checks 
chechako#8: checks 
kristofxm8: bets 507
Bon_Choueur: folds 
chechako#8: folds 
Uncalled bet (507) returned to kristofxm8
kristofxm8 collected 1015 from pot
kristofxm8: doesn't show hand 
*** SUMMARY ***
Total pot 1015 | Rake 0 
Board [Ts 5d 7d 4d 6d]
Seat 1: chechako#8 folded on the River
Seat 2: kristofxm8 (button) collected (1015)
Seat 3: persephoney (small blind) folded before Flop
Seat 5: jager1987 (big blind) folded before Flop
Seat 6: Dr.Durrrq folded before Flop (didn't bet)
Seat 7: Myschkin_Lev folded before Flop
Seat 8: Bon_Choueur folded on the River
Seat 9: dtb1978 folded before Flop (didn't bet)



PokerStars Hand #157575100493: Tournament #1641817620, $7.50+$7.50+$1.50 USD Hold'em No Limit - Level I (15/30) - 2016/08/21 18:31:11 ET
Table '1641817620 47' 9-max Seat #2 is the button
Seat 1: sovikeen (4995 in chips) 
Seat 2: RipperRooo (5370 in chips) 
Seat 3: gtavares10 (4965 in chips) 
Seat 5: IvnAK (4695 in chips) 
Seat 6: sergiooker (4995 in chips) 
Seat 7: T3chnojunk (4995 in chips) 
Seat 8: bruff3l (4995 in chips) 
Seat 9: ppmaster (4995 in chips) 
sovikeen: posts the ante 5
RipperRooo: posts the ante 5
gtavares10: posts the ante 5
IvnAK: posts the ante 5
sergiooker: posts the ante 5
T3chnojunk: posts the ante 5
bruff3l: posts the ante 5
ppmaster: posts the ante 5
gtavares10: posts small blind 15
IvnAK: posts big blind 30
*** HOLE CARDS ***
sergiooker: folds 
T3chnojunk: folds 
bruff3l: raises 170 to 200
ppmaster: folds 
sovikeen: folds 
RipperRooo: folds 
gtavares10: folds 
IvnAK: folds 
Uncalled bet (170) returned to bruff3l
bruff3l collected 115 from pot
bruff3l: doesn't show hand 
*** SUMMARY ***
Total pot 115 | Rake 0 
Seat 1: sovikeen folded before Flop (didn't bet)
Seat 2: RipperRooo (button) folded before Flop (didn't bet)
Seat 3: gtavares10 (small blind) folded before Flop
Seat 5: IvnAK (big blind) folded before Flop
Seat 6: sergiooker folded before Flop (didn't bet)
Seat 7: T3chnojunk folded before Flop (didn't bet)
Seat 8: bruff3l collected (115)
Seat 9: ppmaster folded before Flop (didn't bet)



PokerStars Hand #157575100710: Tournament #1641817620, $7.50+$7.50+$1.50 USD Hold'em No Limit - Level I (15/30) - 2016/08/21 18:31:11 ET
Table '1641817620 15' 9-max Seat #2 is the button
Seat 1: WRussia (4815 in chips) 
Seat 2: miche1301 (4980 in chips) 
Seat 3: tsolias87 (4965 in chips) 
Seat 5: mdf92 (4995 in chips) 
Seat 6: becky88 (4995 in chips) 
Seat 7: Yokiro (4995 in chips) 
Seat 8: Rob.nl (4815 in chips) 
Seat 9: mfalmeidacs (5445 in chips) 
WRussia: posts the ante 5
miche1301: posts the ante 5
tsolias87: posts the ante 5
mdf92: posts the ante 5
becky88: posts the ante 5
Yokiro: posts the ante 5
Rob.nl: posts the ante 5
mfalmeidacs: posts the ante 5
tsolias87: posts small blind 15
mdf92: posts big blind 30
*** HOLE CARDS ***
becky88: raises 60 to 90
Yokiro: folds 
Rob.nl: calls 90
mfalmeidacs: folds 
WRussia: folds 
miche1301: folds 
tsolias87: folds 
mdf92: calls 60
*** FLOP *** [Qs 3c 2s]
mdf92: checks 
becky88: bets 240
Rob.nl: folds 
mdf92: folds 
Uncalled bet (240) returned to becky88
becky88 collected 325 from pot
*** SUMMARY ***
Total pot 325 | Rake 0 
Board [Qs 3c 2s]
Seat 1: WRussia folded before Flop (didn't bet)
Seat 2: miche1301 (button) folded before Flop (didn't bet)
Seat 3: tsolias87 (small blind) folded before Flop
Seat 5: mdf92 (big blind) folded on the Flop
Seat 6: becky88 collected (325)
Seat 7: Yokiro folded before Flop (didn't bet)
Seat 8: Rob.nl folded on the Flop
Seat 9: mfalmeidacs folded before Flop (didn't bet)



PokerStars Hand #157575100786: Tournament #1641817620, $7.50+$7.50+$1.50 USD Hold'em No Limit - Level I (15/30) - 2016/08/21 18:31:12 ET
Table '1641817620 37' 9-max Seat #2 is the button
Seat 1: Youbetipush1 (4995 in chips) 
Seat 2: SouzaEduardo (4980 in chips) 
Seat 3: Maisteri (4965 in chips) 
Seat 4: qball911 (4995 in chips) 
Seat 5: cammyboy777 (4995 in chips) is sitting out
Seat 6: ColdFire_200 (4995 in chips) 
Seat 8: Starvinghelp (1875 in chips) 
Seat 9: carabason (8205 in chips) 
Youbetipush1: posts the ante 5
SouzaEduardo: posts the ante 5
Maisteri: posts the ante 5
qball911: posts the ante 5
cammyboy777: posts the ante 5
ColdFire_200: posts the ante 5
Starvinghelp: posts the ante 5
carabason: posts the ante 5
Maisteri: posts small blind 15
qball911: posts big blind 30
*** HOLE CARDS ***
cammyboy777: folds 
ColdFire_200: folds 
Starvinghelp: folds 
carabason: raises 45 to 75
Youbetipush1: folds 
SouzaEduardo: folds 
Maisteri: folds 
qball911: folds 
Uncalled bet (45) returned to carabason
carabason collected 115 from pot
carabason: doesn't show hand 
*** SUMMARY ***
Total pot 115 | Rake 0 
Seat 1: Youbetipush1 folded before Flop (didn't bet)
Seat 2: SouzaEduardo (button) folded before Flop (didn't bet)
Seat 3: Maisteri (small blind) folded before Flop
Seat 4: qball911 (big blind) folded before Flop
Seat 5: cammyboy777 folded before Flop (didn't bet)
Seat 6: ColdFire_200 folded before Flop (didn't bet)
Seat 8: Starvinghelp folded before Flop (didn't bet)
Seat 9: carabason collected (115)



PokerStars Hand #157575101693: Tournament #1641817620, $7.50+$7.50+$1.50 USD Hold'em No Limit - Level I (15/30) - 2016/08/21 18:31:13 ET
Table '1641817620 16' 9-max Seat #2 is the button
Seat 1: Kugelbohne79 (4995 in chips) 
Seat 2: Sergei0384 (4980 in chips) 
Seat 3: paschalisbg (4965 in chips) 
Seat 4: Maisiewin (4935 in chips) 
Seat 5: alemaozl (4995 in chips) 
Seat 6: malenkaya17 (4995 in chips) 
Seat 7: burton14 (4995 in chips) 
Seat 8: Miky_Man993 (4935 in chips) 
Seat 9: ziboin (5205 in chips) 
Kugelbohne79: posts the ante 5
Sergei0384: posts the ante 5
paschalisbg: posts the ante 5
Maisiewin: posts the ante 5
alemaozl: posts the ante 5
malenkaya17: posts the ante 5
burton14: posts the ante 5
Miky_Man993: posts the ante 5
ziboin: posts the ante 5
paschalisbg: posts small blind 15
Maisiewin: posts big blind 30
*** HOLE CARDS ***
alemaozl: folds 
malenkaya17: folds 
burton14: folds 
Miky_Man993: folds 
ziboin: folds 
Kugelbohne79: folds 
Sergei0384: raises 36 to 66
paschalisbg: folds 
Maisiewin: calls 36
*** FLOP *** [Ad 5s Tc]
Maisiewin: checks 
Sergei0384: checks 
*** TURN *** [Ad 5s Tc] [9c]
Maisiewin: checks 
Sergei0384: checks 
*** RIVER *** [Ad 5s Tc 9c] [3h]
Maisiewin: checks 
Sergei0384: checks 
*** SHOW DOWN ***
Maisiewin: shows [Qh Js] (high card Ace)
Sergei0384: shows [Kh 7h] (high card Ace - King kicker)
Sergei0384 collected 192 from pot
*** SUMMARY ***
Total pot 192 | Rake 0 
Board [Ad 5s Tc 9c 3h]
Seat 1: Kugelbohne79 folded before Flop (didn't bet)
Seat 2: Sergei0384 (button) showed [Kh 7h] and won (192) with high card Ace
Seat 3: paschalisbg (small blind) folded before Flop
Seat 4: Maisiewin (big blind) showed [Qh Js] and lost with high card Ace
Seat 5: alemaozl folded before Flop (didn't bet)
Seat 6: malenkaya17 folded before Flop (didn't bet)
Seat 7: burton14 folded before Flop (didn't bet)
Seat 8: Miky_Man993 folded before Flop (didn't bet)
Seat 9: ziboin folded before Flop (didn't bet)



PokerStars Hand #157575102355: Tournament #1641817620, $7.50+$7.50+$1.50 USD Hold'em No Limit - Level I (15/30) - 2016/08/21 18:31:14 ET
Table '1641817620 26' 9-max Seat #2 is the button
Seat 1: duplo1182 (4995 in chips) 
Seat 2: Heretic66688 (4980 in chips) 
Seat 3: Axkj (4965 in chips) 
Seat 4: h1per1on (4995 in chips) 
Seat 5: xmommybearx (4845 in chips) 
Seat 6: Archibal_17 (4845 in chips) 
Seat 7: GDLW26 (4995 in chips) 
Seat 8: LongTermTILT (5385 in chips) 
Seat 9: danius111 (4995 in chips) 
duplo1182: posts the ante 5
Heretic66688: posts the ante 5
Axkj: posts the ante 5
h1per1on: posts the ante 5
xmommybearx: posts the ante 5
Archibal_17: posts the ante 5
GDLW26: posts the ante 5
LongTermTILT: posts the ante 5
danius111: posts the ante 5
Axkj: posts small blind 15
h1per1on: posts big blind 30
*** HOLE CARDS ***
xmommybearx: folds 
Archibal_17: raises 30 to 60
GDLW26: folds 
LongTermTILT: folds 
danius111: calls 60
duplo1182: folds 
Heretic66688: folds 
Axkj: folds 
h1per1on: folds 
*** FLOP *** [2c Js 9d]
Archibal_17: checks 
danius111: bets 105
Archibal_17: folds 
Uncalled bet (105) returned to danius111
danius111 collected 210 from pot
danius111: doesn't show hand 
*** SUMMARY ***
Total pot 210 | Rake 0 
Board [2c Js 9d]
Seat 1: duplo1182 folded before Flop (didn't bet)
Seat 2: Heretic66688 (button) folded before Flop (didn't bet)
Seat 3: Axkj (small blind) folded before Flop
Seat 4: h1per1on (big blind) folded before Flop
Seat 5: xmommybearx folded before Flop (didn't bet)
Seat 6: Archibal_17 folded on the Flop
Seat 7: GDLW26 folded before Flop (didn't bet)
Seat 8: LongTermTILT folded before Flop (didn't bet)
Seat 9: danius111 collected (210)



PokerStars Hand #157575102926: Tournament #1641817620, $7.50+$7.50+$1.50 USD Hold'em No Limit - Level I (15/30) - 2016/08/21 18:31:15 ET
Table '1641817620 39' 9-max Seat #2 is the button
Seat 1: BuyMeBMW (4995 in chips) 
Seat 2: ahaknh (4965 in chips) 
Seat 3: Crim44 (4965 in chips) 
Seat 4: Neo_gracz (4995 in chips) 
Seat 5: Euan_x (5250 in chips) 
Seat 6: TxsFrUrMoney (4995 in chips) 
Seat 7: j.williams94 (4995 in chips) 
Seat 8: 88K@la88 (4995 in chips) 
Seat 9: Foggy56 (4845 in chips) 
BuyMeBMW: posts the ante 5
ahaknh: posts the ante 5
Crim44: posts the ante 5
Neo_gracz: posts the ante 5
Euan_x: posts the ante 5
TxsFrUrMoney: posts the ante 5
j.williams94: posts the ante 5
88K@la88: posts the ante 5
Foggy56: posts the ante 5
Crim44: posts small blind 15
Neo_gracz: posts big blind 30
*** HOLE CARDS ***
Euan_x: calls 30
TxsFrUrMoney: folds 
j.williams94: raises 90 to 120
88K@la88: folds 
Foggy56: folds 
BuyMeBMW: folds 
ahaknh: folds 
Crim44: folds 
Neo_gracz: folds 
Euan_x: calls 90
*** FLOP *** [Qh 4d 9s]
Euan_x: checks 
j.williams94: bets 180
Euan_x: folds 
Uncalled bet (180) returned to j.williams94
j.williams94 collected 330 from pot
j.williams94: doesn't show hand 
*** SUMMARY ***
Total pot 330 | Rake 0 
Board [Qh 4d 9s]
Seat 1: BuyMeBMW folded before Flop (didn't bet)
Seat 2: ahaknh (button) folded before Flop (didn't bet)
Seat 3: Crim44 (small blind) folded before Flop
Seat 4: Neo_gracz (big blind) folded before Flop
Seat 5: Euan_x folded on the Flop
Seat 6: TxsFrUrMoney folded before Flop (didn't bet)
Seat 7: j.williams94 collected (330)
Seat 8: 88K@la88 folded before Flop (didn't bet)
Seat 9: Foggy56 folded before Flop (didn't bet)



PokerStars Hand #157575103218: Tournament #1641817620, $7.50+$7.50+$1.50 USD Hold'em No Limit - Level I (15/30) - 2016/08/21 18:31:15 ET
Table '1641817620 55' 9-max Seat #2 is the button
Seat 1: jake5030 (4995 in chips) 
Seat 2: HayArro (4905 in chips) 
Seat 3: MaxPips (4905 in chips) 
Seat 4: furia75205 (4995 in chips) 
Seat 5: hoolzky (4905 in chips) 
Seat 6: B.Paulino (4995 in chips) 
Seat 7: xLewie (5310 in chips) 
Seat 8: mendozoQ (4995 in chips) 
Seat 9: igara tigara (4995 in chips) 
jake5030: posts the ante 5
HayArro: posts the ante 5
MaxPips: posts the ante 5
furia75205: posts the ante 5
hoolzky: posts the ante 5
B.Paulino: posts the ante 5
xLewie: posts the ante 5
mendozoQ: posts the ante 5
igara tigara: posts the ante 5
MaxPips: posts small blind 15
furia75205: posts big blind 30
*** HOLE CARDS ***
hoolzky: folds 
B.Paulino: folds 
xLewie: raises 60 to 90
mendozoQ: folds 
igara tigara: folds 
jake5030: folds 
HayArro: folds 
MaxPips: folds 
furia75205: folds 
Uncalled bet (60) returned to xLewie
xLewie collected 120 from pot
xLewie: doesn't show hand 
*** SUMMARY ***
Total pot 120 | Rake 0 
Seat 1: jake5030 folded before Flop (didn't bet)
Seat 2: HayArro (button) folded before Flop (didn't bet)
Seat 3: MaxPips (small blind) folded before Flop
Seat 4: furia75205 (big blind) folded before Flop
Seat 5: hoolzky folded before Flop (didn't bet)
Seat 6: B.Paulino folded before Flop (didn't bet)
Seat 7: xLewie collected (120)
Seat 8: mendozoQ folded before Flop (didn't bet)
Seat 9: igara tigara folded before Flop (didn't bet)



PokerStars Hand #157575104838: Tournament #1641817620, $7.50+$7.50+$1.50 USD Hold'em No Limit - Level I (15/30) - 2016/08/21 18:31:18 ET
Table '1641817620 48' 9-max Seat #2 is the button
Seat 1: soft8981 (4995 in chips) 
Seat 2: getatore (4875 in chips) 
Seat 3: Serg2407 (4875 in chips) 
Seat 4: Zareta (4995 in chips) 
Seat 5: NSStefan (4995 in chips) 
Seat 6: ATE13 (4995 in chips) 
Seat 7: BRUCE999999 (5280 in chips) 
Seat 8: howtown (4995 in chips) 
Seat 9: qcouest (4995 in chips) 
soft8981: posts the ante 5
getatore: posts the ante 5
Serg2407: posts the ante 5
Zareta: posts the ante 5
NSStefan: posts the ante 5
ATE13: posts the ante 5
BRUCE999999: posts the ante 5
howtown: posts the ante 5
qcouest: posts the ante 5
Serg2407: posts small blind 15
Zareta: posts big blind 30
*** HOLE CARDS ***
NSStefan: folds 
ATE13: folds 
BRUCE999999: folds 
howtown: raises 60 to 90
qcouest: calls 90
soft8981: calls 90
getatore: calls 90
Serg2407: folds 
Zareta: calls 60
*** FLOP *** [9s 4d 6d]
Zareta: checks 
howtown: bets 204
qcouest: calls 204
soft8981: calls 204
getatore: folds 
Zareta: folds 
*** TURN *** [9s 4d 6d] [3c]
howtown: checks 
qcouest: checks 
soft8981: checks 
*** RIVER *** [9s 4d 6d 3c] [8d]
howtown: checks 
qcouest: bets 570
soft8981: folds 
howtown: folds 
Uncalled bet (570) returned to qcouest
qcouest collected 1122 from pot
qcouest: doesn't show hand 
*** SUMMARY ***
Total pot 1122 | Rake 0 
Board [9s 4d 6d 3c 8d]
Seat 1: soft8981 folded on the River
Seat 2: getatore (button) folded on the Flop
Seat 3: Serg2407 (small blind) folded before Flop
Seat 4: Zareta (big blind) folded on the Flop
Seat 5: NSStefan folded before Flop (didn't bet)
Seat 6: ATE13 folded before Flop (didn't bet)
Seat 7: BRUCE999999 folded before Flop (didn't bet)
Seat 8: howtown folded on the River
Seat 9: qcouest collected (1122)



PokerStars Hand #157575105139: Tournament #1641817620, $7.50+$7.50+$1.50 USD Hold'em No Limit - Level I (15/30) - 2016/08/21 18:31:18 ET
Table '1641817620 42' 9-max Seat #2 is the button
Seat 1: killa187187 (4785 in chips) 
Seat 2: lmiotto88 (5280 in chips) 
Seat 3: Piiirat (4965 in chips) 
Seat 4: skjørring (4995 in chips) 
Seat 5: AcabeiDeSair (4995 in chips) 
Seat 6: MasterInsekt (4995 in chips) 
Seat 7: ThirtyTw0 (4995 in chips) 
Seat 8: FeFeFeFeFEDE (4995 in chips) 
Seat 9: radekvv777 (4995 in chips) 
killa187187: posts the ante 5
lmiotto88: posts the ante 5
Piiirat: posts the ante 5
skjørring: posts the ante 5
AcabeiDeSair: posts the ante 5
MasterInsekt: posts the ante 5
ThirtyTw0: posts the ante 5
FeFeFeFeFEDE: posts the ante 5
radekvv777: posts the ante 5
Piiirat: posts small blind 15
skjørring: posts big blind 30
*** HOLE CARDS ***
AcabeiDeSair: folds 
MasterInsekt: raises 60 to 90
ThirtyTw0: folds 
FeFeFeFeFEDE: folds 
radekvv777: calls 90
killa187187: folds 
lmiotto88: folds 
Piiirat: folds 
skjørring: folds 
*** FLOP *** [Qh 7h 3c]
MasterInsekt: bets 210
radekvv777: calls 210
*** TURN *** [Qh 7h 3c] [2h]
MasterInsekt: bets 538
radekvv777: raises 538 to 1076
MasterInsekt: calls 538
*** RIVER *** [Qh 7h 3c 2h] [Tc]
MasterInsekt: checks 
radekvv777: bets 3614 and is all-in
MasterInsekt: calls 3614 and is all-in
*** SHOW DOWN ***
radekvv777: shows [2d Qd] (two pair, Queens and Deuces)
MasterInsekt: shows [Ah As] (a pair of Aces)
radekvv777 collected 10070 from pot
radekvv777 wins $3.75 for eliminating MasterInsekt and their own bounty increases by $3.75 to $11.25
MasterInsekt finished the tournament in 999999997th place
*** SUMMARY ***
Total pot 10070 | Rake 0 
Board [Qh 7h 3c 2h Tc]
Seat 1: killa187187 folded before Flop (didn't bet)
Seat 2: lmiotto88 (button) folded before Flop (didn't bet)
Seat 3: Piiirat (small blind) folded before Flop
Seat 4: skjørring (big blind) folded before Flop
Seat 5: AcabeiDeSair folded before Flop (didn't bet)
Seat 6: MasterInsekt showed [Ah As] and lost with a pair of Aces
Seat 7: ThirtyTw0 folded before Flop (didn't bet)
Seat 8: FeFeFeFeFEDE folded before Flop (didn't bet)
Seat 9: radekvv777 showed [2d Qd] and won (10070) with two pair, Queens and Deuces



PokerStars Hand #157575105187: Tournament #1641817620, $7.50+$7.50+$1.50 USD Hold'em No Limit - Level I (15/30) - 2016/08/21 18:31:18 ET
Table '1641817620 56' 9-max Seat #2 is the button
Seat 1: PpME_Oe_87 (4995 in chips) 
Seat 2: NrRockeT9 (4935 in chips) 
Seat 3: DontFoldItPL (5310 in chips) 
Seat 4: cla11 (4995 in chips) 
Seat 5: luvlust (4785 in chips) 
Seat 6: pedro300390 (4995 in chips) 
Seat 7: rickyrdmy (4995 in chips) 
Seat 8: M.J.466 (4995 in chips) 
Seat 9: Exan13 (4995 in chips) 
PpME_Oe_87: posts the ante 5
NrRockeT9: posts the ante 5
DontFoldItPL: posts the ante 5
cla11: posts the ante 5
luvlust: posts the ante 5
pedro300390: posts the ante 5
rickyrdmy: posts the ante 5
M.J.466: posts the ante 5
Exan13: posts the ante 5
DontFoldItPL: posts small blind 15
cla11: posts big blind 30
*** HOLE CARDS ***
luvlust: folds 
pedro300390: folds 
rickyrdmy: folds 
M.J.466: raises 60 to 90
Exan13: folds 
PpME_Oe_87: folds 
NrRockeT9: calls 90
DontFoldItPL: calls 75
cla11: calls 60
*** FLOP *** [8c 3h Td]
DontFoldItPL: bets 135
cla11: calls 135
M.J.466: calls 135
NrRockeT9: folds 
*** TURN *** [8c 3h Td] [4h]
DontFoldItPL: checks 
cla11: checks 
M.J.466: bets 405
DontFoldItPL: folds 
cla11: calls 405
*** RIVER *** [8c 3h Td 4h] [2c]
cla11: checks 
M.J.466: bets 510
cla11: folds 
Uncalled bet (510) returned to M.J.466
M.J.466 collected 1620 from pot
*** SUMMARY ***
Total pot 1620 | Rake 0 
Board [8c 3h Td 4h 2c]
Seat 1: PpME_Oe_87 folded before Flop (didn't bet)
Seat 2: NrRockeT9 (button) folded on the Flop
Seat 3: DontFoldItPL (small blind) folded on the Turn
Seat 4: cla11 (big blind) folded on the River
Seat 5: luvlust folded before Flop (didn't bet)
Seat 6: pedro300390 folded before Flop (didn't bet)
Seat 7: rickyrdmy folded before Flop (didn't bet)
Seat 8: M.J.466 collected (1620)
Seat 9: Exan13 folded before Flop (didn't bet)



PokerStars Hand #157575107208: Tournament #1641817620, $7.50+$7.50+$1.50 USD Hold'em No Limit - Level I (15/30) - 2016/08/21 18:31:21 ET
Table '1641817620 9' 9-max Seat #2 is the button
Seat 1: kake40 (4905 in chips) 
Seat 2: Cergey1387 (5520 in chips) 
Seat 3: portugajr007 (4965 in chips) 
Seat 4: punkhead89 (4815 in chips) 
Seat 5: nO bUsTeD (4995 in chips) 
Seat 6: edizzz903 (4995 in chips) 
Seat 7: Cuzco83 (4995 in chips) 
Seat 8: maurogynppp (4995 in chips) 
Seat 9: N1COLOSO (4815 in chips) 
kake40: posts the ante 5
Cergey1387: posts the ante 5
portugajr007: posts the ante 5
punkhead89: posts the ante 5
nO bUsTeD: posts the ante 5
edizzz903: posts the ante 5
Cuzco83: posts the ante 5
maurogynppp: posts the ante 5
N1COLOSO: posts the ante 5
portugajr007: posts small blind 15
punkhead89: posts big blind 30
*** HOLE CARDS ***
nO bUsTeD: raises 60 to 90
edizzz903: folds 
Cuzco83: folds 
maurogynppp: folds 
N1COLOSO: folds 
kake40: folds 
Cergey1387: calls 90
portugajr007: calls 75
punkhead89: calls 60
*** FLOP *** [3h 4c 6s]
portugajr007: checks 
punkhead89: checks 
nO bUsTeD: bets 210
Cergey1387: calls 210
portugajr007: calls 210
punkhead89: calls 210
*** TURN *** [3h 4c 6s] [5h]
portugajr007: checks 
punkhead89: checks 
nO bUsTeD: checks 
Cergey1387: checks 
*** RIVER *** [3h 4c 6s 5h] [3d]
portugajr007: bets 420
punkhead89: raises 420 to 840
nO bUsTeD: folds 
Cergey1387: calls 840
portugajr007: calls 420
*** SHOW DOWN ***
punkhead89: shows [8c 7c] (a straight, Four to Eight)
Cergey1387: mucks hand 
portugajr007: shows [8h 7d] (a straight, Four to Eight)
portugajr007 collected 1883 from pot
punkhead89 collected 1882 from pot
*** SUMMARY ***
Total pot 3765 | Rake 0 
Board [3h 4c 6s 5h 3d]
Seat 1: kake40 folded before Flop (didn't bet)
Seat 2: Cergey1387 (button) mucked
Seat 3: portugajr007 (small blind) showed [8h 7d] and won (1883) with a straight, Four to Eight
Seat 4: punkhead89 (big blind) showed [8c 7c] and won (1882) with a straight, Four to Eight
Seat 5: nO bUsTeD folded on the River
Seat 6: edizzz903 folded before Flop (didn't bet)
Seat 7: Cuzco83 folded before Flop (didn't bet)
Seat 8: maurogynppp folded before Flop (didn't bet)
Seat 9: N1COLOSO folded before Flop (didn't bet)



PokerStars Hand #157575107269: Tournament #1641817620, $7.50+$7.50+$1.50 USD Hold'em No Limit - Level I (15/30) - 2016/08/21 18:31:21 ET
Table '1641817620 19' 9-max Seat #2 is the button
Seat 1: ArskaTheMan (4995 in chips) 
Seat 2: renem24 (4980 in chips) 
Seat 3: Paparazzi507 (4510 in chips) 
Seat 4: amondelo (4995 in chips) 
Seat 5: guydoune1 (4935 in chips) 
Seat 6: flutzke90 (4995 in chips) 
Seat 7: MrSerks78 (5600 in chips) 
Seat 8: le_chefe28 (4995 in chips) 
Seat 9: naumans (4995 in chips) 
ArskaTheMan: posts the ante 5
renem24: posts the ante 5
Paparazzi507: posts the ante 5
amondelo: posts the ante 5
guydoune1: posts the ante 5
flutzke90: posts the ante 5
MrSerks78: posts the ante 5
le_chefe28: posts the ante 5
naumans: posts the ante 5
Paparazzi507: posts small blind 15
amondelo: posts big blind 30
*** HOLE CARDS ***
guydoune1: folds 
flutzke90: folds 
MrSerks78: raises 120 to 150
le_chefe28: folds 
naumans: folds 
ArskaTheMan: folds 
renem24: raises 330 to 480
Paparazzi507: folds 
amondelo: folds 
MrSerks78: calls 330
*** FLOP *** [6h Js Qs]
MrSerks78: checks 
renem24: bets 346
MrSerks78: calls 346
*** TURN *** [6h Js Qs] [5d]
MrSerks78: checks 
renem24: bets 871
MrSerks78: calls 871
*** RIVER *** [6h Js Qs 5d] [2h]
MrSerks78: bets 3898 and is all-in
renem24: calls 3278 and is all-in
Uncalled bet (620) returned to MrSerks78
*** SHOW DOWN ***
MrSerks78: shows [Ah Qc] (a pair of Queens)
renem24: shows [Kd Ks] (a pair of Kings)
renem24 collected 10040 from pot
*** SUMMARY ***
Total pot 10040 | Rake 0 
Board [6h Js Qs 5d 2h]
Seat 1: ArskaTheMan folded before Flop (didn't bet)
Seat 2: renem24 (button) showed [Kd Ks] and won (10040) with a pair of Kings
Seat 3: Paparazzi507 (small blind) folded before Flop
Seat 4: amondelo (big blind) folded before Flop
Seat 5: guydoune1 folded before Flop (didn't bet)
Seat 6: flutzke90 folded before Flop (didn't bet)
Seat 7: MrSerks78 showed [Ah Qc] and lost with a pair of Queens
Seat 8: le_chefe28 folded before Flop (didn't bet)
Seat 9: naumans folded before Flop (didn't bet)



PokerStars Hand #157575107270: Tournament #1641817620, $7.50+$7.50+$1.50 USD Hold'em No Limit - Level I (15/30) - 2016/08/21 18:31:21 ET
Table '1641817620 41' 9-max Seat #2 is the button
Seat 1: vettecha (4995 in chips) 
Seat 2: ARAVNOA (4980 in chips) 
Seat 3: FlaxonJin (4965 in chips) 
Seat 4: gigibaston (4995 in chips) 
Seat 5: Jujubh (4639 in chips) 
Seat 6: Matiellão (4995 in chips) 
Seat 7: MayFuNg1979 (5441 in chips) 
Seat 8: relmat (4995 in chips) 
Seat 9: Gwermort (4995 in chips) 
vettecha: posts the ante 5
ARAVNOA: posts the ante 5
FlaxonJin: posts the ante 5
gigibaston: posts the ante 5
Jujubh: posts the ante 5
Matiellão: posts the ante 5
MayFuNg1979: posts the ante 5
relmat: posts the ante 5
Gwermort: posts the ante 5
FlaxonJin: posts small blind 15
gigibaston: posts big blind 30
*** HOLE CARDS ***
Jujubh: folds 
Matiellão: folds 
MayFuNg1979: folds 
relmat: raises 60 to 90
Gwermort: raises 187 to 277
vettecha: folds 
ARAVNOA: folds 
FlaxonJin: folds 
gigibaston: folds 
relmat: raises 644 to 921
Gwermort: calls 644
*** FLOP *** [Js 8d Tc]
relmat: bets 1110
Gwermort: calls 1110
*** TURN *** [Js 8d Tc] [Th]
relmat: bets 2959 and is all-in
Gwermort: folds 
Uncalled bet (2959) returned to relmat
relmat collected 4152 from pot
*** SUMMARY ***
Total pot 4152 | Rake 0 
Board [Js 8d Tc Th]
Seat 1: vettecha folded before Flop (didn't bet)
Seat 2: ARAVNOA (button) folded before Flop (didn't bet)
Seat 3: FlaxonJin (small blind) folded before Flop
Seat 4: gigibaston (big blind) folded before Flop
Seat 5: Jujubh folded before Flop (didn't bet)
Seat 6: Matiellão folded before Flop (didn't bet)
Seat 7: MayFuNg1979 folded before Flop (didn't bet)
Seat 8: relmat collected (4152)
Seat 9: Gwermort folded on the Turn



PokerStars Hand #157575107872: Tournament #1641817620, $7.50+$7.50+$1.50 USD Hold'em No Limit - Level I (15/30) - 2016/08/21 18:31:22 ET
Table '1641817620 23' 9-max Seat #2 is the button
Seat 1: Cepillo (4995 in chips) 
Seat 2: erfan86 (4980 in chips) 
Seat 3: derkimos (4935 in chips) 
Seat 4: Carlos11497 (4995 in chips) 
Seat 5: MickJagger86 (4995 in chips) 
Seat 6: Feyenoord0020 (4995 in chips) 
Seat 7: jradjo21 (4995 in chips) 
Seat 8: kajarana (4995 in chips) 
Seat 9: -MCASLAN7- (5115 in chips) 
Cepillo: posts the ante 5
erfan86: posts the ante 5
derkimos: posts the ante 5
Carlos11497: posts the ante 5
MickJagger86: posts the ante 5
Feyenoord0020: posts the ante 5
jradjo21: posts the ante 5
kajarana: posts the ante 5
-MCASLAN7-: posts the ante 5
derkimos: posts small blind 15
Carlos11497: posts big blind 30
*** HOLE CARDS ***
MickJagger86: folds 
Feyenoord0020: raises 120 to 150
jradjo21: folds 
kajarana: folds 
-MCASLAN7-: folds 
Cepillo: folds 
erfan86: folds 
derkimos: calls 135
Carlos11497: folds 
*** FLOP *** [Kd Td Kc]
derkimos: checks 
Feyenoord0020: checks 
*** TURN *** [Kd Td Kc] [4s]
derkimos: checks 
Feyenoord0020: bets 375
derkimos: folds 
Uncalled bet (375) returned to Feyenoord0020
Feyenoord0020 collected 375 from pot
*** SUMMARY ***
Total pot 375 | Rake 0 
Board [Kd Td Kc 4s]
Seat 1: Cepillo folded before Flop (didn't bet)
Seat 2: erfan86 (button) folded before Flop (didn't bet)
Seat 3: derkimos (small blind) folded on the Turn
Seat 4: Carlos11497 (big blind) folded before Flop
Seat 5: MickJagger86 folded before Flop (didn't bet)
Seat 6: Feyenoord0020 collected (375)
Seat 7: jradjo21 folded before Flop (didn't bet)
Seat 8: kajarana folded before Flop (didn't bet)
Seat 9: -MCASLAN7- folded before Flop (didn't bet)



PokerStars Hand #157575109773: Tournament #1641817620, $7.50+$7.50+$1.50 USD Hold'em No Limit - Level I (15/30) - 2016/08/21 18:31:25 ET
Table '1641817620 30' 9-max Seat #2 is the button
Seat 1: riginvl (4995 in chips) 
Seat 2: flashesflash (4965 in chips) 
Seat 3: Drogbaaaaaaa (4965 in chips) 
Seat 5: islidur99 (4995 in chips) 
Seat 6: jeanjrg1 (4995 in chips) 
Seat 7: GazRaz21 (4965 in chips) 
Seat 8: karlson1986 (5160 in chips) 
Seat 9: YNWA UA (4965 in chips) 
riginvl: posts the ante 5
flashesflash: posts the ante 5
Drogbaaaaaaa: posts the ante 5
islidur99: posts the ante 5
jeanjrg1: posts the ante 5
GazRaz21: posts the ante 5
karlson1986: posts the ante 5
YNWA UA: posts the ante 5
Drogbaaaaaaa: posts small blind 15
islidur99: posts big blind 30
*** HOLE CARDS ***
jeanjrg1: folds 
GazRaz21: calls 30
karlson1986: folds 
YNWA UA: folds 
riginvl: folds 
flashesflash: folds 
Drogbaaaaaaa: calls 15
islidur99: raises 280 to 310
GazRaz21: calls 280
Drogbaaaaaaa: folds 
*** FLOP *** [Th Ac 9c]
islidur99: bets 600
GazRaz21: calls 600
*** TURN *** [Th Ac 9c] [8d]
islidur99: bets 4080 and is all-in
GazRaz21: folds 
Uncalled bet (4080) returned to islidur99
islidur99 collected 1890 from pot
islidur99: doesn't show hand 
*** SUMMARY ***
Total pot 1890 | Rake 0 
Board [Th Ac 9c 8d]
Seat 1: riginvl folded before Flop (didn't bet)
Seat 2: flashesflash (button) folded before Flop (didn't bet)
Seat 3: Drogbaaaaaaa (small blind) folded before Flop
Seat 5: islidur99 (big blind) collected (1890)
Seat 6: jeanjrg1 folded before Flop (didn't bet)
Seat 7: GazRaz21 folded on the Turn
Seat 8: karlson1986 folded before Flop (didn't bet)
Seat 9: YNWA UA folded before Flop (didn't bet)



PokerStars Hand #157575109844: Tournament #1641817620, $7.50+$7.50+$1.50 USD Hold'em No Limit - Level I (15/30) - 2016/08/21 18:31:25 ET
Table '1641817620 61' 9-max Seat #2 is the button
Seat 1: talga421 (4223 in chips) 
Seat 2: evgenia19591 (4905 in chips) 
Seat 3: ElliNelly (5992 in chips) 
Seat 5: sasha.yush (4995 in chips) 
Seat 6: houtenboog (4995 in chips) 
Seat 7: setarcos1234 (4995 in chips) 
Seat 8: Dan Mimar (4995 in chips) 
Seat 9: vininicolato (4905 in chips) 
talga421: posts the ante 5
evgenia19591: posts the ante 5
ElliNelly: posts the ante 5
sasha.yush: posts the ante 5
houtenboog: posts the ante 5
setarcos1234: posts the ante 5
Dan Mimar: posts the ante 5
vininicolato: posts the ante 5
ElliNelly: posts small blind 15
sasha.yush: posts big blind 30
*** HOLE CARDS ***
houtenboog: folds 
setarcos1234: folds 
Dan Mimar: raises 30 to 60
vininicolato: folds 
talga421: folds 
evgenia19591: folds 
ElliNelly: folds 
sasha.yush: folds 
Uncalled bet (30) returned to Dan Mimar
Dan Mimar collected 115 from pot
*** SUMMARY ***
Total pot 115 | Rake 0 
Seat 1: talga421 folded before Flop (didn't bet)
Seat 2: evgenia19591 (button) folded before Flop (didn't bet)
Seat 3: ElliNelly (small blind) folded before Flop
Seat 5: sasha.yush (big blind) folded before Flop
Seat 6: houtenboog folded before Flop (didn't bet)
Seat 7: setarcos1234 folded before Flop (didn't bet)
Seat 8: Dan Mimar collected (115)
Seat 9: vininicolato folded before Flop (didn't bet)



PokerStars Hand #157575110432: Tournament #1641817620, $7.50+$7.50+$1.50 USD Hold'em No Limit - Level I (15/30) - 2016/08/21 18:31:26 ET
Table '1641817620 1' 9-max Seat #2 is the button
Seat 1: mattyonuts (4995 in chips) 
Seat 2: topaipi (4935 in chips) 
Seat 3: MAMOHT_T (4965 in chips) 
Seat 5: LADIEFJ (6060 in chips) 
Seat 6: TheGuerreiro (4995 in chips) 
Seat 7: Amorkos (4995 in chips) 
Seat 8: K. Ichinose (4995 in chips) 
Seat 9: AdiMutu1001 (4995 in chips) 
mattyonuts: posts the ante 5
topaipi: posts the ante 5
MAMOHT_T: posts the ante 5
LADIEFJ: posts the ante 5
TheGuerreiro: posts the ante 5
Amorkos: posts the ante 5
K. Ichinose: posts the ante 5
AdiMutu1001: posts the ante 5
MAMOHT_T: posts small blind 15
LADIEFJ: posts big blind 30
*** HOLE CARDS ***
TheGuerreiro: raises 60 to 90
Amorkos: folds 
K. Ichinose: folds 
AdiMutu1001: folds 
mattyonuts: folds 
topaipi: calls 90
MAMOHT_T: folds 
LADIEFJ: folds 
*** FLOP *** [2c Jh 4h]
TheGuerreiro: bets 132
topaipi: calls 132
*** TURN *** [2c Jh 4h] [Qd]
TheGuerreiro: checks 
topaipi: bets 290
TheGuerreiro: folds 
Uncalled bet (290) returned to topaipi
topaipi collected 529 from pot
topaipi: doesn't show hand 
*** SUMMARY ***
Total pot 529 | Rake 0 
Board [2c Jh 4h Qd]
Seat 1: mattyonuts folded before Flop (didn't bet)
Seat 2: topaipi (button) collected (529)
Seat 3: MAMOHT_T (small blind) folded before Flop
Seat 5: LADIEFJ (big blind) folded before Flop
Seat 6: TheGuerreiro folded on the Turn
Seat 7: Amorkos folded before Flop (didn't bet)
Seat 8: K. Ichinose folded before Flop (didn't bet)
Seat 9: AdiMutu1001 folded before Flop (didn't bet)



PokerStars Hand #157575110600: Tournament #1641817620, $7.50+$7.50+$1.50 USD Hold'em No Limit - Level I (15/30) - 2016/08/21 18:31:27 ET
Table '1641817620 2' 9-max Seat #2 is the button
Seat 1: ChaCha121 (4995 in chips) 
Seat 2: T8yourmoney (4980 in chips) 
Seat 3: mvpalls (4935 in chips) 
Seat 5: junkshow#1 (4995 in chips) is sitting out
Seat 6: Vstoinov (4995 in chips) 
Seat 7: GreenDja (4995 in chips) 
Seat 8: BckDoorFlux (4995 in chips) 
Seat 9: LeaD25 (5325 in chips) 
ChaCha121: posts the ante 5
T8yourmoney: posts the ante 5
mvpalls: posts the ante 5
junkshow#1: posts the ante 5
Vstoinov: posts the ante 5
GreenDja: posts the ante 5
BckDoorFlux: posts the ante 5
LeaD25: posts the ante 5
mvpalls: posts small blind 15
junkshow#1: posts big blind 30
*** HOLE CARDS ***
Vstoinov: folds 
junkshow#1 has returned
GreenDja: folds 
BckDoorFlux: raises 30 to 60
LeaD25: calls 60
ChaCha121: folds 
T8yourmoney: folds 
mvpalls: folds 
junkshow#1: folds 
*** FLOP *** [Qd Kh 9d]
BckDoorFlux: checks 
LeaD25: bets 120
BckDoorFlux: folds 
Uncalled bet (120) returned to LeaD25
LeaD25 collected 205 from pot
LeaD25: doesn't show hand 
*** SUMMARY ***
Total pot 205 | Rake 0 
Board [Qd Kh 9d]
Seat 1: ChaCha121 folded before Flop (didn't bet)
Seat 2: T8yourmoney (button) folded before Flop (didn't bet)
Seat 3: mvpalls (small blind) folded before Flop
Seat 5: junkshow#1 (big blind) folded before Flop
Seat 6: Vstoinov folded before Flop (didn't bet)
Seat 7: GreenDja folded before Flop (didn't bet)
Seat 8: BckDoorFlux folded on the Flop
Seat 9: LeaD25 collected (205)



PokerStars Hand #157575110924: Tournament #1641817620, $7.50+$7.50+$1.50 USD Hold'em No Limit - Level I (15/30) - 2016/08/21 18:31:27 ET
Table '1641817620 35' 9-max Seat #3 is the button
Seat 2: Diegodel79 (4975 in chips) 
Seat 3: brunoeffect (4945 in chips) 
Seat 4: PPOrphan (4930 in chips) 
Seat 5: WizardOffAz (5000 in chips) 
Seat 6: brett88987 (4990 in chips) 
Seat 7: IcaLm (4990 in chips) 
Seat 8: ximenesb (4990 in chips) 
Seat 9: Cosacoman (5105 in chips) 
Diegodel79: posts the ante 5
brunoeffect: posts the ante 5
PPOrphan: posts the ante 5
WizardOffAz: posts the ante 5
brett88987: posts the ante 5
IcaLm: posts the ante 5
ximenesb: posts the ante 5
Cosacoman: posts the ante 5
PPOrphan: posts small blind 15
WizardOffAz: posts big blind 30
*** HOLE CARDS ***
brett88987: folds 
IcaLm: folds 
ximenesb: folds 
Cosacoman: folds 
Diegodel79: folds 
brunoeffect: raises 60 to 90
PPOrphan: calls 75
WizardOffAz: folds 
*** FLOP *** [6d Qh 2h]
PPOrphan: checks 
brunoeffect: checks 
*** TURN *** [6d Qh 2h] [Qd]
PPOrphan: checks 
brunoeffect: checks 
*** RIVER *** [6d Qh 2h Qd] [Ks]
PPOrphan: checks 
brunoeffect: checks 
*** SHOW DOWN ***
PPOrphan: shows [Kh 6h] (two pair, Kings and Queens)
brunoeffect: mucks hand 
PPOrphan collected 250 from pot
*** SUMMARY ***
Total pot 250 | Rake 0 
Board [6d Qh 2h Qd Ks]
Seat 2: Diegodel79 folded before Flop (didn't bet)
Seat 3: brunoeffect (button) mucked
Seat 4: PPOrphan (small blind) showed [Kh 6h] and won (250) with two pair, Kings and Queens
Seat 5: WizardOffAz (big blind) folded before Flop
Seat 6: brett88987 folded before Flop (didn't bet)
Seat 7: IcaLm folded before Flop (didn't bet)
Seat 8: ximenesb folded before Flop (didn't bet)
Seat 9: Cosacoman folded before Flop (didn't bet)



PokerStars Hand #157575113302: Tournament #1641817620, $7.50+$7.50+$1.50 USD Hold'em No Limit - Level I (15/30) - 2016/08/21 18:31:31 ET
Table '1641817620 14' 9-max Seat #2 is the button
Seat 1: japazzz1001 (4995 in chips) 
Seat 2: zigolo77 (5280 in chips) 
Seat 3: $Koha$88 (4965 in chips) 
Seat 4: Ed_brisal (4995 in chips) 
Seat 5: kashlaw (5000 in chips) 
Seat 6: sweetlips6 (4780 in chips) 
Seat 7: zerowiec (4995 in chips) 
Seat 8: tim_pro_405! (4995 in chips) 
Seat 9: bacibaci67 (4995 in chips) 
japazzz1001: posts the ante 5
zigolo77: posts the ante 5
$Koha$88: posts the ante 5
Ed_brisal: posts the ante 5
kashlaw: posts the ante 5
sweetlips6: posts the ante 5
zerowiec: posts the ante 5
tim_pro_405!: posts the ante 5
bacibaci67: posts the ante 5
$Koha$88: posts small blind 15
Ed_brisal: posts big blind 30
*** HOLE CARDS ***
kashlaw: folds 
sweetlips6: calls 30
zerowiec: raises 45 to 75
tim_pro_405!: folds 
bacibaci67: folds 
japazzz1001: folds 
zigolo77: folds 
$Koha$88: calls 60
Ed_brisal: calls 45
sweetlips6: calls 45
*** FLOP *** [Qc Ks 7c]
$Koha$88: checks 
Ed_brisal: checks 
sweetlips6: checks 
zerowiec: checks 
*** TURN *** [Qc Ks 7c] [Ts]
$Koha$88: checks 
Ed_brisal: checks 
sweetlips6: checks 
zerowiec: bets 138
$Koha$88: folds 
Ed_brisal: folds 
sweetlips6: calls 138
*** RIVER *** [Qc Ks 7c Ts] [3d]
sweetlips6: checks 
zerowiec: bets 248
sweetlips6: folds 
Uncalled bet (248) returned to zerowiec
zerowiec collected 621 from pot
zerowiec: doesn't show hand 
*** SUMMARY ***
Total pot 621 | Rake 0 
Board [Qc Ks 7c Ts 3d]
Seat 1: japazzz1001 folded before Flop (didn't bet)
Seat 2: zigolo77 (button) folded before Flop (didn't bet)
Seat 3: $Koha$88 (small blind) folded on the Turn
Seat 4: Ed_brisal (big blind) folded on the Turn
Seat 5: kashlaw folded before Flop (didn't bet)
Seat 6: sweetlips6 folded on the River
Seat 7: zerowiec collected (621)
Seat 8: tim_pro_405! folded before Flop (didn't bet)
Seat 9: bacibaci67 folded before Flop (didn't bet)



PokerStars Hand #157575113843: Tournament #1641817620, $7.50+$7.50+$1.50 USD Hold'em No Limit - Level I (15/30) - 2016/08/21 18:31:31 ET
Table '1641817620 28' 9-max Seat #2 is the button
Seat 1: kidprodigy44 (4995 in chips) 
Seat 2: jamaika high (3470 in chips) 
Seat 3: cairob (4965 in chips) 
Seat 4: NIKOLACG (3470 in chips) 
Seat 5: neckbr4ke (4995 in chips) 
Seat 6: Quaysie (4995 in chips) 
Seat 7: d3ment0r (8120 in chips) 
Seat 8: papan9_p$ (4995 in chips) 
Seat 9: benjicleo (4995 in chips) 
kidprodigy44: posts the ante 5
jamaika high: posts the ante 5
cairob: posts the ante 5
NIKOLACG: posts the ante 5
neckbr4ke: posts the ante 5
Quaysie: posts the ante 5
d3ment0r: posts the ante 5
papan9_p$: posts the ante 5
benjicleo: posts the ante 5
cairob: posts small blind 15
NIKOLACG: posts big blind 30
*** HOLE CARDS ***
neckbr4ke: raises 60 to 90
Quaysie: folds 
jamaika high said, "Not normal"
d3ment0r: folds 
papan9_p$: calls 90
benjicleo: folds 
kidprodigy44: folds 
jamaika high: calls 90
cairob: folds 
NIKOLACG: calls 60
*** FLOP *** [Ad Tc 8d]
NIKOLACG: bets 210
jamaika high said, "zzzzzzzzz"
neckbr4ke: folds 
papan9_p$: calls 210
jamaika high: folds 
*** TURN *** [Ad Tc 8d] [4d]
NIKOLACG: checks 
papan9_p$: bets 428
NIKOLACG: calls 428
*** RIVER *** [Ad Tc 8d 4d] [8c]
NIKOLACG: checks 
papan9_p$: bets 864
NIKOLACG: calls 864
*** SHOW DOWN ***
papan9_p$: shows [Qh Ah] (two pair, Aces and Eights)
NIKOLACG: mucks hand 
papan9_p$ collected 3424 from pot
*** SUMMARY ***
Total pot 3424 | Rake 0 
Board [Ad Tc 8d 4d 8c]
Seat 1: kidprodigy44 folded before Flop (didn't bet)
Seat 2: jamaika high (button) folded on the Flop
Seat 3: cairob (small blind) folded before Flop
Seat 4: NIKOLACG (big blind) mucked
Seat 5: neckbr4ke folded on the Flop
Seat 6: Quaysie folded before Flop (didn't bet)
Seat 7: d3ment0r folded before Flop (didn't bet)
Seat 8: papan9_p$ showed [Qh Ah] and won (3424) with two pair, Aces and Eights
Seat 9: benjicleo folded before Flop (didn't bet)



PokerStars Hand #157575114327: Tournament #1641817620, $7.50+$7.50+$1.50 USD Hold'em No Limit - Level I (15/30) - 2016/08/21 18:31:32 ET
Table '1641817620 13' 9-max Seat #2 is the button
Seat 1: Mindthis (4995 in chips) 
Seat 2: nicka501 (10192 in chips) 
Seat 3: POG_Q4 (4914 in chips) 
Seat 4: sutherland43 (5000 in chips) 
Seat 5: LarikkadoAA (5000 in chips) 
Seat 6: MicroStaker5 (4995 in chips) 
Seat 7: MrMalaLeche (4995 in chips) 
Seat 8: EdsonPecly (4914 in chips) 
Seat 9: wantuirpoker (4990 in chips) 
Mindthis: posts the ante 5
nicka501: posts the ante 5
POG_Q4: posts the ante 5
sutherland43: posts the ante 5
LarikkadoAA: posts the ante 5
MicroStaker5: posts the ante 5
MrMalaLeche: posts the ante 5
EdsonPecly: posts the ante 5
wantuirpoker: posts the ante 5
POG_Q4: posts small blind 15
sutherland43: posts big blind 30
*** HOLE CARDS ***
LarikkadoAA: folds 
MicroStaker5: raises 45 to 75
MrMalaLeche: folds 
EdsonPecly: folds 
wantuirpoker: folds 
Mindthis: raises 105 to 180
nicka501: folds 
POG_Q4: calls 165
sutherland43: folds 
MicroStaker5: calls 105
*** FLOP *** [7s Ad Th]
POG_Q4: checks 
MicroStaker5: checks 
Mindthis: bets 307
POG_Q4: calls 307
MicroStaker5: calls 307
*** TURN *** [7s Ad Th] [3s]
POG_Q4: checks 
MicroStaker5: checks 
Mindthis: checks 
*** RIVER *** [7s Ad Th 3s] [3h]
POG_Q4: bets 1260
MicroStaker5: folds 
Mindthis: calls 1260
*** SHOW DOWN ***
POG_Q4: shows [7d 7c] (a full house, Sevens full of Threes)
Mindthis: mucks hand 
POG_Q4 collected 4056 from pot
*** SUMMARY ***
Total pot 4056 | Rake 0 
Board [7s Ad Th 3s 3h]
Seat 1: Mindthis mucked
Seat 2: nicka501 (button) folded before Flop (didn't bet)
Seat 3: POG_Q4 (small blind) showed [7d 7c] and won (4056) with a full house, Sevens full of Threes
Seat 4: sutherland43 (big blind) folded before Flop
Seat 5: LarikkadoAA folded before Flop (didn't bet)
Seat 6: MicroStaker5 folded on the River
Seat 7: MrMalaLeche folded before Flop (didn't bet)
Seat 8: EdsonPecly folded before Flop (didn't bet)
Seat 9: wantuirpoker folded before Flop (didn't bet)



PokerStars Hand #157575114754: Tournament #1641817620, $7.50+$7.50+$1.50 USD Hold'em No Limit - Level I (15/30) - 2016/08/21 18:31:33 ET
Table '1641817620 27' 9-max Seat #2 is the button
Seat 1: TheKaisa87 (4995 in chips) 
Seat 2: msksevart (4980 in chips) 
Seat 3: SweetieSpy (6315 in chips) 
Seat 4: Mr_Buckworth (4995 in chips) 
Seat 5: ladymadon107 (4365 in chips) 
Seat 6: 6aDyHtry (4365 in chips) 
Seat 7: csfreak (4995 in chips) 
Seat 8: PavelGav1 (4995 in chips) 
Seat 9: kyzyldurrr (4995 in chips) 
TheKaisa87: posts the ante 5
msksevart: posts the ante 5
SweetieSpy: posts the ante 5
Mr_Buckworth: posts the ante 5
ladymadon107: posts the ante 5
6aDyHtry: posts the ante 5
csfreak: posts the ante 5
PavelGav1: posts the ante 5
kyzyldurrr: posts the ante 5
SweetieSpy: posts small blind 15
Mr_Buckworth: posts big blind 30
*** HOLE CARDS ***
ladymadon107: folds 
6aDyHtry: folds 
csfreak: folds 
PavelGav1: folds 
kyzyldurrr: folds 
TheKaisa87: calls 30
msksevart: folds 
SweetieSpy: folds 
Mr_Buckworth: raises 60 to 90
TheKaisa87: calls 60
*** FLOP *** [9s 8c 6c]
Mr_Buckworth: bets 120
TheKaisa87: calls 120
*** TURN *** [9s 8c 6c] [6d]
Mr_Buckworth: bets 240
TheKaisa87: folds 
Uncalled bet (240) returned to Mr_Buckworth
Mr_Buckworth collected 480 from pot
Mr_Buckworth: doesn't show hand 
*** SUMMARY ***
Total pot 480 | Rake 0 
Board [9s 8c 6c 6d]
Seat 1: TheKaisa87 folded on the Turn
Seat 2: msksevart (button) folded before Flop (didn't bet)
Seat 3: SweetieSpy (small blind) folded before Flop
Seat 4: Mr_Buckworth (big blind) collected (480)
Seat 5: ladymadon107 folded before Flop (didn't bet)
Seat 6: 6aDyHtry folded before Flop (didn't bet)
Seat 7: csfreak folded before Flop (didn't bet)
Seat 8: PavelGav1 folded before Flop (didn't bet)
Seat 9: kyzyldurrr folded before Flop (didn't bet)



PokerStars Hand #157575115241: Tournament #1641817620, $7.50+$7.50+$1.50 USD Hold'em No Limit - Level I (15/30) - 2016/08/21 18:31:34 ET
Table '1641817620 32' 9-max Seat #3 is the button
Seat 1: RoribeiroS (4990 in chips) 
Seat 2: tomgan (4975 in chips) 
Seat 3: patou99957 (5125 in chips) 
Seat 4: JAhodaZ (5000 in chips) out of hand (moved from another table into small blind)
Seat 5: bdiddy1313 (5345 in chips) 
Seat 6: 69 hearts 69 (4990 in chips) 
Seat 7: rimis9999 (4990 in chips) 
Seat 8: noah5555 (4690 in chips) 
Seat 9: gamesAREover (4900 in chips) 
RoribeiroS: posts the ante 5
tomgan: posts the ante 5
patou99957: posts the ante 5
bdiddy1313: posts the ante 5
69 hearts 69: posts the ante 5
rimis9999: posts the ante 5
noah5555: posts the ante 5
gamesAREover: posts the ante 5
bdiddy1313: posts small blind 15
69 hearts 69: posts big blind 30
*** HOLE CARDS ***
rimis9999: folds 
noah5555: folds 
gamesAREover: folds 
RoribeiroS: folds 
tomgan: raises 60 to 90
patou99957: folds 
bdiddy1313: folds 
69 hearts 69: calls 60
*** FLOP *** [Kd Ts 3h]
69 hearts 69: checks 
tomgan: bets 235
69 hearts 69: folds 
Uncalled bet (235) returned to tomgan
tomgan collected 235 from pot
tomgan: doesn't show hand 
*** SUMMARY ***
Total pot 235 | Rake 0 
Board [Kd Ts 3h]
Seat 1: RoribeiroS folded before Flop (didn't bet)
Seat 2: tomgan collected (235)
Seat 3: patou99957 (button) folded before Flop (didn't bet)
Seat 5: bdiddy1313 (small blind) folded before Flop
Seat 6: 69 hearts 69 (big blind) folded on the Flop
Seat 7: rimis9999 folded before Flop (didn't bet)
Seat 8: noah5555 folded before Flop (didn't bet)
Seat 9: gamesAREover folded before Flop (didn't bet)



PokerStars Hand #157575115546: Tournament #1641817620, $7.50+$7.50+$1.50 USD Hold'em No Limit - Level I (15/30) - 2016/08/21 18:31:34 ET
Table '1641817620 33' 9-max Seat #3 is the button
Seat 1: fungyou (4990 in chips) 
Seat 2: titauhu (4975 in chips) is sitting out
Seat 3: gmdef.2001 (4945 in chips) 
Seat 4: natahha_92 (5000 in chips) out of hand (moved from another table into small blind)
Seat 5: T@keItDown (4960 in chips) 
Seat 6: REPPARTFLOW (4990 in chips) 
Seat 7: dennismitru (5080 in chips) 
Seat 8: Joao Valli (4990 in chips) 
Seat 9: Pablos701 (5075 in chips) 
fungyou: posts the ante 5
titauhu: posts the ante 5
gmdef.2001: posts the ante 5
T@keItDown: posts the ante 5
REPPARTFLOW: posts the ante 5
dennismitru: posts the ante 5
Joao Valli: posts the ante 5
Pablos701: posts the ante 5
T@keItDown: posts small blind 15
REPPARTFLOW: posts big blind 30
*** HOLE CARDS ***
dennismitru: folds 
Joao Valli: folds 
Pablos701: folds 
fungyou: folds 
titauhu: folds 
gmdef.2001: folds 
T@keItDown: raises 60 to 90
REPPARTFLOW: folds 
Uncalled bet (60) returned to T@keItDown
T@keItDown collected 100 from pot
T@keItDown: doesn't show hand 
*** SUMMARY ***
Total pot 100 | Rake 0 
Seat 1: fungyou folded before Flop (didn't bet)
Seat 2: titauhu folded before Flop (didn't bet)
Seat 3: gmdef.2001 (button) folded before Flop (didn't bet)
Seat 5: T@keItDown (small blind) collected (100)
Seat 6: REPPARTFLOW (big blind) folded before Flop
Seat 7: dennismitru folded before Flop (didn't bet)
Seat 8: Joao Valli folded before Flop (didn't bet)
Seat 9: Pablos701 folded before Flop (didn't bet)



PokerStars Hand #157575116313: Tournament #1641817620, $7.50+$7.50+$1.50 USD Hold'em No Limit - Level I (15/30) - 2016/08/21 18:31:35 ET
Table '1641817620 25' 9-max Seat #3 is the button
Seat 1: MoW3R (4990 in chips) 
Seat 2: pirus157 (5395 in chips) 
Seat 3: MaxBracht (4885 in chips) 
Seat 4: Rex Nelson (4870 in chips) 
Seat 5: ArKip (4990 in chips) 
Seat 6: xxxDOUxxx (4990 in chips) 
Seat 7: AAnaKKonda (4990 in chips) 
Seat 8: Mad Dionysus (4990 in chips) 
Seat 9: IwillCall3 (4900 in chips) 
MoW3R: posts the ante 5
pirus157: posts the ante 5
MaxBracht: posts the ante 5
Rex Nelson: posts the ante 5
ArKip: posts the ante 5
xxxDOUxxx: posts the ante 5
AAnaKKonda: posts the ante 5
Mad Dionysus: posts the ante 5
IwillCall3: posts the ante 5
Rex Nelson: posts small blind 15
ArKip: posts big blind 30
*** HOLE CARDS ***
xxxDOUxxx: folds 
AAnaKKonda: folds 
Mad Dionysus: folds 
IwillCall3: folds 
MoW3R: folds 
pirus157: folds 
MaxBracht: folds 
Rex Nelson: raises 60 to 90
ArKip: folds 
Uncalled bet (60) returned to Rex Nelson
Rex Nelson collected 105 from pot
*** SUMMARY ***
Total pot 105 | Rake 0 
Seat 1: MoW3R folded before Flop (didn't bet)
Seat 2: pirus157 folded before Flop (didn't bet)
Seat 3: MaxBracht (button) folded before Flop (didn't bet)
Seat 4: Rex Nelson (small blind) collected (105)
Seat 5: ArKip (big blind) folded before Flop
Seat 6: xxxDOUxxx folded before Flop (didn't bet)
Seat 7: AAnaKKonda folded before Flop (didn't bet)
Seat 8: Mad Dionysus folded before Flop (didn't bet)
Seat 9: IwillCall3 folded before Flop (didn't bet)



PokerStars Hand #157575116496: Tournament #1641817620, $7.50+$7.50+$1.50 USD Hold'em No Limit - Level I (15/30) - 2016/08/21 18:31:35 ET
Table '1641817620 24' 9-max Seat #3 is the button
Seat 1: heyyy presto (4990 in chips) 
Seat 2: BOW300 (4930 in chips) 
Seat 3: muskto (5035 in chips) 
Seat 4: jt3x87 (4930 in chips) 
Seat 5: PhaniaX (4990 in chips) 
Seat 6: pisti801 (4990 in chips) 
Seat 7: luckydayn (5155 in chips) 
Seat 8: trabey (4990 in chips) 
Seat 9: Quickcard (4990 in chips) is sitting out
heyyy presto: posts the ante 5
BOW300: posts the ante 5
muskto: posts the ante 5
jt3x87: posts the ante 5
PhaniaX: posts the ante 5
pisti801: posts the ante 5
luckydayn: posts the ante 5
trabey: posts the ante 5
Quickcard: posts the ante 5
jt3x87: posts small blind 15
PhaniaX: posts big blind 30
*** HOLE CARDS ***
pisti801: folds 
luckydayn: folds 
trabey: calls 30
Quickcard: folds 
heyyy presto: calls 30
BOW300: folds 
muskto: calls 30
jt3x87: calls 15
PhaniaX: checks 
*** FLOP *** [3h 5d 6h]
jt3x87: checks 
PhaniaX: checks 
trabey: checks 
heyyy presto: bets 110
muskto: calls 110
jt3x87: folds 
PhaniaX: folds 
trabey: calls 110
*** TURN *** [3h 5d 6h] [3s]
trabey: checks 
heyyy presto: bets 200
muskto: calls 200
trabey: folds 
*** RIVER *** [3h 5d 6h 3s] [As]
heyyy presto: bets 600
Quickcard has returned
muskto: folds 
Uncalled bet (600) returned to heyyy presto
heyyy presto collected 925 from pot
heyyy presto: doesn't show hand 
*** SUMMARY ***
Total pot 925 | Rake 0 
Board [3h 5d 6h 3s As]
Seat 1: heyyy presto collected (925)
Seat 2: BOW300 folded before Flop (didn't bet)
Seat 3: muskto (button) folded on the River
Seat 4: jt3x87 (small blind) folded on the Flop
Seat 5: PhaniaX (big blind) folded on the Flop
Seat 6: pisti801 folded before Flop (didn't bet)
Seat 7: luckydayn folded before Flop (didn't bet)
Seat 8: trabey folded on the Turn
Seat 9: Quickcard folded before Flop (didn't bet)



PokerStars Hand #157575117774: Tournament #1641817620, $7.50+$7.50+$1.50 USD Hold'em No Limit - Level I (15/30) - 2016/08/21 18:31:37 ET
Table '1641817620 5' 9-max Seat #3 is the button
Seat 1: PsychixtellO (5000 in chips) 
Seat 2: jonesfi5sh (4975 in chips) 
Seat 3: PhenomPen1 (4930 in chips) 
Seat 4: GrimJoker77 (5000 in chips) 
Seat 6: Javicho9 (4990 in chips) 
Seat 7: athilapvh (10135 in chips) 
Seat 8: sloty27 (4990 in chips) 
Seat 9: chuny dealer (4990 in chips) 
PsychixtellO: posts the ante 5
jonesfi5sh: posts the ante 5
PhenomPen1: posts the ante 5
GrimJoker77: posts the ante 5
Javicho9: posts the ante 5
athilapvh: posts the ante 5
sloty27: posts the ante 5
chuny dealer: posts the ante 5
GrimJoker77: posts small blind 15
Javicho9: posts big blind 30
*** HOLE CARDS ***
athilapvh: folds 
sloty27: folds 
chuny dealer: folds 
PsychixtellO: folds 
jonesfi5sh: raises 30 to 60
PhenomPen1: folds 
GrimJoker77: folds 
PsychixtellO is disconnected 
Javicho9: calls 30
*** FLOP *** [5s 3h Jh]
Javicho9: checks 
jonesfi5sh: bets 60
PsychixtellO is disconnected 
Javicho9: calls 60
*** TURN *** [5s 3h Jh] [2h]
Javicho9: checks 
jonesfi5sh: bets 300
Javicho9: calls 300
*** RIVER *** [5s 3h Jh 2h] [Ac]
Javicho9: checks 
jonesfi5sh: bets 870
Javicho9: folds 
Uncalled bet (870) returned to jonesfi5sh
jonesfi5sh collected 895 from pot
jonesfi5sh: doesn't show hand 
*** SUMMARY ***
Total pot 895 | Rake 0 
Board [5s 3h Jh 2h Ac]
Seat 1: PsychixtellO folded before Flop (didn't bet)
Seat 2: jonesfi5sh collected (895)
Seat 3: PhenomPen1 (button) folded before Flop (didn't bet)
Seat 4: GrimJoker77 (small blind) folded before Flop
Seat 6: Javicho9 (big blind) folded on the River
Seat 7: athilapvh folded before Flop (didn't bet)
Seat 8: sloty27 folded before Flop (didn't bet)
Seat 9: chuny dealer folded before Flop (didn't bet)



PokerStars Hand #157575118915: Tournament #1641817620, $7.50+$7.50+$1.50 USD Hold'em No Limit - Level I (15/30) - 2016/08/21 18:31:39 ET
Table '1641817620 17' 9-max Seat #3 is the button
Seat 1: guitarist68 (4990 in chips) 
Seat 2: Anton163reg (4975 in chips) 
Seat 3: GoldenBeeM (4945 in chips) 
Seat 4: PETER BEATZ (4690 in chips) 
Seat 6: dekota222 (4990 in chips) 
Seat 7: rooney69 (5230 in chips) 
Seat 8: uuvvrr (4990 in chips) 
Seat 9: Samburger514 (5200 in chips) 
guitarist68: posts the ante 5
Anton163reg: posts the ante 5
GoldenBeeM: posts the ante 5
PETER BEATZ: posts the ante 5
dekota222: posts the ante 5
rooney69: posts the ante 5
uuvvrr: posts the ante 5
Samburger514: posts the ante 5
PETER BEATZ: posts small blind 15
dekota222: posts big blind 30
*** HOLE CARDS ***
rooney69: folds 
uuvvrr: folds 
Samburger514: folds 
guitarist68: raises 36 to 66
Anton163reg: folds 
GoldenBeeM: folds 
PETER BEATZ: folds 
dekota222: folds 
Uncalled bet (36) returned to guitarist68
guitarist68 collected 115 from pot
guitarist68: doesn't show hand 
*** SUMMARY ***
Total pot 115 | Rake 0 
Seat 1: guitarist68 collected (115)
Seat 2: Anton163reg folded before Flop (didn't bet)
Seat 3: GoldenBeeM (button) folded before Flop (didn't bet)
Seat 4: PETER BEATZ (small blind) folded before Flop
Seat 6: dekota222 (big blind) folded before Flop
Seat 7: rooney69 folded before Flop (didn't bet)
Seat 8: uuvvrr folded before Flop (didn't bet)
Seat 9: Samburger514 folded before Flop (didn't bet)



PokerStars Hand #157575119183: Tournament #1641817620, $7.50+$7.50+$1.50 USD Hold'em No Limit - Level I (15/30) - 2016/08/21 18:31:40 ET
Table '1641817620 10' 9-max Seat #4 is the button
Seat 1: VANDECO174 (4985 in chips) 
Seat 2: Be Anger (4970 in chips) 
Seat 3: mickyryan (5030 in chips) 
Seat 4: silveira1879 (5030 in chips) 
Seat 5: AndyLou27 (4955 in chips) 
Seat 6: I M GOIN OFF (4985 in chips) 
Seat 7: Nuazo (4985 in chips) 
Seat 8: damibor (5135 in chips) 
Seat 9: Stokesy05 (4925 in chips) 
VANDECO174: posts the ante 5
Be Anger: posts the ante 5
mickyryan: posts the ante 5
silveira1879: posts the ante 5
AndyLou27: posts the ante 5
I M GOIN OFF: posts the ante 5
Nuazo: posts the ante 5
damibor: posts the ante 5
Stokesy05: posts the ante 5
AndyLou27: posts small blind 15
I M GOIN OFF: posts big blind 30
*** HOLE CARDS ***
Nuazo: folds 
damibor: folds 
Stokesy05: folds 
VANDECO174: folds 
Be Anger: raises 60 to 90
mickyryan: folds 
silveira1879: raises 150 to 240
AndyLou27: folds 
I M GOIN OFF: folds 
Be Anger: calls 150
*** FLOP *** [Ad 9c 4d]
Be Anger: checks 
silveira1879: bets 285
Be Anger: folds 
Uncalled bet (285) returned to silveira1879
silveira1879 collected 570 from pot
silveira1879: doesn't show hand 
*** SUMMARY ***
Total pot 570 | Rake 0 
Board [Ad 9c 4d]
Seat 1: VANDECO174 folded before Flop (didn't bet)
Seat 2: Be Anger folded on the Flop
Seat 3: mickyryan folded before Flop (didn't bet)
Seat 4: silveira1879 (button) collected (570)
Seat 5: AndyLou27 (small blind) folded before Flop
Seat 6: I M GOIN OFF (big blind) folded before Flop
Seat 7: Nuazo folded before Flop (didn't bet)
Seat 8: damibor folded before Flop (didn't bet)
Seat 9: Stokesy05 folded before Flop (didn't bet)



PokerStars Hand #157575120324: Tournament #1641817620, $7.50+$7.50+$1.50 USD Hold'em No Limit - Level I (15/30) - 2016/08/21 18:31:41 ET
Table '1641817620 44' 9-max Seat #4 is the button
Seat 1: BurrGrylls (4985 in chips) 
Seat 2: moisesgosu (4970 in chips) 
Seat 3: kduwork (5030 in chips) 
Seat 4: starkstud (5120 in chips) 
Seat 5: rbcowboy27 (5000 in chips) out of hand (moved from another table into small blind)
Seat 6: lesley hu (4955 in chips) is sitting out
Seat 7: ongggg (5000 in chips) 
Seat 8: heynow21 (4985 in chips) 
Seat 9: Pro_Tunis (5070 in chips) 
BurrGrylls: posts the ante 5
moisesgosu: posts the ante 5
kduwork: posts the ante 5
starkstud: posts the ante 5
lesley hu: posts the ante 5
ongggg: posts the ante 5
heynow21: posts the ante 5
Pro_Tunis: posts the ante 5
lesley hu: posts small blind 15
ongggg: posts big blind 30
*** HOLE CARDS ***
heynow21: folds 
Pro_Tunis: folds 
BurrGrylls: folds 
moisesgosu: folds 
kduwork: raises 42 to 72
starkstud: folds 
lesley hu: folds 
ongggg: calls 42
*** FLOP *** [4d 8h 6d]
ongggg: checks 
kduwork: bets 151
ongggg: folds 
Uncalled bet (151) returned to kduwork
kduwork collected 199 from pot
kduwork: doesn't show hand 
*** SUMMARY ***
Total pot 199 | Rake 0 
Board [4d 8h 6d]
Seat 1: BurrGrylls folded before Flop (didn't bet)
Seat 2: moisesgosu folded before Flop (didn't bet)
Seat 3: kduwork collected (199)
Seat 4: starkstud (button) folded before Flop (didn't bet)
Seat 6: lesley hu (small blind) folded before Flop
Seat 7: ongggg (big blind) folded on the Flop
Seat 8: heynow21 folded before Flop (didn't bet)
Seat 9: Pro_Tunis folded before Flop (didn't bet)



PokerStars Hand #157575120405: Tournament #1641817620, $7.50+$7.50+$1.50 USD Hold'em No Limit - Level I (15/30) - 2016/08/21 18:31:41 ET
Table '1641817620 51' 9-max Seat #3 is the button
Seat 1: yys000 (4990 in chips) 
Seat 2: paulotury (4975 in chips) 
Seat 3: kozloeric (4878 in chips) 
Seat 4: bastef79 (4818 in chips) 
Seat 5: cusirc (4990 in chips) 
Seat 6: demonas05 (5379 in chips) 
Seat 7: boostyz (4990 in chips) 
Seat 8: Garfild740 (4990 in chips) 
Seat 9: Kalvar1 (4990 in chips) 
yys000: posts the ante 5
paulotury: posts the ante 5
kozloeric: posts the ante 5
bastef79: posts the ante 5
cusirc: posts the ante 5
demonas05: posts the ante 5
boostyz: posts the ante 5
Garfild740: posts the ante 5
Kalvar1: posts the ante 5
bastef79: posts small blind 15
cusirc: posts big blind 30
*** HOLE CARDS ***
demonas05: folds 
boostyz: folds 
Garfild740: folds 
Kalvar1: calls 30
yys000: folds 
paulotury: folds 
kozloeric: folds 
bastef79: calls 15
cusirc: checks 
*** FLOP *** [Jh 2d Qd]
bastef79: checks 
cusirc: checks 
Kalvar1: bets 60
bastef79: calls 60
cusirc: folds 
*** TURN *** [Jh 2d Qd] [Kh]
bastef79: bets 117
Kalvar1: calls 117
*** RIVER *** [Jh 2d Qd Kh] [Ac]
bastef79: bets 540
Kalvar1: calls 540
*** SHOW DOWN ***
bastef79: shows [Qc Td] (a straight, Ten to Ace)
Kalvar1: shows [Tc 9s] (a straight, Ten to Ace)
bastef79 collected 785 from pot
Kalvar1 collected 784 from pot
*** SUMMARY ***
Total pot 1569 | Rake 0 
Board [Jh 2d Qd Kh Ac]
Seat 1: yys000 folded before Flop (didn't bet)
Seat 2: paulotury folded before Flop (didn't bet)
Seat 3: kozloeric (button) folded before Flop (didn't bet)
Seat 4: bastef79 (small blind) showed [Qc Td] and won (785) with a straight, Ten to Ace
Seat 5: cusirc (big blind) folded on the Flop
Seat 6: demonas05 folded before Flop (didn't bet)
Seat 7: boostyz folded before Flop (didn't bet)
Seat 8: Garfild740 folded before Flop (didn't bet)
Seat 9: Kalvar1 showed [Tc 9s] and won (784) with a straight, Ten to Ace



PokerStars Hand #157575120604: Tournament #1641817620, $7.50+$7.50+$1.50 USD Hold'em No Limit - Level I (15/30) - 2016/08/21 18:31:42 ET
Table '1641817620 53' 9-max Seat #3 is the button
Seat 1: star729 (5470 in chips) 
Seat 2: cebola77 (4975 in chips) 
Seat 3: Pekkosaurus (4945 in chips) 
Seat 4: -UNREGPRE- (4960 in chips) 
Seat 5: carlostrend (4690 in chips) 
Seat 6: The39player (4990 in chips) 
Seat 7: MingRey (4990 in chips) 
Seat 8: top@pokker (4990 in chips) 
Seat 9: cruiser5917 (4990 in chips) 
star729: posts the ante 5
cebola77: posts the ante 5
Pekkosaurus: posts the ante 5
-UNREGPRE-: posts the ante 5
carlostrend: posts the ante 5
The39player: posts the ante 5
MingRey: posts the ante 5
top@pokker: posts the ante 5
cruiser5917: posts the ante 5
-UNREGPRE-: posts small blind 15
carlostrend: posts big blind 30
*** HOLE CARDS ***
The39player: folds 
MingRey: folds 
top@pokker: folds 
cruiser5917: folds 
star729: raises 60 to 90
cebola77: folds 
Pekkosaurus: folds 
-UNREGPRE-: folds 
carlostrend: calls 60
*** FLOP *** [8c Ah Qd]
carlostrend: checks 
star729: checks 
*** TURN *** [8c Ah Qd] [7d]
carlostrend: checks 
star729: bets 120
carlostrend: folds 
Uncalled bet (120) returned to star729
star729 collected 240 from pot
star729: doesn't show hand 
*** SUMMARY ***
Total pot 240 | Rake 0 
Board [8c Ah Qd 7d]
Seat 1: star729 collected (240)
Seat 2: cebola77 folded before Flop (didn't bet)
Seat 3: Pekkosaurus (button) folded before Flop (didn't bet)
Seat 4: -UNREGPRE- (small blind) folded before Flop
Seat 5: carlostrend (big blind) folded on the Turn
Seat 6: The39player folded before Flop (didn't bet)
Seat 7: MingRey folded before Flop (didn't bet)
Seat 8: top@pokker folded before Flop (didn't bet)
Seat 9: cruiser5917 folded before Flop (didn't bet)



PokerStars Hand #157575121110: Tournament #1641817620, $7.50+$7.50+$1.50 USD Hold'em No Limit - Level I (15/30) - 2016/08/21 18:31:42 ET
Table '1641817620 6' 9-max Seat #6 is the button
Seat 1: ASTRAXANSKI (4985 in chips) 
Seat 2: KOT-BEGEMOT6 (4970 in chips) 
Seat 3: agneseagnese (4995 in chips) 
Seat 4: mekkoramarha (5025 in chips) 
Seat 5: KKKistKKK (5000 in chips) 
Seat 6: brown1967 (5020 in chips) 
Seat 7: Balotelli195 (4955 in chips) 
Seat 8: linoleum006 (5070 in chips) 
Seat 9: Jelsomino79 (4985 in chips) 
ASTRAXANSKI: posts the ante 5
KOT-BEGEMOT6: posts the ante 5
agneseagnese: posts the ante 5
mekkoramarha: posts the ante 5
KKKistKKK: posts the ante 5
brown1967: posts the ante 5
Balotelli195: posts the ante 5
linoleum006: posts the ante 5
Jelsomino79: posts the ante 5
Balotelli195: posts small blind 15
linoleum006: posts big blind 30
*** HOLE CARDS ***
Jelsomino79: raises 30 to 60
ASTRAXANSKI: folds 
KOT-BEGEMOT6: folds 
agneseagnese: folds 
mekkoramarha: calls 60
KKKistKKK: calls 60
brown1967: folds 
Balotelli195: folds 
linoleum006: calls 30
*** FLOP *** [7c 9c Tc]
linoleum006: checks 
Jelsomino79: bets 153
mekkoramarha: folds 
KKKistKKK: calls 153
linoleum006: folds 
*** TURN *** [7c 9c Tc] [Js]
Jelsomino79: bets 309
KKKistKKK: calls 309
*** RIVER *** [7c 9c Tc Js] [8s]
Jelsomino79: bets 624
KKKistKKK: calls 624
*** SHOW DOWN ***
Jelsomino79: shows [4c Ac] (a flush, Ace high)
KKKistKKK: mucks hand 
Jelsomino79 collected 2472 from pot
*** SUMMARY ***
Total pot 2472 | Rake 0 
Board [7c 9c Tc Js 8s]
Seat 1: ASTRAXANSKI folded before Flop (didn't bet)
Seat 2: KOT-BEGEMOT6 folded before Flop (didn't bet)
Seat 3: agneseagnese folded before Flop (didn't bet)
Seat 4: mekkoramarha folded on the Flop
Seat 5: KKKistKKK mucked
Seat 6: brown1967 (button) folded before Flop (didn't bet)
Seat 7: Balotelli195 (small blind) folded before Flop
Seat 8: linoleum006 (big blind) folded on the Flop
Seat 9: Jelsomino79 showed [4c Ac] and won (2472) with a flush, Ace high



PokerStars Hand #157575122513: Tournament #1641817620, $7.50+$7.50+$1.50 USD Hold'em No Limit - Level I (15/30) - 2016/08/21 18:31:45 ET
Table '1641817620 11' 9-max Seat #2 is the button
Seat 1: GambleGrill (4995 in chips) 
Seat 2: Dionakabarbi (4980 in chips) is sitting out
Seat 3: TriviGn'R (5050 in chips) 
Seat 4: rapo007 (4995 in chips) 
Seat 5: vanilaice88 (4995 in chips) 
Seat 6: buzios38 (4995 in chips) 
Seat 7: BAIGUATE (5000 in chips) 
Seat 8: luisnrd (4995 in chips) 
Seat 9: kylix42 (4995 in chips) 
GambleGrill: posts the ante 5
Dionakabarbi: posts the ante 5
TriviGn'R: posts the ante 5
rapo007: posts the ante 5
vanilaice88: posts the ante 5
buzios38: posts the ante 5
BAIGUATE: posts the ante 5
luisnrd: posts the ante 5
kylix42: posts the ante 5
TriviGn'R: posts small blind 15
rapo007: posts big blind 30
*** HOLE CARDS ***
vanilaice88: folds 
buzios38: raises 60 to 90
BAIGUATE: folds 
luisnrd: folds 
kylix42: folds 
GambleGrill: folds 
Dionakabarbi: folds 
TriviGn'R: folds 
rapo007: folds 
Uncalled bet (60) returned to buzios38
buzios38 collected 120 from pot
buzios38: doesn't show hand 
*** SUMMARY ***
Total pot 120 | Rake 0 
Seat 1: GambleGrill folded before Flop (didn't bet)
Seat 2: Dionakabarbi (button) folded before Flop (didn't bet)
Seat 3: TriviGn'R (small blind) folded before Flop
Seat 4: rapo007 (big blind) folded before Flop
Seat 5: vanilaice88 folded before Flop (didn't bet)
Seat 6: buzios38 collected (120)
Seat 7: BAIGUATE folded before Flop (didn't bet)
Seat 8: luisnrd folded before Flop (didn't bet)
Seat 9: kylix42 folded before Flop (didn't bet)



PokerStars Hand #157575122975: Tournament #1641817620, $7.50+$7.50+$1.50 USD Hold'em No Limit - Level I (15/30) - 2016/08/21 18:31:45 ET
Table '1641817620 39' 9-max Seat #3 is the button
Seat 1: BuyMeBMW (4990 in chips) 
Seat 2: ahaknh (4960 in chips) 
Seat 3: Crim44 (4945 in chips) 
Seat 4: Neo_gracz (4960 in chips) 
Seat 6: TxsFrUrMoney (4990 in chips) 
Seat 7: j.williams94 (5200 in chips) 
Seat 8: 88K@la88 (4990 in chips) 
Seat 9: Foggy56 (4840 in chips) 
BuyMeBMW: posts the ante 5
ahaknh: posts the ante 5
Crim44: posts the ante 5
Neo_gracz: posts the ante 5
TxsFrUrMoney: posts the ante 5
j.williams94: posts the ante 5
88K@la88: posts the ante 5
Foggy56: posts the ante 5
Neo_gracz: posts small blind 15
TxsFrUrMoney: posts big blind 30
*** HOLE CARDS ***
j.williams94: folds 
88K@la88: raises 60 to 90
Foggy56: folds 
BuyMeBMW: folds 
ahaknh: folds 
Crim44: calls 90
Neo_gracz: folds 
TxsFrUrMoney: folds 
*** FLOP *** [2c Js 5h]
88K@la88: bets 132
Crim44: calls 132
*** TURN *** [2c Js 5h] [Th]
88K@la88: checks 
Crim44: bets 270
88K@la88: calls 270
*** RIVER *** [2c Js 5h Th] [6c]
88K@la88: checks 
Crim44: bets 540
88K@la88: folds 
Uncalled bet (540) returned to Crim44
Crim44 collected 1069 from pot
Crim44: doesn't show hand 
*** SUMMARY ***
Total pot 1069 | Rake 0 
Board [2c Js 5h Th 6c]
Seat 1: BuyMeBMW folded before Flop (didn't bet)
Seat 2: ahaknh folded before Flop (didn't bet)
Seat 3: Crim44 (button) collected (1069)
Seat 4: Neo_gracz (small blind) folded before Flop
Seat 6: TxsFrUrMoney (big blind) folded before Flop
Seat 7: j.williams94 folded before Flop (didn't bet)
Seat 8: 88K@la88 folded on the River
Seat 9: Foggy56 folded before Flop (didn't bet)



PokerStars Hand #157575123959: Tournament #1641817620, $7.50+$7.50+$1.50 USD Hold'em No Limit - Level I (15/30) - 2016/08/21 18:31:47 ET
Table '1641817620 36' 9-max Seat #2 is the button
Seat 1: craiger1976 (4995 in chips) 
Seat 2: Winston4ever (4905 in chips) 
Seat 3: sarxa (4965 in chips) 
Seat 5: blufface88 (5160 in chips) 
Seat 6: xanja (4995 in chips) 
Seat 7: jadrankokec (4995 in chips) 
Seat 8: ruben marley (4995 in chips) 
Seat 9: wowbizz2 (4995 in chips) 
craiger1976: posts the ante 5
Winston4ever: posts the ante 5
sarxa: posts the ante 5
blufface88: posts the ante 5
xanja: posts the ante 5
jadrankokec: posts the ante 5
ruben marley: posts the ante 5
wowbizz2: posts the ante 5
sarxa: posts small blind 15
blufface88: posts big blind 30
*** HOLE CARDS ***
xanja: folds 
jadrankokec: folds 
ruben marley: folds 
wowbizz2: folds 
craiger1976: folds 
Winston4ever: calls 30
sarxa: folds 
blufface88: checks 
*** FLOP *** [Ac 5h 9d]
blufface88: checks 
Winston4ever: bets 57
blufface88: folds 
Uncalled bet (57) returned to Winston4ever
Winston4ever collected 115 from pot
*** SUMMARY ***
Total pot 115 | Rake 0 
Board [Ac 5h 9d]
Seat 1: craiger1976 folded before Flop (didn't bet)
Seat 2: Winston4ever (button) collected (115)
Seat 3: sarxa (small blind) folded before Flop
Seat 5: blufface88 (big blind) folded on the Flop
Seat 6: xanja folded before Flop (didn't bet)
Seat 7: jadrankokec folded before Flop (didn't bet)
Seat 8: ruben marley folded before Flop (didn't bet)
Seat 9: wowbizz2 folded before Flop (didn't bet)



PokerStars Hand #157575124207: Tournament #1641817620, $7.50+$7.50+$1.50 USD Hold'em No Limit - Level I (15/30) - 2016/08/21 18:31:47 ET
Table '1641817620 37' 9-max Seat #3 is the button
Seat 1: Youbetipush1 (4990 in chips) 
Seat 2: SouzaEduardo (4975 in chips) 
Seat 3: Maisteri (4945 in chips) 
Seat 4: qball911 (4960 in chips) 
Seat 6: ColdFire_200 (4990 in chips) 
Seat 7: loachxm (5000 in chips) 
Seat 8: Starvinghelp (1870 in chips) 
Seat 9: carabason (8285 in chips) 
Youbetipush1: posts the ante 5
SouzaEduardo: posts the ante 5
Maisteri: posts the ante 5
qball911: posts the ante 5
ColdFire_200: posts the ante 5
loachxm: posts the ante 5
Starvinghelp: posts the ante 5
carabason: posts the ante 5
qball911: posts small blind 15
ColdFire_200: posts big blind 30
*** HOLE CARDS ***
loachxm: raises 30 to 60
Starvinghelp: calls 60
carabason: folds 
Youbetipush1: calls 60
SouzaEduardo: folds 
Maisteri: raises 4880 to 4940 and is all-in
qball911: folds 
ColdFire_200: folds 
loachxm: folds 
Starvinghelp: calls 1805 and is all-in
Youbetipush1: folds 
Uncalled bet (3075) returned to Maisteri
*** FLOP *** [Ah Jc 9d]
*** TURN *** [Ah Jc 9d] [8c]
*** RIVER *** [Ah Jc 9d 8c] [4h]
*** SHOW DOWN ***
Starvinghelp: shows [7s 5s] (high card Ace)
Maisteri: shows [Ac Kh] (a pair of Aces)
Maisteri collected 3935 from pot
Maisteri wins $3.75 for eliminating Starvinghelp and their own bounty increases by $3.75 to $11.25
Starvinghelp finished the tournament in 999999998th place
*** SUMMARY ***
Total pot 3935 | Rake 0 
Board [Ah Jc 9d 8c 4h]
Seat 1: Youbetipush1 folded before Flop
Seat 2: SouzaEduardo folded before Flop (didn't bet)
Seat 3: Maisteri (button) showed [Ac Kh] and won (3935) with a pair of Aces
Seat 4: qball911 (small blind) folded before Flop
Seat 6: ColdFire_200 (big blind) folded before Flop
Seat 7: loachxm folded before Flop
Seat 8: Starvinghelp showed [7s 5s] and lost with high card Ace
Seat 9: carabason folded before Flop (didn't bet)



PokerStars Hand #157575124323: Tournament #1641817620, $7.50+$7.50+$1.50 USD Hold'em No Limit - Level I (15/30) - 2016/08/21 18:31:47 ET
Table '1641817620 3' 9-max Seat #3 is the button
Seat 1: IwantplayNL (4990 in chips) 
Seat 2: dufino (7366 in chips) 
Seat 3: zIggY-7-rAc3 (4945 in chips) 
Seat 4: gerald0jr (4960 in chips) 
Seat 6: BrunoCastroR (2875 in chips) 
Seat 7: alehirazawa (4990 in chips) 
Seat 8: markosharko (4894 in chips) 
Seat 9: VictorZh14 (4990 in chips) 
IwantplayNL: posts the ante 5
dufino: posts the ante 5
zIggY-7-rAc3: posts the ante 5
gerald0jr: posts the ante 5
BrunoCastroR: posts the ante 5
alehirazawa: posts the ante 5
markosharko: posts the ante 5
VictorZh14: posts the ante 5
gerald0jr: posts small blind 15
BrunoCastroR: posts big blind 30
*** HOLE CARDS ***
alehirazawa: folds 
markosharko: folds 
VictorZh14: folds 
IwantplayNL: folds 
dufino: folds 
zIggY-7-rAc3: folds 
gerald0jr: folds 
Uncalled bet (15) returned to BrunoCastroR
BrunoCastroR collected 70 from pot
BrunoCastroR: doesn't show hand 
*** SUMMARY ***
Total pot 70 | Rake 0 
Seat 1: IwantplayNL folded before Flop (didn't bet)
Seat 2: dufino folded before Flop (didn't bet)
Seat 3: zIggY-7-rAc3 (button) folded before Flop (didn't bet)
Seat 4: gerald0jr (small blind) folded before Flop
Seat 6: BrunoCastroR (big blind) collected (70)
Seat 7: alehirazawa folded before Flop (didn't bet)
Seat 8: markosharko folded before Flop (didn't bet)
Seat 9: VictorZh14 folded before Flop (didn't bet)



PokerStars Hand #157575124559: Tournament #1641817620, $7.50+$7.50+$1.50 USD Hold'em No Limit - Level I (15/30) - 2016/08/21 18:31:48 ET
Table '1641817620 7' 9-max Seat #3 is the button
Seat 1: jad castelo (5000 in chips) 
Seat 2: ricar1749 (4995 in chips) 
Seat 3: Steve G009 (4980 in chips) 
Seat 4: nbmom (4905 in chips) 
Seat 6: POKEMONSTRO (4995 in chips) 
Seat 7: NemeanDanny (4995 in chips) 
Seat 8: Original02 (5380 in chips) 
Seat 9: cjgarceau (4995 in chips) 
jad castelo: posts the ante 5
ricar1749: posts the ante 5
Steve G009: posts the ante 5
nbmom: posts the ante 5
POKEMONSTRO: posts the ante 5
NemeanDanny: posts the ante 5
Original02: posts the ante 5
cjgarceau: posts the ante 5
nbmom: posts small blind 15
POKEMONSTRO: posts big blind 30
*** HOLE CARDS ***
NemeanDanny: folds 
Original02: folds 
cjgarceau: folds 
jad castelo: raises 60 to 90
ricar1749: folds 
Steve G009: folds 
nbmom: folds 
POKEMONSTRO: folds 
Uncalled bet (60) returned to jad castelo
jad castelo collected 115 from pot
jad castelo: doesn't show hand 
*** SUMMARY ***
Total pot 115 | Rake 0 
Seat 1: jad castelo collected (115)
Seat 2: ricar1749 folded before Flop (didn't bet)
Seat 3: Steve G009 (button) folded before Flop (didn't bet)
Seat 4: nbmom (small blind) folded before Flop
Seat 6: POKEMONSTRO (big blind) folded before Flop
Seat 7: NemeanDanny folded before Flop (didn't bet)
Seat 8: Original02 folded before Flop (didn't bet)
Seat 9: cjgarceau folded before Flop (didn't bet)



PokerStars Hand #157575126060: Tournament #1641817620, $7.50+$7.50+$1.50 USD Hold'em No Limit - Level I (15/30) - 2016/08/21 18:31:50 ET
Table '1641817620 47' 9-max Seat #3 is the button
Seat 1: sovikeen (4990 in chips) 
Seat 2: RipperRooo (5365 in chips) 
Seat 3: gtavares10 (4945 in chips) 
Seat 4: FredyROKSTAR (5000 in chips) out of hand (moved from another table into small blind)
Seat 5: IvnAK (4660 in chips) 
Seat 6: sergiooker (4990 in chips) 
Seat 7: T3chnojunk (4990 in chips) 
Seat 8: bruff3l (5075 in chips) 
Seat 9: ppmaster (4990 in chips) 
sovikeen: posts the ante 5
RipperRooo: posts the ante 5
gtavares10: posts the ante 5
IvnAK: posts the ante 5
sergiooker: posts the ante 5
T3chnojunk: posts the ante 5
bruff3l: posts the ante 5
ppmaster: posts the ante 5
IvnAK: posts small blind 15
sergiooker: posts big blind 30
*** HOLE CARDS ***
T3chnojunk: folds 
bruff3l: folds 
ppmaster: raises 60 to 90
sovikeen: folds 
RipperRooo: folds 
gtavares10: calls 90
IvnAK: folds 
sergiooker: calls 60
*** FLOP *** [9c 4h 4c]
sergiooker: checks 
ppmaster: checks 
gtavares10: bets 123
sergiooker: calls 123
ppmaster: folds 
*** TURN *** [9c 4h 4c] [Kd]
sergiooker: checks 
gtavares10: checks 
*** RIVER *** [9c 4h 4c Kd] [Qc]
sergiooker: bets 428
gtavares10: folds 
Uncalled bet (428) returned to sergiooker
sergiooker collected 571 from pot
sergiooker: doesn't show hand 
*** SUMMARY ***
Total pot 571 | Rake 0 
Board [9c 4h 4c Kd Qc]
Seat 1: sovikeen folded before Flop (didn't bet)
Seat 2: RipperRooo folded before Flop (didn't bet)
Seat 3: gtavares10 (button) folded on the River
Seat 5: IvnAK (small blind) folded before Flop
Seat 6: sergiooker (big blind) collected (571)
Seat 7: T3chnojunk folded before Flop (didn't bet)
Seat 8: bruff3l folded before Flop (didn't bet)
Seat 9: ppmaster folded on the Flop



PokerStars Hand #157575127534: Tournament #1641817620, $7.50+$7.50+$1.50 USD Hold'em No Limit - Level I (15/30) - 2016/08/21 18:31:52 ET
Table '1641817620 55' 9-max Seat #3 is the button
Seat 1: jake5030 (4990 in chips) 
Seat 2: HayArro (4900 in chips) 
Seat 3: MaxPips (4885 in chips) 
Seat 4: furia75205 (4960 in chips) 
Seat 5: hoolzky (4900 in chips) 
Seat 6: B.Paulino (4990 in chips) 
Seat 7: xLewie (5395 in chips) 
Seat 8: mendozoQ (4990 in chips) 
Seat 9: igara tigara (4990 in chips) 
jake5030: posts the ante 5
HayArro: posts the ante 5
MaxPips: posts the ante 5
furia75205: posts the ante 5
hoolzky: posts the ante 5
B.Paulino: posts the ante 5
xLewie: posts the ante 5
mendozoQ: posts the ante 5
igara tigara: posts the ante 5
furia75205: posts small blind 15
hoolzky: posts big blind 30
*** HOLE CARDS ***
B.Paulino: folds 
xLewie: folds 
mendozoQ: raises 60 to 90
igara tigara: folds 
jake5030: calls 90
HayArro: folds 
MaxPips: folds 
furia75205: folds 
hoolzky: folds 
*** FLOP *** [Jc Td 3h]
mendozoQ: bets 135
jake5030: calls 135
*** TURN *** [Jc Td 3h] [5h]
mendozoQ: bets 300
jake5030: raises 4460 to 4760 and is all-in
mendozoQ: calls 4460 and is all-in
*** RIVER *** [Jc Td 3h 5h] [9c]
*** SHOW DOWN ***
mendozoQ: shows [Kc Kd] (a pair of Kings)
jake5030: shows [Ah Th] (a pair of Tens)
mendozoQ collected 10060 from pot
mendozoQ wins $3.75 for eliminating jake5030 and their own bounty increases by $3.75 to $11.25
jake5030 finished the tournament in 999999995th place
*** SUMMARY ***
Total pot 10060 | Rake 0 
Board [Jc Td 3h 5h 9c]
Seat 1: jake5030 showed [Ah Th] and lost with a pair of Tens
Seat 2: HayArro folded before Flop (didn't bet)
Seat 3: MaxPips (button) folded before Flop (didn't bet)
Seat 4: furia75205 (small blind) folded before Flop
Seat 5: hoolzky (big blind) folded before Flop
Seat 6: B.Paulino folded before Flop (didn't bet)
Seat 7: xLewie folded before Flop (didn't bet)
Seat 8: mendozoQ showed [Kc Kd] and won (10060) with a pair of Kings
Seat 9: igara tigara folded before Flop (didn't bet)



PokerStars Hand #157575127976: Tournament #1641817620, $7.50+$7.50+$1.50 USD Hold'em No Limit - Level I (15/30) - 2016/08/21 18:31:53 ET
Table '1641817620 22' 9-max Seat #3 is the button
Seat 1: glangglang (4990 in chips) 
Seat 2: skalistair (4900 in chips) 
Seat 3: CHININ118 (4945 in chips) 
Seat 4: Jaliplay (5065 in chips) 
Seat 5: hewx (4990 in chips) 
Seat 6: xxSTORMZYxx (4990 in chips) 
Seat 7: ogotop76 (4990 in chips) 
Seat 8: monterreymx (4990 in chips) 
Seat 9: cash4king (5140 in chips) 
glangglang: posts the ante 5
skalistair: posts the ante 5
CHININ118: posts the ante 5
Jaliplay: posts the ante 5
hewx: posts the ante 5
xxSTORMZYxx: posts the ante 5
ogotop76: posts the ante 5
monterreymx: posts the ante 5
cash4king: posts the ante 5
Jaliplay: posts small blind 15
hewx: posts big blind 30
*** HOLE CARDS ***
xxSTORMZYxx: folds 
ogotop76: folds 
monterreymx: folds 
cash4king: folds 
glangglang: folds 
skalistair: raises 60 to 90
CHININ118: folds 
Jaliplay: folds 
hewx: folds 
Uncalled bet (60) returned to skalistair
skalistair collected 120 from pot
skalistair: doesn't show hand 
*** SUMMARY ***
Total pot 120 | Rake 0 
Seat 1: glangglang folded before Flop (didn't bet)
Seat 2: skalistair collected (120)
Seat 3: CHININ118 (button) folded before Flop (didn't bet)
Seat 4: Jaliplay (small blind) folded before Flop
Seat 5: hewx (big blind) folded before Flop
Seat 6: xxSTORMZYxx folded before Flop (didn't bet)
Seat 7: ogotop76 folded before Flop (didn't bet)
Seat 8: monterreymx folded before Flop (didn't bet)
Seat 9: cash4king folded before Flop (didn't bet)



PokerStars Hand #157575128801: Tournament #1641817620, $7.50+$7.50+$1.50 USD Hold'em No Limit - Level I (15/30) - 2016/08/21 18:31:54 ET
Table '1641817620 21' 9-max Seat #3 is the button
Seat 1: apaixtos1 (4990 in chips) 
Seat 2: ukr_durrrr (4855 in chips) 
Seat 3: ultgamb (4945 in chips) 
Seat 4: fishin1981 (4960 in chips) 
Seat 5: jeroma123 (4990 in chips) 
Seat 6: olleggi (5080 in chips) 
Seat 7: pokerlazik (4990 in chips) 
Seat 8: pokerist2692 (5200 in chips) 
Seat 9: Ferrazz (4990 in chips) 
apaixtos1: posts the ante 5
ukr_durrrr: posts the ante 5
ultgamb: posts the ante 5
fishin1981: posts the ante 5
jeroma123: posts the ante 5
olleggi: posts the ante 5
pokerlazik: posts the ante 5
pokerist2692: posts the ante 5
Ferrazz: posts the ante 5
fishin1981: posts small blind 15
jeroma123: posts big blind 30
*** HOLE CARDS ***
olleggi: folds 
pokerlazik: folds 
pokerist2692: folds 
Ferrazz: folds 
apaixtos1: raises 30 to 60
ukr_durrrr: folds 
ultgamb: folds 
fishin1981: calls 45
jeroma123: calls 30
*** FLOP *** [7s 2d 4c]
fishin1981: checks 
jeroma123: checks 
apaixtos1: checks 
*** TURN *** [7s 2d 4c] [8h]
fishin1981: checks 
jeroma123: bets 90
apaixtos1: calls 90
fishin1981: folds 
*** RIVER *** [7s 2d 4c 8h] [8s]
jeroma123: checks 
apaixtos1: bets 405
jeroma123: calls 405
*** SHOW DOWN ***
apaixtos1: shows [9d 8d] (three of a kind, Eights)
jeroma123: mucks hand 
apaixtos1 collected 1215 from pot
*** SUMMARY ***
Total pot 1215 | Rake 0 
Board [7s 2d 4c 8h 8s]
Seat 1: apaixtos1 showed [9d 8d] and won (1215) with three of a kind, Eights
Seat 2: ukr_durrrr folded before Flop (didn't bet)
Seat 3: ultgamb (button) folded before Flop (didn't bet)
Seat 4: fishin1981 (small blind) folded on the Turn
Seat 5: jeroma123 (big blind) mucked
Seat 6: olleggi folded before Flop (didn't bet)
Seat 7: pokerlazik folded before Flop (didn't bet)
Seat 8: pokerist2692 folded before Flop (didn't bet)
Seat 9: Ferrazz folded before Flop (didn't bet)



PokerStars Hand #157575129034: Tournament #1641817620, $7.50+$7.50+$1.50 USD Hold'em No Limit - Level I (15/30) - 2016/08/21 18:31:55 ET
Table '1641817620 50' 9-max Seat #3 is the button
Seat 1: Alpentraum (4960 in chips) 
Seat 2: FrEmpireAk (4660 in chips) 
Seat 3: hat_coates (4945 in chips) 
Seat 4: GiCi40 (5000 in chips) out of hand (moved from another table into small blind)
Seat 5: Herbettigre (4855 in chips) 
Seat 6: saintP20 (5750 in chips) 
Seat 7: Shab26 (4855 in chips) 
Seat 8: thinkfeeldo (4990 in chips) 
Seat 9: ziomekek (4990 in chips) 
Alpentraum: posts the ante 5
FrEmpireAk: posts the ante 5
hat_coates: posts the ante 5
Herbettigre: posts the ante 5
saintP20: posts the ante 5
Shab26: posts the ante 5
thinkfeeldo: posts the ante 5
ziomekek: posts the ante 5
Herbettigre: posts small blind 15
saintP20: posts big blind 30
*** HOLE CARDS ***
Shab26: folds 
thinkfeeldo: folds 
ziomekek: folds 
Alpentraum: raises 115 to 145
FrEmpireAk: raises 185 to 330
hat_coates: folds 
Herbettigre: folds 
saintP20: calls 300
Alpentraum: calls 185
*** FLOP *** [Jc 8s 7c]
saintP20: checks 
Alpentraum: bets 522
FrEmpireAk: raises 1587 to 2109
saintP20: calls 2109
Alpentraum: folds 
*** TURN *** [Jc 8s 7c] [8d]
saintP20: bets 3306 and is all-in
FrEmpireAk: calls 2216 and is all-in
Uncalled bet (1090) returned to saintP20
*** RIVER *** [Jc 8s 7c 8d] [Ad]
*** SHOW DOWN ***
saintP20: shows [Qc Kc] (a pair of Eights)
FrEmpireAk: shows [Td 9d] (a straight, Seven to Jack)
FrEmpireAk collected 10217 from pot
*** SUMMARY ***
Total pot 10217 | Rake 0 
Board [Jc 8s 7c 8d Ad]
Seat 1: Alpentraum folded on the Flop
Seat 2: FrEmpireAk showed [Td 9d] and won (10217) with a straight, Seven to Jack
Seat 3: hat_coates (button) folded before Flop (didn't bet)
Seat 5: Herbettigre (small blind) folded before Flop
Seat 6: saintP20 (big blind) showed [Qc Kc] and lost with a pair of Eights
Seat 7: Shab26 folded before Flop (didn't bet)
Seat 8: thinkfeeldo folded before Flop (didn't bet)
Seat 9: ziomekek folded before Flop (didn't bet)



PokerStars Hand #157575129381: Tournament #1641817620, $7.50+$7.50+$1.50 USD Hold'em No Limit - Level I (15/30) - 2016/08/21 18:31:55 ET
Table '1641817620 40' 9-max Seat #3 is the button
Seat 1: Shiryu100 (4990 in chips) 
Seat 2: nico122527 (4945 in chips) 
Seat 3: ilico (4855 in chips) 
Seat 4: Mr_Giiba (5110 in chips) 
Seat 5: mario342 (5260 in chips) 
Seat 6: MON3Y$HOT (4990 in chips) 
Seat 7: hyratsch (4870 in chips) 
Seat 8: vaggelis1982 (4990 in chips) 
Seat 9: kafu123 (4990 in chips) is sitting out
Shiryu100: posts the ante 5
nico122527: posts the ante 5
ilico: posts the ante 5
Mr_Giiba: posts the ante 5
mario342: posts the ante 5
MON3Y$HOT: posts the ante 5
hyratsch: posts the ante 5
vaggelis1982: posts the ante 5
kafu123: posts the ante 5
Mr_Giiba: posts small blind 15
mario342: posts big blind 30
*** HOLE CARDS ***
MON3Y$HOT: folds 
hyratsch: folds 
vaggelis1982: folds 
kafu123: folds 
Shiryu100: folds 
nico122527: folds 
ilico: folds 
Mr_Giiba: raises 30 to 60
mario342: raises 420 to 480
Mr_Giiba: folds 
Uncalled bet (420) returned to mario342
mario342 collected 165 from pot
mario342: doesn't show hand 
*** SUMMARY ***
Total pot 165 | Rake 0 
Seat 1: Shiryu100 folded before Flop (didn't bet)
Seat 2: nico122527 folded before Flop (didn't bet)
Seat 3: ilico (button) folded before Flop (didn't bet)
Seat 4: Mr_Giiba (small blind) folded before Flop
Seat 5: mario342 (big blind) collected (165)
Seat 6: MON3Y$HOT folded before Flop (didn't bet)
Seat 7: hyratsch folded before Flop (didn't bet)
Seat 8: vaggelis1982 folded before Flop (didn't bet)
Seat 9: kafu123 folded before Flop (didn't bet)



PokerStars Hand #157575130848: Tournament #1641817620, $7.50+$7.50+$1.50 USD Hold'em No Limit - Level I (15/30) - 2016/08/21 18:31:57 ET
Table '1641817620 61' 9-max Seat #3 is the button
Seat 1: talga421 (4218 in chips) 
Seat 2: evgenia19591 (4900 in chips) 
Seat 3: ElliNelly (5972 in chips) 
Seat 4: Adso139 (5000 in chips) out of hand (moved from another table into small blind)
Seat 5: sasha.yush (4960 in chips) 
Seat 6: houtenboog (4990 in chips) 
Seat 7: setarcos1234 (4990 in chips) 
Seat 8: Dan Mimar (5075 in chips) 
Seat 9: vininicolato (4900 in chips) 
talga421: posts the ante 5
evgenia19591: posts the ante 5
ElliNelly: posts the ante 5
sasha.yush: posts the ante 5
houtenboog: posts the ante 5
setarcos1234: posts the ante 5
Dan Mimar: posts the ante 5
vininicolato: posts the ante 5
sasha.yush: posts small blind 15
houtenboog: posts big blind 30
*** HOLE CARDS ***
setarcos1234: folds 
Dan Mimar: calls 30
vininicolato: raises 90 to 120
talga421: folds 
evgenia19591: folds 
ElliNelly: calls 120
sasha.yush: folds 
houtenboog: calls 90
Dan Mimar: calls 90
*** FLOP *** [5h 9h Ah]
houtenboog: checks 
Dan Mimar: checks 
vininicolato: checks 
ElliNelly: bets 535
houtenboog: folds 
Dan Mimar: calls 535
vininicolato: folds 
*** TURN *** [5h 9h Ah] [4s]
Dan Mimar: bets 810
ElliNelly: raises 810 to 1620
Dan Mimar: calls 810
*** RIVER *** [5h 9h Ah 4s] [6h]
Dan Mimar: checks 
ElliNelly: bets 3692 and is all-in
Dan Mimar: calls 2795 and is all-in
Uncalled bet (897) returned to ElliNelly
*** SHOW DOWN ***
ElliNelly: shows [Ad Qh] (a flush, Ace high)
Dan Mimar: shows [8h Th] (a flush, Ace high - lower cards)
ElliNelly collected 10435 from pot
ElliNelly wins $3.75 for eliminating Dan Mimar and their own bounty increases by $3.75 to $11.25
Dan Mimar finished the tournament in 999999992nd place
*** SUMMARY ***
Total pot 10435 | Rake 0 
Board [5h 9h Ah 4s 6h]
Seat 1: talga421 folded before Flop (didn't bet)
Seat 2: evgenia19591 folded before Flop (didn't bet)
Seat 3: ElliNelly (button) showed [Ad Qh] and won (10435) with a flush, Ace high
Seat 5: sasha.yush (small blind) folded before Flop
Seat 6: houtenboog (big blind) folded on the Flop
Seat 7: setarcos1234 folded before Flop (didn't bet)
Seat 8: Dan Mimar showed [8h Th] and lost with a flush, Ace high
Seat 9: vininicolato folded on the Flop



PokerStars Hand #157575130952: Tournament #1641817620, $7.50+$7.50+$1.50 USD Hold'em No Limit - Level I (15/30) - 2016/08/21 18:31:58 ET
Table '1641817620 33' 9-max Seat #5 is the button
Seat 1: fungyou (4985 in chips) 
Seat 2: titauhu (4970 in chips) is sitting out
Seat 3: gmdef.2001 (4940 in chips) 
Seat 4: natahha_92 (5000 in chips) 
Seat 5: T@keItDown (5025 in chips) 
Seat 6: REPPARTFLOW (4955 in chips) 
Seat 7: dennismitru (5075 in chips) 
Seat 8: Joao Valli (4985 in chips) 
Seat 9: Pablos701 (5070 in chips) 
fungyou: posts the ante 5
titauhu: posts the ante 5
gmdef.2001: posts the ante 5
natahha_92: posts the ante 5
T@keItDown: posts the ante 5
REPPARTFLOW: posts the ante 5
dennismitru: posts the ante 5
Joao Valli: posts the ante 5
Pablos701: posts the ante 5
REPPARTFLOW: posts small blind 15
dennismitru: posts big blind 30
*** HOLE CARDS ***
Joao Valli: folds 
Pablos701: folds 
fungyou: folds 
titauhu: folds 
gmdef.2001: folds 
natahha_92: folds 
T@keItDown: folds 
REPPARTFLOW: folds 
Uncalled bet (15) returned to dennismitru
dennismitru collected 75 from pot
*** SUMMARY ***
Total pot 75 | Rake 0 
Seat 1: fungyou folded before Flop (didn't bet)
Seat 2: titauhu folded before Flop (didn't bet)
Seat 3: gmdef.2001 folded before Flop (didn't bet)
Seat 4: natahha_92 folded before Flop (didn't bet)
Seat 5: T@keItDown (button) folded before Flop (didn't bet)
Seat 6: REPPARTFLOW (small blind) folded before Flop
Seat 7: dennismitru (big blind) collected (75)
Seat 8: Joao Valli folded before Flop (didn't bet)
Seat 9: Pablos701 folded before Flop (didn't bet)



PokerStars Hand #157575131072: Tournament #1641817620, $7.50+$7.50+$1.50 USD Hold'em No Limit - Level I (15/30) - 2016/08/21 18:31:58 ET
Table '1641817620 29' 9-max Seat #3 is the button
Seat 1: kidpokerjm89 (4990 in chips) 
Seat 2: niejowicz (4975 in chips) 
Seat 3: Ofbravetight (4945 in chips) 
Seat 4: Ottel (4180 in chips) 
Seat 5: puntoo (5950 in chips) 
Seat 6: Melady77777 (4990 in chips) 
Seat 7: fishfind000 (4990 in chips) 
Seat 8: AcePheres (4990 in chips) 
Seat 9: LAZO30 (4990 in chips) 
kidpokerjm89: posts the ante 5
niejowicz: posts the ante 5
Ofbravetight: posts the ante 5
Ottel: posts the ante 5
puntoo: posts the ante 5
Melady77777: posts the ante 5
fishfind000: posts the ante 5
AcePheres: posts the ante 5
LAZO30: posts the ante 5
Ottel: posts small blind 15
puntoo: posts big blind 30
*** HOLE CARDS ***
Melady77777: folds 
fishfind000: raises 120 to 150
AcePheres: folds 
LAZO30: folds 
kidpokerjm89: folds 
niejowicz: folds 
Ofbravetight: folds 
Ottel: folds 
puntoo: folds 
Uncalled bet (120) returned to fishfind000
fishfind000 collected 120 from pot
fishfind000: doesn't show hand 
*** SUMMARY ***
Total pot 120 | Rake 0 
Seat 1: kidpokerjm89 folded before Flop (didn't bet)
Seat 2: niejowicz folded before Flop (didn't bet)
Seat 3: Ofbravetight (button) folded before Flop (didn't bet)
Seat 4: Ottel (small blind) folded before Flop
Seat 5: puntoo (big blind) folded before Flop
Seat 6: Melady77777 folded before Flop (didn't bet)
Seat 7: fishfind000 collected (120)
Seat 8: AcePheres folded before Flop (didn't bet)
Seat 9: LAZO30 folded before Flop (didn't bet)



PokerStars Hand #157575132112: Tournament #1641817620, $7.50+$7.50+$1.50 USD Hold'em No Limit - Level I (15/30) - 2016/08/21 18:31:59 ET
Table '1641817620 49' 9-max Seat #2 is the button
Seat 1: Mi2xa (4995 in chips) 
Seat 2: abig89 (5594 in chips) 
Seat 3: nickviso (4965 in chips) 
Seat 5: Can'tStopMee (4995 in chips) 
Seat 6: PaulDaPole (4995 in chips) 
Seat 7: Prebendk (4733 in chips) 
Seat 8: VixenKoala (4995 in chips) 
Seat 9: logos1428 (4733 in chips) 
Mi2xa: posts the ante 5
abig89: posts the ante 5
nickviso: posts the ante 5
Can'tStopMee: posts the ante 5
PaulDaPole: posts the ante 5
Prebendk: posts the ante 5
VixenKoala: posts the ante 5
logos1428: posts the ante 5
nickviso: posts small blind 15
Can'tStopMee: posts big blind 30
*** HOLE CARDS ***
PaulDaPole: raises 60 to 90
Prebendk: calls 90
VixenKoala: folds 
logos1428: folds 
Mi2xa: folds 
abig89: folds 
nickviso: folds 
Can'tStopMee: folds 
*** FLOP *** [Ad Ts 2d]
PaulDaPole: bets 138
Prebendk: calls 138
*** TURN *** [Ad Ts 2d] [9c]
PaulDaPole: checks 
Prebendk: bets 270
PaulDaPole: calls 270
*** RIVER *** [Ad Ts 2d 9c] [Jd]
PaulDaPole: checks 
Prebendk: bets 540
PaulDaPole: calls 540
*** SHOW DOWN ***
Prebendk: shows [Kd Jc] (a pair of Jacks)
PaulDaPole: shows [8c 7c] (a straight, Seven to Jack)
PaulDaPole collected 2161 from pot
*** SUMMARY ***
Total pot 2161 | Rake 0 
Board [Ad Ts 2d 9c Jd]
Seat 1: Mi2xa folded before Flop (didn't bet)
Seat 2: abig89 (button) folded before Flop (didn't bet)
Seat 3: nickviso (small blind) folded before Flop
Seat 5: Can'tStopMee (big blind) folded before Flop
Seat 6: PaulDaPole showed [8c 7c] and won (2161) with a straight, Seven to Jack
Seat 7: Prebendk showed [Kd Jc] and lost with a pair of Jacks
Seat 8: VixenKoala folded before Flop (didn't bet)
Seat 9: logos1428 folded before Flop (didn't bet)



PokerStars Hand #157575132195: Tournament #1641817620, $7.50+$7.50+$1.50 USD Hold'em No Limit - Level I (15/30) - 2016/08/21 18:31:59 ET
Table '1641817620 26' 9-max Seat #3 is the button
Seat 1: duplo1182 (4990 in chips) 
Seat 2: Heretic66688 (4975 in chips) 
Seat 3: Axkj (4945 in chips) 
Seat 4: h1per1on (4960 in chips) 
Seat 6: Archibal_17 (4780 in chips) 
Seat 7: GDLW26 (4990 in chips) 
Seat 8: LongTermTILT (5380 in chips) 
Seat 9: danius111 (5140 in chips) 
duplo1182: posts the ante 5
Heretic66688: posts the ante 5
Axkj: posts the ante 5
h1per1on: posts the ante 5
Archibal_17: posts the ante 5
GDLW26: posts the ante 5
LongTermTILT: posts the ante 5
danius111: posts the ante 5
h1per1on: posts small blind 15
Archibal_17: posts big blind 30
*** HOLE CARDS ***
GDLW26: folds 
LongTermTILT: folds 
danius111: raises 30 to 60
duplo1182: folds 
Heretic66688: folds 
Axkj: folds 
h1per1on: folds 
Archibal_17: folds 
Uncalled bet (30) returned to danius111
danius111 collected 115 from pot
danius111: doesn't show hand 
*** SUMMARY ***
Total pot 115 | Rake 0 
Seat 1: duplo1182 folded before Flop (didn't bet)
Seat 2: Heretic66688 folded before Flop (didn't bet)
Seat 3: Axkj (button) folded before Flop (didn't bet)
Seat 4: h1per1on (small blind) folded before Flop
Seat 6: Archibal_17 (big blind) folded before Flop
Seat 7: GDLW26 folded before Flop (didn't bet)
Seat 8: LongTermTILT folded before Flop (didn't bet)
Seat 9: danius111 collected (115)



PokerStars Hand #157575132346: Tournament #1641817620, $7.50+$7.50+$1.50 USD Hold'em No Limit - Level I (15/30) - 2016/08/21 18:32:00 ET
Table '1641817620 25' 9-max Seat #4 is the button
Seat 1: MoW3R (4985 in chips) 
Seat 2: pirus157 (5390 in chips) 
Seat 3: MaxBracht (4880 in chips) 
Seat 4: Rex Nelson (4940 in chips) 
Seat 5: ArKip (4955 in chips) 
Seat 7: AAnaKKonda (4985 in chips) 
Seat 8: Mad Dionysus (4985 in chips) 
Seat 9: IwillCall3 (4895 in chips) 
MoW3R: posts the ante 5
pirus157: posts the ante 5
MaxBracht: posts the ante 5
Rex Nelson: posts the ante 5
ArKip: posts the ante 5
AAnaKKonda: posts the ante 5
Mad Dionysus: posts the ante 5
IwillCall3: posts the ante 5
ArKip: posts small blind 15
AAnaKKonda: posts big blind 30
*** HOLE CARDS ***
Mad Dionysus: folds 
IwillCall3: folds 
MoW3R: folds 
pirus157: folds 
MaxBracht: folds 
Rex Nelson: raises 60 to 90
ArKip: folds 
AAnaKKonda: folds 
Uncalled bet (60) returned to Rex Nelson
Rex Nelson collected 115 from pot
*** SUMMARY ***
Total pot 115 | Rake 0 
Seat 1: MoW3R folded before Flop (didn't bet)
Seat 2: pirus157 folded before Flop (didn't bet)
Seat 3: MaxBracht folded before Flop (didn't bet)
Seat 4: Rex Nelson (button) collected (115)
Seat 5: ArKip (small blind) folded before Flop
Seat 7: AAnaKKonda (big blind) folded before Flop
Seat 8: Mad Dionysus folded before Flop (didn't bet)
Seat 9: IwillCall3 folded before Flop (didn't bet)



PokerStars Hand #157575133020: Tournament #1641817620, $7.50+$7.50+$1.50 USD Hold'em No Limit - Level I (15/30) - 2016/08/21 18:32:01 ET
Table '1641817620 15' 9-max Seat #3 is the button
Seat 1: WRussia (4810 in chips) 
Seat 2: miche1301 (4975 in chips) 
Seat 3: tsolias87 (4945 in chips) 
Seat 4: daveholden4 (5000 in chips) out of hand (moved from another table into small blind)
Seat 5: mdf92 (4900 in chips) 
Seat 7: Yokiro (4990 in chips) 
Seat 8: Rob.nl (4720 in chips) 
Seat 9: mfalmeidacs (5440 in chips) 
WRussia: posts the ante 5
miche1301: posts the ante 5
tsolias87: posts the ante 5
mdf92: posts the ante 5
Yokiro: posts the ante 5
Rob.nl: posts the ante 5
mfalmeidacs: posts the ante 5
mdf92: posts small blind 15
Yokiro: posts big blind 30
*** HOLE CARDS ***
Rob.nl: folds 
mfalmeidacs: folds 
WRussia: folds 
miche1301: raises 60 to 90
tsolias87: folds 
mdf92: calls 75
Yokiro: calls 60
*** FLOP *** [5c 8d Kd]
mdf92: checks 
Yokiro: checks 
miche1301: bets 210
mdf92: calls 210
Yokiro: calls 210
*** TURN *** [5c 8d Kd] [4s]
mdf92: checks 
Yokiro: checks 
miche1301: bets 570
mdf92: folds 
Yokiro: folds 
Uncalled bet (570) returned to miche1301
miche1301 collected 935 from pot
miche1301: doesn't show hand 
*** SUMMARY ***
Total pot 935 | Rake 0 
Board [5c 8d Kd 4s]
Seat 1: WRussia folded before Flop (didn't bet)
Seat 2: miche1301 collected (935)
Seat 3: tsolias87 (button) folded before Flop (didn't bet)
Seat 5: mdf92 (small blind) folded on the Turn
Seat 7: Yokiro (big blind) folded on the Turn
Seat 8: Rob.nl folded before Flop (didn't bet)
Seat 9: mfalmeidacs folded before Flop (didn't bet)



PokerStars Hand #157575134969: Tournament #1641817620, $7.50+$7.50+$1.50 USD Hold'em No Limit - Level I (15/30) - 2016/08/21 18:32:04 ET
Table '1641817620 4' 9-max Seat #2 is the button
Seat 1: coldboy23 (4995 in chips) 
Seat 2: Velho Sábio (4980 in chips) 
Seat 3: manukk2 (4605 in chips) 
Seat 4: slk55amg (4605 in chips) 
Seat 5: sica26 (4995 in chips) 
Seat 7: AleksZy (4995 in chips) 
Seat 8: petersonmach (4995 in chips) 
Seat 9: DagobertQuad (4995 in chips) 
coldboy23: posts the ante 5
Velho Sábio: posts the ante 5
manukk2: posts the ante 5
slk55amg: posts the ante 5
sica26: posts the ante 5
AleksZy: posts the ante 5
petersonmach: posts the ante 5
DagobertQuad: posts the ante 5
manukk2: posts small blind 15
slk55amg: posts big blind 30
*** HOLE CARDS ***
sica26: raises 43 to 73
AleksZy: folds 
petersonmach: folds 
DagobertQuad: calls 73
coldboy23: calls 73
Velho Sábio: calls 73
manukk2: folds 
slk55amg: calls 43
*** FLOP *** [4h Ah 5c]
slk55amg: checks 
sica26: bets 189
DagobertQuad: folds 
coldboy23: folds 
Velho Sábio: folds 
slk55amg: folds 
Uncalled bet (189) returned to sica26
sica26 collected 420 from pot
sica26: doesn't show hand 
*** SUMMARY ***
Total pot 420 | Rake 0 
Board [4h Ah 5c]
Seat 1: coldboy23 folded on the Flop
Seat 2: Velho Sábio (button) folded on the Flop
Seat 3: manukk2 (small blind) folded before Flop
Seat 4: slk55amg (big blind) folded on the Flop
Seat 5: sica26 collected (420)
Seat 7: AleksZy folded before Flop (didn't bet)
Seat 8: petersonmach folded before Flop (didn't bet)
Seat 9: DagobertQuad folded on the Flop



PokerStars Hand #157575135814: Tournament #1641817620, $7.50+$7.50+$1.50 USD Hold'em No Limit - Level I (15/30) - 2016/08/21 18:32:05 ET
Table '1641817620 34' 9-max Seat #3 is the button
Seat 1: Zukertort (4990 in chips) is sitting out
Seat 2: AngelBerley (4975 in chips) 
Seat 3: Zigslick (4945 in chips) 
Seat 4: Snabers (4960 in chips) 
Seat 5: juggaletto (4900 in chips) 
Seat 6: virtus213 (4915 in chips) 
Seat 7: Poher42 (4990 in chips) 
Seat 8: S.FILTH (4990 in chips) 
Seat 9: omar miete (5335 in chips) 
Zukertort: posts the ante 5
AngelBerley: posts the ante 5
Zigslick: posts the ante 5
Snabers: posts the ante 5
juggaletto: posts the ante 5
virtus213: posts the ante 5
Poher42: posts the ante 5
S.FILTH: posts the ante 5
omar miete: posts the ante 5
Snabers: posts small blind 15
juggaletto: posts big blind 30
*** HOLE CARDS ***
virtus213: folds 
Poher42: raises 30 to 60
S.FILTH: folds 
omar miete: folds 
Zukertort: folds 
AngelBerley: folds 
Zigslick: folds 
Snabers: calls 45
juggaletto: calls 30
*** FLOP *** [Ah 4c Kc]
Snabers: checks 
juggaletto: bets 60
Poher42: calls 60
Snabers: calls 60
*** TURN *** [Ah 4c Kc] [4h]
Snabers: checks 
juggaletto: checks 
Poher42: checks 
*** RIVER *** [Ah 4c Kc 4h] [Ad]
Snabers: checks 
juggaletto: checks 
Poher42: checks 
*** SHOW DOWN ***
Snabers: shows [Jc 9c] (two pair, Aces and Fours)
juggaletto: shows [Qs Jh] (two pair, Aces and Fours)
Poher42: shows [5d 5c] (two pair, Aces and Fives)
Poher42 collected 405 from pot
*** SUMMARY ***
Total pot 405 | Rake 0 
Board [Ah 4c Kc 4h Ad]
Seat 1: Zukertort folded before Flop (didn't bet)
Seat 2: AngelBerley folded before Flop (didn't bet)
Seat 3: Zigslick (button) folded before Flop (didn't bet)
Seat 4: Snabers (small blind) showed [Jc 9c] and lost with two pair, Aces and Fours
Seat 5: juggaletto (big blind) showed [Qs Jh] and lost with two pair, Aces and Fours
Seat 6: virtus213 folded before Flop (didn't bet)
Seat 7: Poher42 showed [5d 5c] and won (405) with two pair, Aces and Fives
Seat 8: S.FILTH folded before Flop (didn't bet)
Seat 9: omar miete folded before Flop (didn't bet)



PokerStars Hand #157575136390: Tournament #1641817620, $7.50+$7.50+$1.50 USD Hold'em No Limit - Level I (15/30) - 2016/08/21 18:32:06 ET
Table '1641817620 59' 9-max Seat #3 is the button
Seat 1: pitoco2012 (4990 in chips) 
Seat 2: M_ORBIT_M (4975 in chips) 
Seat 3: alemaowe (4945 in chips) 
Seat 4: jan monster (4559 in chips) 
Seat 5: laiyitui (4990 in chips) 
Seat 6: stilio_al (4990 in chips) 
Seat 7: 88Xin88 (5080 in chips) 
Seat 8: Enio Pinho (5547 in chips) 
Seat 9: Robsn087 (4924 in chips) 
pitoco2012: posts the ante 5
M_ORBIT_M: posts the ante 5
alemaowe: posts the ante 5
jan monster: posts the ante 5
laiyitui: posts the ante 5
stilio_al: posts the ante 5
88Xin88: posts the ante 5
Enio Pinho: posts the ante 5
Robsn087: posts the ante 5
jan monster: posts small blind 15
laiyitui: posts big blind 30
*** HOLE CARDS ***
stilio_al: folds 
88Xin88: folds 
Enio Pinho: folds 
Robsn087: folds 
pitoco2012: calls 30
M_ORBIT_M: folds 
alemaowe: folds 
jan monster: folds 
laiyitui: checks 
*** FLOP *** [2c 6c 6s]
laiyitui: checks 
pitoco2012: checks 
*** TURN *** [2c 6c 6s] [4h]
laiyitui: bets 60
pitoco2012: raises 60 to 120
laiyitui: folds 
Uncalled bet (60) returned to pitoco2012
pitoco2012 collected 240 from pot
pitoco2012: doesn't show hand 
*** SUMMARY ***
Total pot 240 | Rake 0 
Board [2c 6c 6s 4h]
Seat 1: pitoco2012 collected (240)
Seat 2: M_ORBIT_M folded before Flop (didn't bet)
Seat 3: alemaowe (button) folded before Flop (didn't bet)
Seat 4: jan monster (small blind) folded before Flop
Seat 5: laiyitui (big blind) folded on the Turn
Seat 6: stilio_al folded before Flop (didn't bet)
Seat 7: 88Xin88 folded before Flop (didn't bet)
Seat 8: Enio Pinho folded before Flop (didn't bet)
Seat 9: Robsn087 folded before Flop (didn't bet)



PokerStars Hand #157575136405: Tournament #1641817620, $7.50+$7.50+$1.50 USD Hold'em No Limit - Level I (15/30) - 2016/08/21 18:32:06 ET
Table '1641817620 8' 9-max Seat #4 is the button
Seat 1: inkjoh (5070 in chips) 
Seat 2: MarcosCLMO (4632 in chips) 
Seat 3: HundTore (5363 in chips) 
Seat 4: Kamikase1805 (5030 in chips) 
Seat 5: younesch (4965 in chips) 
Seat 6: spinne1109 (5000 in chips) 
Seat 7: pavaopics (4985 in chips) 
Seat 8: FastEdiddy (4985 in chips) 
Seat 9: Pokerofwind (4985 in chips) 
inkjoh: posts the ante 5
MarcosCLMO: posts the ante 5
HundTore: posts the ante 5
Kamikase1805: posts the ante 5
younesch: posts the ante 5
spinne1109: posts the ante 5
pavaopics: posts the ante 5
FastEdiddy: posts the ante 5
Pokerofwind: posts the ante 5
younesch: posts small blind 15
spinne1109: posts big blind 30
*** HOLE CARDS ***
pavaopics: folds 
FastEdiddy: folds 
Pokerofwind: folds 
inkjoh: folds 
MarcosCLMO: folds 
HundTore: raises 42 to 72
Kamikase1805: folds 
younesch: calls 57
spinne1109: folds 
*** FLOP *** [2h 4h 3d]
younesch: bets 90
HundTore: calls 90
*** TURN *** [2h 4h 3d] [Ks]
younesch: checks 
HundTore: bets 195
younesch: calls 195
*** RIVER *** [2h 4h 3d Ks] [Th]
younesch: checks 
HundTore: bets 386
younesch: folds 
Uncalled bet (386) returned to HundTore
HundTore collected 789 from pot
HundTore: doesn't show hand 
*** SUMMARY ***
Total pot 789 | Rake 0 
Board [2h 4h 3d Ks Th]
Seat 1: inkjoh folded before Flop (didn't bet)
Seat 2: MarcosCLMO folded before Flop (didn't bet)
Seat 3: HundTore collected (789)
Seat 4: Kamikase1805 (button) folded before Flop (didn't bet)
Seat 5: younesch (small blind) folded on the River
Seat 6: spinne1109 (big blind) folded before Flop
Seat 7: pavaopics folded before Flop (didn't bet)
Seat 8: FastEdiddy folded before Flop (didn't bet)
Seat 9: Pokerofwind folded before Flop (didn't bet)



PokerStars Hand #157575136519: Tournament #1641817620, $7.50+$7.50+$1.50 USD Hold'em No Limit - Level I (15/30) - 2016/08/21 18:32:06 ET
Table '1641817620 20' 9-max Seat #2 is the button
Seat 1: Showdown pl (4995 in chips) 
Seat 2: tomus_ero (4980 in chips) 
Seat 3: Tiffany8888 (4965 in chips) 
Seat 4: brainpleaser (4473 in chips) 
Seat 5: msantos0123 (4995 in chips) 
Seat 6: TuckYouIn (4845 in chips) 
Seat 7: anniczka (6279 in chips) 
Seat 8: profChaos780 (4473 in chips) 
Seat 9: chezzetcook2 (4995 in chips) 
Showdown pl: posts the ante 5
tomus_ero: posts the ante 5
Tiffany8888: posts the ante 5
brainpleaser: posts the ante 5
msantos0123: posts the ante 5
TuckYouIn: posts the ante 5
anniczka: posts the ante 5
profChaos780: posts the ante 5
chezzetcook2: posts the ante 5
Tiffany8888: posts small blind 15
brainpleaser: posts big blind 30
*** HOLE CARDS ***
msantos0123: folds 
TuckYouIn: raises 45 to 75
anniczka: folds 
profChaos780: folds 
chezzetcook2: calls 75
Showdown pl: folds 
tomus_ero: raises 105 to 180
Tiffany8888: calls 165
brainpleaser: calls 150
TuckYouIn: calls 105
chezzetcook2: calls 105
*** FLOP *** [Ts Ah 6d]
Tiffany8888: checks 
brainpleaser: checks 
TuckYouIn: checks 
chezzetcook2: checks 
tomus_ero: bets 387
Tiffany8888: folds 
brainpleaser: folds 
TuckYouIn: folds 
chezzetcook2: calls 387
*** TURN *** [Ts Ah 6d] [7s]
chezzetcook2: checks 
tomus_ero: checks 
*** RIVER *** [Ts Ah 6d 7s] [7d]
chezzetcook2: checks 
tomus_ero: bets 704
chezzetcook2: calls 704
anniczka is disconnected 
*** SHOW DOWN ***
tomus_ero: shows [Qd Qc] (two pair, Queens and Sevens)
chezzetcook2: mucks hand 
tomus_ero collected 3127 from pot
*** SUMMARY ***
Total pot 3127 | Rake 0 
Board [Ts Ah 6d 7s 7d]
Seat 1: Showdown pl folded before Flop (didn't bet)
Seat 2: tomus_ero (button) showed [Qd Qc] and won (3127) with two pair, Queens and Sevens
Seat 3: Tiffany8888 (small blind) folded on the Flop
Seat 4: brainpleaser (big blind) folded on the Flop
Seat 5: msantos0123 folded before Flop (didn't bet)
Seat 6: TuckYouIn folded on the Flop
Seat 7: anniczka folded before Flop (didn't bet)
Seat 8: profChaos780 folded before Flop (didn't bet)
Seat 9: chezzetcook2 mucked



PokerStars Hand #157575138578: Tournament #1641817620, $7.50+$7.50+$1.50 USD Hold'em No Limit - Level I (15/30) - 2016/08/21 18:32:09 ET
Table '1641817620 16' 9-max Seat #3 is the button
Seat 1: Kugelbohne79 (4990 in chips) 
Seat 2: Sergei0384 (5101 in chips) 
Seat 3: paschalisbg (4945 in chips) 
Seat 4: Maisiewin (4864 in chips) 
Seat 5: alemaozl (4990 in chips) 
Seat 6: malenkaya17 (4990 in chips) 
Seat 7: burton14 (4990 in chips) 
Seat 8: Miky_Man993 (4930 in chips) 
Seat 9: ziboin (5200 in chips) 
Kugelbohne79: posts the ante 5
Sergei0384: posts the ante 5
paschalisbg: posts the ante 5
Maisiewin: posts the ante 5
alemaozl: posts the ante 5
malenkaya17: posts the ante 5
burton14: posts the ante 5
Miky_Man993: posts the ante 5
ziboin: posts the ante 5
Maisiewin: posts small blind 15
alemaozl: posts big blind 30
*** HOLE CARDS ***
malenkaya17: folds 
burton14: folds 
Miky_Man993: folds 
ziboin: folds 
Kugelbohne79: raises 120 to 150
Sergei0384: folds 
paschalisbg: folds 
Maisiewin: folds 
alemaozl: folds 
Uncalled bet (120) returned to Kugelbohne79
Kugelbohne79 collected 120 from pot
Kugelbohne79: doesn't show hand 
*** SUMMARY ***
Total pot 120 | Rake 0 
Seat 1: Kugelbohne79 collected (120)
Seat 2: Sergei0384 folded before Flop (didn't bet)
Seat 3: paschalisbg (button) folded before Flop (didn't bet)
Seat 4: Maisiewin (small blind) folded before Flop
Seat 5: alemaozl (big blind) folded before Flop
Seat 6: malenkaya17 folded before Flop (didn't bet)
Seat 7: burton14 folded before Flop (didn't bet)
Seat 8: Miky_Man993 folded before Flop (didn't bet)
Seat 9: ziboin folded before Flop (didn't bet)



PokerStars Hand #157575138728: Tournament #1641817620, $7.50+$7.50+$1.50 USD Hold'em No Limit - Level I (15/30) - 2016/08/21 18:32:09 ET
Table '1641817620 58' 9-max Seat #2 is the button
Seat 1: bld66 (4665 in chips) 
Seat 2: FACEBUHH (4875 in chips) 
Seat 3: CFgabriel (4965 in chips) 
Seat 4: nejirose (4995 in chips) 
Seat 5: pokercr7721 (4995 in chips) 
Seat 6: verdao134 (4995 in chips) 
Seat 7: I_R0B0T_90 (4995 in chips) 
Seat 8: lovebigpairs (4995 in chips) 
Seat 9: binho1806 (5520 in chips) 
bld66: posts the ante 5
FACEBUHH: posts the ante 5
CFgabriel: posts the ante 5
nejirose: posts the ante 5
pokercr7721: posts the ante 5
verdao134: posts the ante 5
I_R0B0T_90: posts the ante 5
lovebigpairs: posts the ante 5
binho1806: posts the ante 5
CFgabriel: posts small blind 15
nejirose: posts big blind 30
*** HOLE CARDS ***
pokercr7721: folds 
verdao134: folds 
I_R0B0T_90: folds 
lovebigpairs: raises 120 to 150
binho1806: folds 
bld66: folds 
FACEBUHH: calls 150
CFgabriel: folds 
nejirose: folds 
*** FLOP *** [Qc As Qh]
lovebigpairs: checks 
FACEBUHH: bets 180
lovebigpairs: calls 180
*** TURN *** [Qc As Qh] [6c]
lovebigpairs: checks 
FACEBUHH: bets 330
lovebigpairs: calls 330
*** RIVER *** [Qc As Qh 6c] [6s]
lovebigpairs: checks 
FACEBUHH: bets 1620
lovebigpairs: calls 1620
*** SHOW DOWN ***
FACEBUHH: shows [Kc Qs] (a full house, Queens full of Sixes)
lovebigpairs: mucks hand 
FACEBUHH collected 4650 from pot
*** SUMMARY ***
Total pot 4650 | Rake 0 
Board [Qc As Qh 6c 6s]
Seat 1: bld66 folded before Flop (didn't bet)
Seat 2: FACEBUHH (button) showed [Kc Qs] and won (4650) with a full house, Queens full of Sixes
Seat 3: CFgabriel (small blind) folded before Flop
Seat 4: nejirose (big blind) folded before Flop
Seat 5: pokercr7721 folded before Flop (didn't bet)
Seat 6: verdao134 folded before Flop (didn't bet)
Seat 7: I_R0B0T_90 folded before Flop (didn't bet)
Seat 8: lovebigpairs mucked
Seat 9: binho1806 folded before Flop (didn't bet)



PokerStars Hand #157575139527: Tournament #1641817620, $7.50+$7.50+$1.50 USD Hold'em No Limit - Level I (15/30) - 2016/08/21 18:32:11 ET
Table '1641817620 31' 9-max Seat #3 is the button
Seat 1: JmanRz (4930 in chips) 
Seat 2: Esp2011 (4776 in chips) 
Seat 3: karanikolass (5189 in chips) 
Seat 4: Famzinha10 (5000 in chips) out of hand (moved from another table into small blind)
Seat 5: jucielitheco (4960 in chips) 
Seat 6: Ant_md (5180 in chips) 
Seat 7: fkamus (4990 in chips) 
Seat 8: RENA79 (4990 in chips) 
Seat 9: Jack.Siete (4990 in chips) 
JmanRz: posts the ante 5
Esp2011: posts the ante 5
karanikolass: posts the ante 5
jucielitheco: posts the ante 5
Ant_md: posts the ante 5
fkamus: posts the ante 5
RENA79: posts the ante 5
Jack.Siete: posts the ante 5
jucielitheco: posts small blind 15
Ant_md: posts big blind 30
*** HOLE CARDS ***
fkamus: folds 
RENA79: folds 
Jack.Siete: folds 
JmanRz: raises 39 to 69
Esp2011: calls 69
karanikolass: folds 
jucielitheco: folds 
Ant_md: folds 
*** FLOP *** [6d Qh Th]
JmanRz: bets 102
Esp2011: folds 
Uncalled bet (102) returned to JmanRz
JmanRz collected 223 from pot
*** SUMMARY ***
Total pot 223 | Rake 0 
Board [6d Qh Th]
Seat 1: JmanRz collected (223)
Seat 2: Esp2011 folded on the Flop
Seat 3: karanikolass (button) folded before Flop (didn't bet)
Seat 5: jucielitheco (small blind) folded before Flop
Seat 6: Ant_md (big blind) folded before Flop
Seat 7: fkamus folded before Flop (didn't bet)
Seat 8: RENA79 folded before Flop (didn't bet)
Seat 9: Jack.Siete folded before Flop (didn't bet)



PokerStars Hand #157575139871: Tournament #1641817620, $7.50+$7.50+$1.50 USD Hold'em No Limit - Level I (15/30) - 2016/08/21 18:32:11 ET
Table '1641817620 3' 9-max Seat #4 is the button
Seat 1: IwantplayNL (4985 in chips) 
Seat 2: dufino (7361 in chips) 
Seat 3: zIggY-7-rAc3 (4940 in chips) 
Seat 4: gerald0jr (4940 in chips) 
Seat 5: Arkadius1975 (5000 in chips) out of hand (moved from another table into small blind)
Seat 6: BrunoCastroR (2925 in chips) 
Seat 7: alehirazawa (4985 in chips) 
Seat 8: markosharko (4889 in chips) 
Seat 9: VictorZh14 (4985 in chips) 
IwantplayNL: posts the ante 5
dufino: posts the ante 5
zIggY-7-rAc3: posts the ante 5
gerald0jr: posts the ante 5
BrunoCastroR: posts the ante 5
alehirazawa: posts the ante 5
markosharko: posts the ante 5
VictorZh14: posts the ante 5
BrunoCastroR: posts small blind 15
alehirazawa: posts big blind 30
*** HOLE CARDS ***
markosharko: raises 33 to 63
VictorZh14: folds 
IwantplayNL: raises 87 to 150
dufino: folds 
zIggY-7-rAc3: folds 
gerald0jr: folds 
BrunoCastroR: folds 
alehirazawa: folds 
markosharko: raises 312 to 462
IwantplayNL: calls 312
*** FLOP *** [2c 3d 6h]
markosharko: bets 484
IwantplayNL: folds 
Uncalled bet (484) returned to markosharko
markosharko collected 1009 from pot
markosharko: doesn't show hand 
*** SUMMARY ***
Total pot 1009 | Rake 0 
Board [2c 3d 6h]
Seat 1: IwantplayNL folded on the Flop
Seat 2: dufino folded before Flop (didn't bet)
Seat 3: zIggY-7-rAc3 folded before Flop (didn't bet)
Seat 4: gerald0jr (button) folded before Flop (didn't bet)
Seat 6: BrunoCastroR (small blind) folded before Flop
Seat 7: alehirazawa (big blind) folded before Flop
Seat 8: markosharko collected (1009)
Seat 9: VictorZh14 folded before Flop (didn't bet)



PokerStars Hand #157575140029: Tournament #1641817620, $7.50+$7.50+$1.50 USD Hold'em No Limit - Level I (15/30) - 2016/08/21 18:32:11 ET
Table '1641817620 60' 9-max Seat #2 is the button
Seat 1: C0rpsbal (4995 in chips) 
Seat 2: LuckyRin (4980 in chips) 
Seat 3: Mattzy1 (5946 in chips) 
Seat 4: loco2202 (4995 in chips) 
Seat 5: SaoJorge2222 (4724 in chips) 
Seat 6: sexyhands (4995 in chips) 
Seat 7: vodao1 (4375 in chips) 
Seat 8: TarDinaCash (4995 in chips) 
Seat 9: Eibsee08 (4995 in chips) 
C0rpsbal: posts the ante 5
LuckyRin: posts the ante 5
Mattzy1: posts the ante 5
loco2202: posts the ante 5
SaoJorge2222: posts the ante 5
sexyhands: posts the ante 5
vodao1: posts the ante 5
TarDinaCash: posts the ante 5
Eibsee08: posts the ante 5
Mattzy1: posts small blind 15
loco2202: posts big blind 30
*** HOLE CARDS ***
SaoJorge2222: folds 
sexyhands: raises 60 to 90
vodao1: folds 
TarDinaCash: folds 
Eibsee08: folds 
C0rpsbal: folds 
LuckyRin: folds 
Mattzy1: calls 75
loco2202: calls 60
*** FLOP *** [6s 4c 8d]
Mattzy1: checks 
loco2202: checks 
sexyhands: bets 200
Mattzy1: calls 200
loco2202: folds 
*** TURN *** [6s 4c 8d] [5h]
Mattzy1: checks 
sexyhands: checks 
*** RIVER *** [6s 4c 8d 5h] [8h]
Mattzy1: bets 510
sexyhands: calls 510
*** SHOW DOWN ***
Mattzy1: shows [7s Ad] (a straight, Four to Eight)
sexyhands: mucks hand 
Mattzy1 collected 1735 from pot
*** SUMMARY ***
Total pot 1735 | Rake 0 
Board [6s 4c 8d 5h 8h]
Seat 1: C0rpsbal folded before Flop (didn't bet)
Seat 2: LuckyRin (button) folded before Flop (didn't bet)
Seat 3: Mattzy1 (small blind) showed [7s Ad] and won (1735) with a straight, Four to Eight
Seat 4: loco2202 (big blind) folded on the Flop
Seat 5: SaoJorge2222 folded before Flop (didn't bet)
Seat 6: sexyhands mucked
Seat 7: vodao1 folded before Flop (didn't bet)
Seat 8: TarDinaCash folded before Flop (didn't bet)
Seat 9: Eibsee08 folded before Flop (didn't bet)



PokerStars Hand #157575141451: Tournament #1641817620, $7.50+$7.50+$1.50 USD Hold'em No Limit - Level I (15/30) - 2016/08/21 18:32:14 ET
Table '1641817620 7' 9-max Seat #4 is the button
Seat 1: jad castelo (5080 in chips) 
Seat 2: ricar1749 (4990 in chips) 
Seat 3: Steve G009 (4975 in chips) 
Seat 4: nbmom (4885 in chips) 
Seat 5: bernardijack (5000 in chips) out of hand (moved from another table into small blind)
Seat 6: POKEMONSTRO (4960 in chips) 
Seat 7: NemeanDanny (4990 in chips) 
Seat 8: Original02 (5375 in chips) 
Seat 9: cjgarceau (4990 in chips) 
jad castelo: posts the ante 5
ricar1749: posts the ante 5
Steve G009: posts the ante 5
nbmom: posts the ante 5
POKEMONSTRO: posts the ante 5
NemeanDanny: posts the ante 5
Original02: posts the ante 5
cjgarceau: posts the ante 5
POKEMONSTRO: posts small blind 15
NemeanDanny: posts big blind 30
*** HOLE CARDS ***
Original02: folds 
cjgarceau: folds 
jad castelo: folds 
ricar1749: folds 
Steve G009: folds 
nbmom is disconnected 
nbmom is connected 
nbmom: folds 
POKEMONSTRO: calls 15
NemeanDanny: raises 60 to 90
POKEMONSTRO: folds 
Uncalled bet (60) returned to NemeanDanny
NemeanDanny collected 100 from pot
*** SUMMARY ***
Total pot 100 | Rake 0 
Seat 1: jad castelo folded before Flop (didn't bet)
Seat 2: ricar1749 folded before Flop (didn't bet)
Seat 3: Steve G009 folded before Flop (didn't bet)
Seat 4: nbmom (button) folded before Flop (didn't bet)
Seat 6: POKEMONSTRO (small blind) folded before Flop
Seat 7: NemeanDanny (big blind) collected (100)
Seat 8: Original02 folded before Flop (didn't bet)
Seat 9: cjgarceau folded before Flop (didn't bet)



PokerStars Hand #157575141491: Tournament #1641817620, $7.50+$7.50+$1.50 USD Hold'em No Limit - Level I (15/30) - 2016/08/21 18:32:14 ET
Table '1641817620 54' 9-max Seat #3 is the button
Seat 1: nixx77 (4990 in chips) 
Seat 2: FábioC.p.br (4975 in chips) 
Seat 3: pinokkioOo (4945 in chips) 
Seat 4: ALLESC-114 (4960 in chips) 
Seat 5: appache55 (3850 in chips) 
Seat 6: hrabbi87 (4930 in chips) 
Seat 7: xpsbynoc (6370 in chips) 
Seat 8: MiltonMorais (4990 in chips) 
Seat 9: ZeckMaverick (4990 in chips) 
nixx77: posts the ante 5
FábioC.p.br: posts the ante 5
pinokkioOo: posts the ante 5
ALLESC-114: posts the ante 5
appache55: posts the ante 5
hrabbi87: posts the ante 5
xpsbynoc: posts the ante 5
MiltonMorais: posts the ante 5
ZeckMaverick: posts the ante 5
ALLESC-114: posts small blind 15
appache55: posts big blind 30
*** HOLE CARDS ***
hrabbi87: folds 
xpsbynoc: raises 30 to 60
MiltonMorais: folds 
ZeckMaverick: folds 
nixx77: folds 
FábioC.p.br: folds 
pinokkioOo: folds 
ALLESC-114: folds 
appache55: calls 30
*** FLOP *** [7h 6s 2h]
appache55: bets 180
xpsbynoc: calls 180
*** TURN *** [7h 6s 2h] [Ac]
appache55: checks 
xpsbynoc: checks 
*** RIVER *** [7h 6s 2h Ac] [Td]
appache55: checks 
xpsbynoc: bets 420
appache55: calls 420
*** SHOW DOWN ***
xpsbynoc: shows [Ad Qs] (a pair of Aces)
appache55: mucks hand 
xpsbynoc collected 1380 from pot
*** SUMMARY ***
Total pot 1380 | Rake 0 
Board [7h 6s 2h Ac Td]
Seat 1: nixx77 folded before Flop (didn't bet)
Seat 2: FábioC.p.br folded before Flop (didn't bet)
Seat 3: pinokkioOo (button) folded before Flop (didn't bet)
Seat 4: ALLESC-114 (small blind) folded before Flop
Seat 5: appache55 (big blind) mucked
Seat 6: hrabbi87 folded before Flop (didn't bet)
Seat 7: xpsbynoc showed [Ad Qs] and won (1380) with a pair of Aces
Seat 8: MiltonMorais folded before Flop (didn't bet)
Seat 9: ZeckMaverick folded before Flop (didn't bet)



PokerStars Hand #157575142001: Tournament #1641817620, $7.50+$7.50+$1.50 USD Hold'em No Limit - Level I (15/30) - 2016/08/21 18:32:15 ET
Table '1641817620 43' 9-max Seat #3 is the button
Seat 1: VeniG95 (4990 in chips) 
Seat 2: alanyamil (5065 in chips) 
Seat 3: Raulop (4780 in chips) 
Seat 4: SoulSlaye166 (5215 in chips) 
Seat 5: DimaRu777 (4990 in chips) 
Seat 6: Taima (4990 in chips) 
Seat 7: Caville88 (4990 in chips) 
Seat 8: BetoFolhaCMC (4990 in chips) 
Seat 9: cajool (4990 in chips) 
VeniG95: posts the ante 5
alanyamil: posts the ante 5
Raulop: posts the ante 5
SoulSlaye166: posts the ante 5
DimaRu777: posts the ante 5
Taima: posts the ante 5
Caville88: posts the ante 5
BetoFolhaCMC: posts the ante 5
cajool: posts the ante 5
SoulSlaye166: posts small blind 15
DimaRu777: posts big blind 30
*** HOLE CARDS ***
Taima: raises 60 to 90
Caville88: folds 
BetoFolhaCMC: folds 
cajool: folds 
VeniG95: raises 104 to 194
alanyamil: calls 194
Raulop: folds 
SoulSlaye166: folds 
DimaRu777: folds 
Taima: calls 104
*** FLOP *** [Ac 5h 4d]
Taima: checks 
VeniG95: bets 392
alanyamil: calls 392
Taima: folds 
*** TURN *** [Ac 5h 4d] [Tc]
VeniG95: bets 990
alanyamil: calls 990
*** RIVER *** [Ac 5h 4d Tc] [8d]
VeniG95: bets 3409 and is all-in
alanyamil: calls 3409
*** SHOW DOWN ***
VeniG95: shows [Ad Kc] (a pair of Aces)
alanyamil: shows [Jc Ah] (a pair of Aces - lower kicker)
VeniG95 collected 10254 from pot
*** SUMMARY ***
Total pot 10254 | Rake 0 
Board [Ac 5h 4d Tc 8d]
Seat 1: VeniG95 showed [Ad Kc] and won (10254) with a pair of Aces
Seat 2: alanyamil showed [Jc Ah] and lost with a pair of Aces
Seat 3: Raulop (button) folded before Flop (didn't bet)
Seat 4: SoulSlaye166 (small blind) folded before Flop
Seat 5: DimaRu777 (big blind) folded before Flop
Seat 6: Taima folded on the Flop
Seat 7: Caville88 folded before Flop (didn't bet)
Seat 8: BetoFolhaCMC folded before Flop (didn't bet)
Seat 9: cajool folded before Flop (didn't bet)



PokerStars Hand #157575142232: Tournament #1641817620, $7.50+$7.50+$1.50 USD Hold'em No Limit - Level I (15/30) - 2016/08/21 18:32:15 ET
Table '1641817620 32' 9-max Seat #5 is the button
Seat 1: RoribeiroS (4985 in chips) 
Seat 2: tomgan (5115 in chips) 
Seat 3: patou99957 (5120 in chips) 
Seat 4: JAhodaZ (5000 in chips) 
Seat 5: bdiddy1313 (5325 in chips) 
Seat 6: 69 hearts 69 (4895 in chips) 
Seat 7: rimis9999 (4985 in chips) 
Seat 8: noah5555 (4685 in chips) 
Seat 9: gamesAREover (4895 in chips) 
RoribeiroS: posts the ante 5
tomgan: posts the ante 5
patou99957: posts the ante 5
JAhodaZ: posts the ante 5
bdiddy1313: posts the ante 5
69 hearts 69: posts the ante 5
rimis9999: posts the ante 5
noah5555: posts the ante 5
gamesAREover: posts the ante 5
69 hearts 69: posts small blind 15
rimis9999: posts big blind 30
*** HOLE CARDS ***
noah5555: folds 
gamesAREover: folds 
RoribeiroS: raises 60 to 90
tomgan: folds 
patou99957: calls 90
JAhodaZ: calls 90
bdiddy1313: folds 
69 hearts 69: calls 75
rimis9999: folds 
*** FLOP *** [Ah 9s 7d]
69 hearts 69: checks 
RoribeiroS: bets 191
patou99957: calls 191
JAhodaZ: folds 
69 hearts 69: calls 191
*** TURN *** [Ah 9s 7d] [Jh]
69 hearts 69: checks 
RoribeiroS: bets 443
patou99957: calls 443
69 hearts 69: calls 443
*** RIVER *** [Ah 9s 7d Jh] [Ks]
69 hearts 69: checks 
RoribeiroS: bets 4256 and is all-in
patou99957: folds 
69 hearts 69: folds 
Uncalled bet (4256) returned to RoribeiroS
RoribeiroS collected 2337 from pot
*** SUMMARY ***
Total pot 2337 | Rake 0 
Board [Ah 9s 7d Jh Ks]
Seat 1: RoribeiroS collected (2337)
Seat 2: tomgan folded before Flop (didn't bet)
Seat 3: patou99957 folded on the River
Seat 4: JAhodaZ folded on the Flop
Seat 5: bdiddy1313 (button) folded before Flop (didn't bet)
Seat 6: 69 hearts 69 (small blind) folded on the River
Seat 7: rimis9999 (big blind) folded before Flop
Seat 8: noah5555 folded before Flop (didn't bet)
Seat 9: gamesAREover folded before Flop (didn't bet)



PokerStars Hand #157575143986: Tournament #1641817620, $7.50+$7.50+$1.50 USD Hold'em No Limit - Level I (15/30) - 2016/08/21 18:32:17 ET
Table '1641817620 12' 9-max Seat #3 is the button
Seat 1: Vlacerda (5129 in chips) 
Seat 2: aiaolinda (4855 in chips) 
Seat 3: faza29 (4896 in chips) 
Seat 4: Gottlieb007 (5170 in chips) 
Seat 5: ALEX-RSN (4990 in chips) 
Seat 6: MANJUS89 (4990 in chips) 
Seat 7: Mr. Burns501 (4990 in chips) 
Seat 8: CHARRUA1122 (4990 in chips) 
Seat 9: FrankLDrex (4990 in chips) 
Vlacerda: posts the ante 5
aiaolinda: posts the ante 5
faza29: posts the ante 5
Gottlieb007: posts the ante 5
ALEX-RSN: posts the ante 5
MANJUS89: posts the ante 5
Mr. Burns501: posts the ante 5
CHARRUA1122: posts the ante 5
FrankLDrex: posts the ante 5
Gottlieb007: posts small blind 15
ALEX-RSN: posts big blind 30
*** HOLE CARDS ***
MANJUS89: folds 
Mr. Burns501: raises 75 to 105
CHARRUA1122: raises 375 to 480
FrankLDrex: folds 
Vlacerda: folds 
aiaolinda: calls 480
faza29: folds 
Gottlieb007: folds 
ALEX-RSN: folds 
Mr. Burns501: calls 375
*** FLOP *** [8d 4c 4h]
Mr. Burns501: checks 
CHARRUA1122: bets 4505 and is all-in
aiaolinda: folds 
Mr. Burns501: folds 
Uncalled bet (4505) returned to CHARRUA1122
CHARRUA1122 collected 1530 from pot
*** SUMMARY ***
Total pot 1530 | Rake 0 
Board [8d 4c 4h]
Seat 1: Vlacerda folded before Flop (didn't bet)
Seat 2: aiaolinda folded on the Flop
Seat 3: faza29 (button) folded before Flop (didn't bet)
Seat 4: Gottlieb007 (small blind) folded before Flop
Seat 5: ALEX-RSN (big blind) folded before Flop
Seat 6: MANJUS89 folded before Flop (didn't bet)
Seat 7: Mr. Burns501 folded on the Flop
Seat 8: CHARRUA1122 collected (1530)
Seat 9: FrankLDrex folded before Flop (didn't bet)



PokerStars Hand #157575144263: Tournament #1641817620, $7.50+$7.50+$1.50 USD Hold'em No Limit - Level I (15/30) - 2016/08/21 18:32:18 ET
Table '1641817620 1' 9-max Seat #3 is the button
Seat 1: mattyonuts (4990 in chips) 
Seat 2: topaipi (5237 in chips) 
Seat 3: MAMOHT_T (4945 in chips) 
Seat 4: ManMaPayé (5000 in chips) out of hand (moved from another table into small blind)
Seat 5: LADIEFJ (6025 in chips) 
Seat 6: TheGuerreiro (4768 in chips) 
Seat 7: Amorkos (4990 in chips) 
Seat 8: K. Ichinose (4990 in chips) 
Seat 9: AdiMutu1001 (4990 in chips) 
mattyonuts: posts the ante 5
topaipi: posts the ante 5
MAMOHT_T: posts the ante 5
LADIEFJ: posts the ante 5
TheGuerreiro: posts the ante 5
Amorkos: posts the ante 5
K. Ichinose: posts the ante 5
AdiMutu1001: posts the ante 5
LADIEFJ: posts small blind 15
TheGuerreiro: posts big blind 30
*** HOLE CARDS ***
Amorkos: folds 
K. Ichinose: folds 
AdiMutu1001: folds 
mattyonuts: raises 38 to 68
topaipi: calls 68
MAMOHT_T: folds 
LADIEFJ: folds 
TheGuerreiro: folds 
*** FLOP *** [6h Ad 5s]
mattyonuts: bets 125
topaipi: folds 
Uncalled bet (125) returned to mattyonuts
mattyonuts collected 221 from pot
mattyonuts: doesn't show hand 
*** SUMMARY ***
Total pot 221 | Rake 0 
Board [6h Ad 5s]
Seat 1: mattyonuts collected (221)
Seat 2: topaipi folded on the Flop
Seat 3: MAMOHT_T (button) folded before Flop (didn't bet)
Seat 5: LADIEFJ (small blind) folded before Flop
Seat 6: TheGuerreiro (big blind) folded before Flop
Seat 7: Amorkos folded before Flop (didn't bet)
Seat 8: K. Ichinose folded before Flop (didn't bet)
Seat 9: AdiMutu1001 folded before Flop (didn't bet)



PokerStars Hand #157575145495: Tournament #1641817620, $7.50+$7.50+$1.50 USD Hold'em No Limit - Level I (15/30) - 2016/08/21 18:32:20 ET
Table '1641817620 2' 9-max Seat #3 is the button
Seat 1: ChaCha121 (4990 in chips) 
Seat 2: T8yourmoney (4975 in chips) 
Seat 3: mvpalls (4915 in chips) 
Seat 4: Juniorjbm28 (5000 in chips) out of hand (moved from another table into small blind)
Seat 5: junkshow#1 (4960 in chips) 
Seat 6: Vstoinov (4990 in chips) 
Seat 7: GreenDja (4990 in chips) 
Seat 8: BckDoorFlux (4930 in chips) 
Seat 9: LeaD25 (5465 in chips) 
ChaCha121: posts the ante 5
T8yourmoney: posts the ante 5
mvpalls: posts the ante 5
junkshow#1: posts the ante 5
Vstoinov: posts the ante 5
GreenDja: posts the ante 5
BckDoorFlux: posts the ante 5
LeaD25: posts the ante 5
junkshow#1: posts small blind 15
Vstoinov: posts big blind 30
*** HOLE CARDS ***
GreenDja: folds 
BckDoorFlux: raises 30 to 60
LeaD25: folds 
ChaCha121: folds 
T8yourmoney: folds 
mvpalls: folds 
junkshow#1: folds 
Vstoinov: folds 
Uncalled bet (30) returned to BckDoorFlux
BckDoorFlux collected 115 from pot
*** SUMMARY ***
Total pot 115 | Rake 0 
Seat 1: ChaCha121 folded before Flop (didn't bet)
Seat 2: T8yourmoney folded before Flop (didn't bet)
Seat 3: mvpalls (button) folded before Flop (didn't bet)
Seat 5: junkshow#1 (small blind) folded before Flop
Seat 6: Vstoinov (big blind) folded before Flop
Seat 7: GreenDja folded before Flop (didn't bet)
Seat 8: BckDoorFlux collected (115)
Seat 9: LeaD25 folded before Flop (didn't bet)



PokerStars Hand #157575145519: Tournament #1641817620, $7.50+$7.50+$1.50 USD Hold'em No Limit - Level I (15/30) - 2016/08/21 18:32:20 ET
Table '1641817620 17' 9-max Seat #4 is the button
Seat 1: guitarist68 (5070 in chips) 
Seat 2: Anton163reg (4970 in chips) 
Seat 3: GoldenBeeM (4940 in chips) 
Seat 4: PETER BEATZ (4670 in chips) 
Seat 5: happyminh (5000 in chips) out of hand (moved from another table into small blind)
Seat 6: dekota222 (4955 in chips) 
Seat 7: rooney69 (5225 in chips) 
Seat 8: uuvvrr (4985 in chips) 
Seat 9: Samburger514 (5195 in chips) 
guitarist68: posts the ante 5
Anton163reg: posts the ante 5
GoldenBeeM: posts the ante 5
PETER BEATZ: posts the ante 5
dekota222: posts the ante 5
rooney69: posts the ante 5
uuvvrr: posts the ante 5
Samburger514: posts the ante 5
dekota222: posts small blind 15
rooney69: posts big blind 30
*** HOLE CARDS ***
uuvvrr: folds 
Samburger514: folds 
guitarist68: raises 36 to 66
Anton163reg: folds 
GoldenBeeM: folds 
PETER BEATZ: folds 
dekota222: folds 
rooney69: folds 
Uncalled bet (36) returned to guitarist68
guitarist68 collected 115 from pot
guitarist68: doesn't show hand 
*** SUMMARY ***
Total pot 115 | Rake 0 
Seat 1: guitarist68 collected (115)
Seat 2: Anton163reg folded before Flop (didn't bet)
Seat 3: GoldenBeeM folded before Flop (didn't bet)
Seat 4: PETER BEATZ (button) folded before Flop (didn't bet)
Seat 6: dekota222 (small blind) folded before Flop
Seat 7: rooney69 (big blind) folded before Flop
Seat 8: uuvvrr folded before Flop (didn't bet)
Seat 9: Samburger514 folded before Flop (didn't bet)



PokerStars Hand #157575146797: Tournament #1641817620, $7.50+$7.50+$1.50 USD Hold'em No Limit - Level I (15/30) - 2016/08/21 18:32:22 ET
Table '1641817620 46' 9-max Seat #3 is the button
Seat 1: Kotakera (4823 in chips) 
Seat 2: estebangocu (4975 in chips) 
Seat 3: butler992 (4945 in chips) 
Seat 4: ZuzanaM (4960 in chips) 
Seat 5: Koeike (4995 in chips) 
Seat 6: BredaBreda (4990 in chips) 
Seat 7: clavito691 (5406 in chips) 
Seat 8: Violetarose (4921 in chips) 
Seat 9: staknchips83 (4990 in chips) 
Kotakera: posts the ante 5
estebangocu: posts the ante 5
butler992: posts the ante 5
ZuzanaM: posts the ante 5
Koeike: posts the ante 5
BredaBreda: posts the ante 5
clavito691: posts the ante 5
Violetarose: posts the ante 5
staknchips83: posts the ante 5
ZuzanaM: posts small blind 15
Koeike: posts big blind 30
*** HOLE CARDS ***
BredaBreda: folds 
clavito691: folds 
Violetarose: raises 30 to 60
staknchips83: folds 
Kotakera: folds 
estebangocu: folds 
butler992: calls 60
ZuzanaM: folds 
Koeike: calls 30
*** FLOP *** [2h 6d 9d]
Koeike: checks 
Violetarose: checks 
butler992: checks 
*** TURN *** [2h 6d 9d] [6h]
Koeike: checks 
Violetarose: bets 180
butler992: folds 
Koeike: folds 
Uncalled bet (180) returned to Violetarose
Violetarose collected 240 from pot
*** SUMMARY ***
Total pot 240 | Rake 0 
Board [2h 6d 9d 6h]
Seat 1: Kotakera folded before Flop (didn't bet)
Seat 2: estebangocu folded before Flop (didn't bet)
Seat 3: butler992 (button) folded on the Turn
Seat 4: ZuzanaM (small blind) folded before Flop
Seat 5: Koeike (big blind) folded on the Turn
Seat 6: BredaBreda folded before Flop (didn't bet)
Seat 7: clavito691 folded before Flop (didn't bet)
Seat 8: Violetarose collected (240)
Seat 9: staknchips83 folded before Flop (didn't bet)



PokerStars Hand #157575147065: Tournament #1641817620, $7.50+$7.50+$1.50 USD Hold'em No Limit - Level I (15/30) - 2016/08/21 18:32:22 ET
Table '1641817620 26' 9-max Seat #4 is the button
Seat 1: duplo1182 (4985 in chips) 
Seat 2: Heretic66688 (4970 in chips) 
Seat 3: Axkj (4940 in chips) 
Seat 4: h1per1on (4940 in chips) 
Seat 6: Archibal_17 (4745 in chips) 
Seat 7: GDLW26 (4985 in chips) 
Seat 8: LongTermTILT (5375 in chips) 
Seat 9: danius111 (5220 in chips) 
duplo1182: posts the ante 5
Heretic66688: posts the ante 5
Axkj: posts the ante 5
h1per1on: posts the ante 5
Archibal_17: posts the ante 5
GDLW26: posts the ante 5
LongTermTILT: posts the ante 5
danius111: posts the ante 5
Archibal_17: posts small blind 15
GDLW26: posts big blind 30
*** HOLE CARDS ***
LongTermTILT: folds 
danius111: raises 30 to 60
duplo1182: folds 
Heretic66688: folds 
Axkj: folds 
h1per1on: calls 60
Archibal_17: calls 45
GDLW26: folds 
*** FLOP *** [6d 5c Kd]
Archibal_17: checks 
danius111: checks 
h1per1on: bets 155
Archibal_17: calls 155
danius111: folds 
*** TURN *** [6d 5c Kd] [5s]
Archibal_17: checks 
h1per1on: bets 278
Archibal_17: folds 
Uncalled bet (278) returned to h1per1on
h1per1on collected 560 from pot
h1per1on: doesn't show hand 
*** SUMMARY ***
Total pot 560 | Rake 0 
Board [6d 5c Kd 5s]
Seat 1: duplo1182 folded before Flop (didn't bet)
Seat 2: Heretic66688 folded before Flop (didn't bet)
Seat 3: Axkj folded before Flop (didn't bet)
Seat 4: h1per1on (button) collected (560)
Seat 6: Archibal_17 (small blind) folded on the Turn
Seat 7: GDLW26 (big blind) folded before Flop
Seat 8: LongTermTILT folded before Flop (didn't bet)
Seat 9: danius111 folded on the Flop



PokerStars Hand #157575147334: Tournament #1641817620, $7.50+$7.50+$1.50 USD Hold'em No Limit - Level I (15/30) - 2016/08/21 18:32:23 ET
Table '1641817620 11' 9-max Seat #3 is the button
Seat 1: GambleGrill (4990 in chips) 
Seat 2: Dionakabarbi (4975 in chips) is sitting out
Seat 3: TriviGn'R (5030 in chips) 
Seat 4: rapo007 (4960 in chips) 
Seat 5: vanilaice88 (4990 in chips) 
Seat 6: buzios38 (5080 in chips) 
Seat 7: BAIGUATE (4995 in chips) 
Seat 8: luisnrd (4990 in chips) 
Seat 9: kylix42 (4990 in chips) 
GambleGrill: posts the ante 5
Dionakabarbi: posts the ante 5
TriviGn'R: posts the ante 5
rapo007: posts the ante 5
vanilaice88: posts the ante 5
buzios38: posts the ante 5
BAIGUATE: posts the ante 5
luisnrd: posts the ante 5
kylix42: posts the ante 5
rapo007: posts small blind 15
vanilaice88: posts big blind 30
*** HOLE CARDS ***
buzios38: raises 60 to 90
BAIGUATE: calls 90
luisnrd: folds 
kylix42: folds 
GambleGrill: folds 
Dionakabarbi: folds 
TriviGn'R: folds 
rapo007: folds 
vanilaice88: calls 60
*** FLOP *** [Jh 7s 8s]
vanilaice88: checks 
buzios38: bets 150
BAIGUATE: calls 150
vanilaice88: calls 150
*** TURN *** [Jh 7s 8s] [Qc]
vanilaice88: checks 
Dionakabarbi has returned
buzios38: bets 390
BAIGUATE: folds 
vanilaice88: folds 
Uncalled bet (390) returned to buzios38
buzios38 collected 780 from pot
buzios38: doesn't show hand 
*** SUMMARY ***
Total pot 780 | Rake 0 
Board [Jh 7s 8s Qc]
Seat 1: GambleGrill folded before Flop (didn't bet)
Seat 2: Dionakabarbi folded before Flop (didn't bet)
Seat 3: TriviGn'R (button) folded before Flop (didn't bet)
Seat 4: rapo007 (small blind) folded before Flop
Seat 5: vanilaice88 (big blind) folded on the Turn
Seat 6: buzios38 collected (780)
Seat 7: BAIGUATE folded on the Turn
Seat 8: luisnrd folded before Flop (didn't bet)
Seat 9: kylix42 folded before Flop (didn't bet)



PokerStars Hand #157575148117: Tournament #1641817620, $7.50+$7.50+$1.50 USD Hold'em No Limit - Level I (15/30) - 2016/08/21 18:32:24 ET
Table '1641817620 23' 9-max Seat #3 is the button
Seat 1: Cepillo (4990 in chips) 
Seat 2: erfan86 (4975 in chips) 
Seat 3: derkimos (4780 in chips) 
Seat 4: Carlos11497 (4960 in chips) 
Seat 5: MickJagger86 (4990 in chips) 
Seat 6: Feyenoord0020 (5215 in chips) 
Seat 7: jradjo21 (4990 in chips) 
Seat 8: kajarana (4990 in chips) 
Seat 9: -MCASLAN7- (5110 in chips) 
Cepillo: posts the ante 5
erfan86: posts the ante 5
derkimos: posts the ante 5
Carlos11497: posts the ante 5
MickJagger86: posts the ante 5
Feyenoord0020: posts the ante 5
jradjo21: posts the ante 5
kajarana: posts the ante 5
-MCASLAN7-: posts the ante 5
Carlos11497: posts small blind 15
MickJagger86: posts big blind 30
*** HOLE CARDS ***
Feyenoord0020: folds 
jradjo21: folds 
kajarana: folds 
-MCASLAN7-: folds 
Cepillo: folds 
erfan86: folds 
derkimos: raises 90 to 120
Carlos11497: folds 
MickJagger86: folds 
Uncalled bet (90) returned to derkimos
derkimos collected 120 from pot
derkimos: doesn't show hand 
*** SUMMARY ***
Total pot 120 | Rake 0 
Seat 1: Cepillo folded before Flop (didn't bet)
Seat 2: erfan86 folded before Flop (didn't bet)
Seat 3: derkimos (button) collected (120)
Seat 4: Carlos11497 (small blind) folded before Flop
Seat 5: MickJagger86 (big blind) folded before Flop
Seat 6: Feyenoord0020 folded before Flop (didn't bet)
Seat 7: jradjo21 folded before Flop (didn't bet)
Seat 8: kajarana folded before Flop (didn't bet)
Seat 9: -MCASLAN7- folded before Flop (didn't bet)



PokerStars Hand #157575148204: Tournament #1641817620, $7.50+$7.50+$1.50 USD Hold'em No Limit - Level I (15/30) - 2016/08/21 18:32:24 ET
Table '1641817620 22' 9-max Seat #4 is the button
Seat 1: glangglang (4985 in chips) 
Seat 2: skalistair (4985 in chips) 
Seat 3: CHININ118 (4940 in chips) 
Seat 4: Jaliplay (5045 in chips) 
Seat 5: hewx (4955 in chips) 
Seat 6: xxSTORMZYxx (4985 in chips) 
Seat 7: ogotop76 (4985 in chips) 
Seat 8: monterreymx (4985 in chips) 
Seat 9: cash4king (5135 in chips) 
glangglang: posts the ante 5
skalistair: posts the ante 5
CHININ118: posts the ante 5
Jaliplay: posts the ante 5
hewx: posts the ante 5
xxSTORMZYxx: posts the ante 5
ogotop76: posts the ante 5
monterreymx: posts the ante 5
cash4king: posts the ante 5
hewx: posts small blind 15
xxSTORMZYxx: posts big blind 30
*** HOLE CARDS ***
ogotop76: folds 
monterreymx: folds 
cash4king: folds 
glangglang: folds 
skalistair: raises 60 to 90
CHININ118: folds 
Jaliplay: raises 150 to 240
hewx: folds 
xxSTORMZYxx: folds 
skalistair: calls 150
*** FLOP *** [7h 9c Qd]
skalistair: bets 570
Jaliplay: raises 1110 to 1680
skalistair: raises 3060 to 4740 and is all-in
Jaliplay: calls 3060
*** TURN *** [7h 9c Qd] [7s]
*** RIVER *** [7h 9c Qd 7s] [Kc]
*** SHOW DOWN ***
skalistair: shows [9s 3h] (two pair, Nines and Sevens)
Jaliplay: shows [Ah Qs] (two pair, Queens and Sevens)
Jaliplay collected 10050 from pot
Jaliplay wins $3.75 for eliminating skalistair and their own bounty increases by $3.75 to $11.25
skalistair finished the tournament in 999999993rd place
*** SUMMARY ***
Total pot 10050 | Rake 0 
Board [7h 9c Qd 7s Kc]
Seat 1: glangglang folded before Flop (didn't bet)
Seat 2: skalistair showed [9s 3h] and lost with two pair, Nines and Sevens
Seat 3: CHININ118 folded before Flop (didn't bet)
Seat 4: Jaliplay (button) showed [Ah Qs] and won (10050) with two pair, Queens and Sevens
Seat 5: hewx (small blind) folded before Flop
Seat 6: xxSTORMZYxx (big blind) folded before Flop
Seat 7: ogotop76 folded before Flop (didn't bet)
Seat 8: monterreymx folded before Flop (didn't bet)
Seat 9: cash4king folded before Flop (didn't bet)



PokerStars Hand #157575150604: Tournament #1641817620, $7.50+$7.50+$1.50 USD Hold'em No Limit - Level I (15/30) - 2016/08/21 18:32:28 ET
Table '1641817620 18' 9-max Seat #2 is the button
Seat 1: Declan387 (4482 in chips) 
Seat 2: silvina35 (4932 in chips) 
Seat 3: TBP23 (4482 in chips) 
Seat 4: One_Cigar (4995 in chips) 
Seat 5: 111santos (4995 in chips) 
Seat 6: Krauser2589 (4995 in chips) 
Seat 7: shaxmatiist (4995 in chips) 
Seat 8: Lestatdiego (4752 in chips) 
Seat 9: kokandija (6372 in chips) 
Declan387: posts the ante 5
silvina35: posts the ante 5
TBP23: posts the ante 5
One_Cigar: posts the ante 5
111santos: posts the ante 5
Krauser2589: posts the ante 5
shaxmatiist: posts the ante 5
Lestatdiego: posts the ante 5
kokandija: posts the ante 5
TBP23: posts small blind 15
One_Cigar: posts big blind 30
*** HOLE CARDS ***
111santos: calls 30
Krauser2589: folds 
shaxmatiist: folds 
Lestatdiego: folds 
kokandija: folds 
Declan387: folds 
silvina35: raises 120 to 150
TBP23: folds 
One_Cigar: folds 
111santos: calls 120
*** FLOP *** [9s 6h 2c]
111santos: checks 
silvina35: bets 390
111santos: folds 
Uncalled bet (390) returned to silvina35
silvina35 collected 390 from pot
silvina35: doesn't show hand 
*** SUMMARY ***
Total pot 390 | Rake 0 
Board [9s 6h 2c]
Seat 1: Declan387 folded before Flop (didn't bet)
Seat 2: silvina35 (button) collected (390)
Seat 3: TBP23 (small blind) folded before Flop
Seat 4: One_Cigar (big blind) folded before Flop
Seat 5: 111santos folded on the Flop
Seat 6: Krauser2589 folded before Flop (didn't bet)
Seat 7: shaxmatiist folded before Flop (didn't bet)
Seat 8: Lestatdiego folded before Flop (didn't bet)
Seat 9: kokandija folded before Flop (didn't bet)



PokerStars Hand #157575150928: Tournament #1641817620, $7.50+$7.50+$1.50 USD Hold'em No Limit - Level I (15/30) - 2016/08/21 18:32:28 ET
Table '1641817620 33' 9-max Seat #6 is the button
Seat 1: fungyou (4980 in chips) 
Seat 2: titauhu (4965 in chips) is sitting out
Seat 3: gmdef.2001 (4935 in chips) 
Seat 4: natahha_92 (4995 in chips) 
Seat 5: T@keItDown (5020 in chips) 
Seat 6: REPPARTFLOW (4935 in chips) 
Seat 7: dennismitru (5130 in chips) 
Seat 8: Joao Valli (4980 in chips) 
Seat 9: Pablos701 (5065 in chips) 
fungyou: posts the ante 5
titauhu: posts the ante 5
gmdef.2001: posts the ante 5
natahha_92: posts the ante 5
T@keItDown: posts the ante 5
REPPARTFLOW: posts the ante 5
dennismitru: posts the ante 5
Joao Valli: posts the ante 5
Pablos701: posts the ante 5
dennismitru: posts small blind 15
Joao Valli: posts big blind 30
*** HOLE CARDS ***
Pablos701: folds 
fungyou: folds 
titauhu: folds 
gmdef.2001: folds 
natahha_92 is disconnected 
natahha_92 is connected 
natahha_92: folds 
T@keItDown: folds 
REPPARTFLOW: raises 120 to 150
dennismitru: folds 
Joao Valli: folds 
Uncalled bet (120) returned to REPPARTFLOW
REPPARTFLOW collected 120 from pot
REPPARTFLOW: doesn't show hand 
*** SUMMARY ***
Total pot 120 | Rake 0 
Seat 1: fungyou folded before Flop (didn't bet)
Seat 2: titauhu folded before Flop (didn't bet)
Seat 3: gmdef.2001 folded before Flop (didn't bet)
Seat 4: natahha_92 folded before Flop (didn't bet)
Seat 5: T@keItDown folded before Flop (didn't bet)
Seat 6: REPPARTFLOW (button) collected (120)
Seat 7: dennismitru (small blind) folded before Flop
Seat 8: Joao Valli (big blind) folded before Flop
Seat 9: Pablos701 folded before Flop (didn't bet)



PokerStars Hand #157575152099: Tournament #1641817620, $7.50+$7.50+$1.50 USD Hold'em No Limit - Level I (15/30) - 2016/08/21 18:32:30 ET
Table '1641817620 36' 9-max Seat #3 is the button
Seat 1: craiger1976 (4990 in chips) 
Seat 2: Winston4ever (4985 in chips) 
Seat 3: sarxa (4945 in chips) 
Seat 4: rakeshguru (5000 in chips) out of hand (moved from another table into small blind)
Seat 5: blufface88 (5125 in chips) 
Seat 6: xanja (4990 in chips) 
Seat 7: jadrankokec (4990 in chips) 
Seat 8: ruben marley (4990 in chips) 
Seat 9: wowbizz2 (4990 in chips) 
craiger1976: posts the ante 5
Winston4ever: posts the ante 5
sarxa: posts the ante 5
blufface88: posts the ante 5
xanja: posts the ante 5
jadrankokec: posts the ante 5
ruben marley: posts the ante 5
wowbizz2: posts the ante 5
blufface88: posts small blind 15
xanja: posts big blind 30
*** HOLE CARDS ***
jadrankokec: folds 
ruben marley: folds 
wowbizz2: calls 30
craiger1976: folds 
Winston4ever: calls 30
sarxa: folds 
blufface88: raises 90 to 120
xanja: folds 
wowbizz2: calls 90
Winston4ever: calls 90
*** FLOP *** [Th 4c Td]
blufface88: bets 270
wowbizz2: calls 270
Winston4ever: folds 
*** TURN *** [Th 4c Td] [Ts]
blufface88: bets 600
wowbizz2: calls 600
*** RIVER *** [Th 4c Td Ts] [Jh]
blufface88: checks 
wowbizz2: checks 
*** SHOW DOWN ***
blufface88: shows [5s Ad] (three of a kind, Tens)
wowbizz2: shows [9c 9s] (a full house, Tens full of Nines)
wowbizz2 collected 2170 from pot
*** SUMMARY ***
Total pot 2170 | Rake 0 
Board [Th 4c Td Ts Jh]
Seat 1: craiger1976 folded before Flop (didn't bet)
Seat 2: Winston4ever folded on the Flop
Seat 3: sarxa (button) folded before Flop (didn't bet)
Seat 5: blufface88 (small blind) showed [5s Ad] and lost with three of a kind, Tens
Seat 6: xanja (big blind) folded before Flop
Seat 7: jadrankokec folded before Flop (didn't bet)
Seat 8: ruben marley folded before Flop (didn't bet)
Seat 9: wowbizz2 showed [9c 9s] and won (2170) with a full house, Tens full of Nines



PokerStars Hand #157575152133: Tournament #1641817620, $7.50+$7.50+$1.50 USD Hold'em No Limit - Level I (15/30) - 2016/08/21 18:32:30 ET
Table '1641817620 44' 9-max Seat #6 is the button
Seat 1: BurrGrylls (4980 in chips) 
Seat 2: moisesgosu (4965 in chips) 
Seat 3: kduwork (5152 in chips) 
Seat 4: starkstud (5115 in chips) 
Seat 5: rbcowboy27 (5000 in chips) 
Seat 6: lesley hu (4935 in chips) is sitting out
Seat 7: ongggg (4923 in chips) 
Seat 8: heynow21 (4980 in chips) 
Seat 9: Pro_Tunis (5065 in chips) 
BurrGrylls: posts the ante 5
moisesgosu: posts the ante 5
kduwork: posts the ante 5
starkstud: posts the ante 5
rbcowboy27: posts the ante 5
lesley hu: posts the ante 5
ongggg: posts the ante 5
heynow21: posts the ante 5
Pro_Tunis: posts the ante 5
ongggg: posts small blind 15
heynow21: posts big blind 30
*** HOLE CARDS ***
Pro_Tunis: folds 
BurrGrylls: folds 
moisesgosu: raises 30 to 60
kduwork: folds 
starkstud: folds 
rbcowboy27: folds 
lesley hu: folds 
ongggg: folds 
heynow21: calls 30
*** FLOP *** [7h 6c 9s]
heynow21: checks 
moisesgosu: bets 99
heynow21: calls 99
*** TURN *** [7h 6c 9s] [Qh]
heynow21: bets 235
moisesgosu: folds 
Uncalled bet (235) returned to heynow21
heynow21 collected 378 from pot
heynow21: doesn't show hand 
*** SUMMARY ***
Total pot 378 | Rake 0 
Board [7h 6c 9s Qh]
Seat 1: BurrGrylls folded before Flop (didn't bet)
Seat 2: moisesgosu folded on the Turn
Seat 3: kduwork folded before Flop (didn't bet)
Seat 4: starkstud folded before Flop (didn't bet)
Seat 5: rbcowboy27 folded before Flop (didn't bet)
Seat 6: lesley hu (button) folded before Flop (didn't bet)
Seat 7: ongggg (small blind) folded before Flop
Seat 8: heynow21 (big blind) collected (378)
Seat 9: Pro_Tunis folded before Flop (didn't bet)



PokerStars Hand #157575153015: Tournament #1641817620, $7.50+$7.50+$1.50 USD Hold'em No Limit - Level I (15/30) - 2016/08/21 18:32:32 ET
Table '1641817620 29' 9-max Seat #4 is the button
Seat 1: kidpokerjm89 (4985 in chips) 
Seat 2: niejowicz (4970 in chips) 
Seat 3: Ofbravetight (4940 in chips) 
Seat 4: Ottel (4160 in chips) 
Seat 5: puntoo (5915 in chips) 
Seat 6: Melady77777 (4985 in chips) 
Seat 7: fishfind000 (5075 in chips) 
Seat 8: AcePheres (4985 in chips) 
Seat 9: LAZO30 (4985 in chips) 
kidpokerjm89: posts the ante 5
niejowicz: posts the ante 5
Ofbravetight: posts the ante 5
Ottel: posts the ante 5
puntoo: posts the ante 5
Melady77777: posts the ante 5
fishfind000: posts the ante 5
AcePheres: posts the ante 5
LAZO30: posts the ante 5
puntoo: posts small blind 15
Melady77777: posts big blind 30
*** HOLE CARDS ***
fishfind000: folds 
AcePheres: folds 
LAZO30: folds 
kidpokerjm89: folds 
niejowicz: folds 
Ofbravetight: folds 
Ottel: folds 
puntoo: raises 60 to 90
Melady77777: calls 60
*** FLOP *** [Qh 8h 2s]
puntoo: bets 225
Melady77777: calls 225
*** TURN *** [Qh 8h 2s] [9h]
puntoo: bets 675
Melady77777: calls 675
*** RIVER *** [Qh 8h 2s 9h] [4d]
puntoo: checks 
Melady77777: bets 1440
puntoo: folds 
Uncalled bet (1440) returned to Melady77777
Melady77777 collected 2025 from pot
*** SUMMARY ***
Total pot 2025 | Rake 0 
Board [Qh 8h 2s 9h 4d]
Seat 1: kidpokerjm89 folded before Flop (didn't bet)
Seat 2: niejowicz folded before Flop (didn't bet)
Seat 3: Ofbravetight folded before Flop (didn't bet)
Seat 4: Ottel (button) folded before Flop (didn't bet)
Seat 5: puntoo (small blind) folded on the River
Seat 6: Melady77777 (big blind) collected (2025)
Seat 7: fishfind000 folded before Flop (didn't bet)
Seat 8: AcePheres folded before Flop (didn't bet)
Seat 9: LAZO30 folded before Flop (didn't bet)



PokerStars Hand #157575153531: Tournament #1641817620, $7.50+$7.50+$1.50 USD Hold'em No Limit - Level I (15/30) - 2016/08/21 18:32:32 ET
Table '1641817620 35' 9-max Seat #4 is the button
Seat 1: AlexanGeo (5000 in chips) 
Seat 2: Diegodel79 (4970 in chips) 
Seat 3: brunoeffect (4850 in chips) 
Seat 4: PPOrphan (5085 in chips) 
Seat 5: WizardOffAz (4965 in chips) 
Seat 6: brett88987 (4985 in chips) 
Seat 7: IcaLm (4985 in chips) 
Seat 8: ximenesb (4985 in chips) 
Seat 9: Cosacoman (5100 in chips) 
AlexanGeo: posts the ante 5
Diegodel79: posts the ante 5
brunoeffect: posts the ante 5
PPOrphan: posts the ante 5
WizardOffAz: posts the ante 5
brett88987: posts the ante 5
IcaLm: posts the ante 5
ximenesb: posts the ante 5
Cosacoman: posts the ante 5
WizardOffAz: posts small blind 15
brett88987: posts big blind 30
*** HOLE CARDS ***
IcaLm: folds 
ximenesb: folds 
Cosacoman: raises 30 to 60
AlexanGeo: folds 
Diegodel79: folds 
brunoeffect: folds 
PPOrphan: folds 
WizardOffAz: folds 
brett88987: calls 30
*** FLOP *** [Kh As 9s]
brett88987: checks 
Cosacoman: checks 
*** TURN *** [Kh As 9s] [8h]
brett88987: checks 
Cosacoman: bets 60
brett88987: folds 
Uncalled bet (60) returned to Cosacoman
Cosacoman collected 180 from pot
Cosacoman: doesn't show hand 
*** SUMMARY ***
Total pot 180 | Rake 0 
Board [Kh As 9s 8h]
Seat 1: AlexanGeo folded before Flop (didn't bet)
Seat 2: Diegodel79 folded before Flop (didn't bet)
Seat 3: brunoeffect folded before Flop (didn't bet)
Seat 4: PPOrphan (button) folded before Flop (didn't bet)
Seat 5: WizardOffAz (small blind) folded before Flop
Seat 6: brett88987 (big blind) folded on the Turn
Seat 7: IcaLm folded before Flop (didn't bet)
Seat 8: ximenesb folded before Flop (didn't bet)
Seat 9: Cosacoman collected (180)



PokerStars Hand #157575153677: Tournament #1641817620, $7.50+$7.50+$1.50 USD Hold'em No Limit - Level I (15/30) - 2016/08/21 18:32:33 ET
Table '1641817620 45' 9-max Seat #2 is the button
Seat 1: rocky 7 (4995 in chips) 
Seat 2: ldf58 (4980 in chips) 
Seat 3: LifFtD (4965 in chips) 
Seat 4: Grasquet (4995 in chips) 
Seat 5: Mr.Bob-su (2685 in chips) 
Seat 6: CHIT4 (4995 in chips) 
Seat 7: R4ID3R12 (4995 in chips) 
Seat 8: mrbandito27 (4905 in chips) 
Seat 9: Andre Ortega (7485 in chips) 
rocky 7: posts the ante 5
ldf58: posts the ante 5
LifFtD: posts the ante 5
Grasquet: posts the ante 5
Mr.Bob-su: posts the ante 5
CHIT4: posts the ante 5
R4ID3R12: posts the ante 5
mrbandito27: posts the ante 5
Andre Ortega: posts the ante 5
LifFtD: posts small blind 15
Grasquet: posts big blind 30
*** HOLE CARDS ***
Mr.Bob-su: folds 
CHIT4: folds 
R4ID3R12: folds 
mrbandito27: folds 
Andre Ortega: raises 60 to 90
rocky 7: calls 90
ldf58: raises 360 to 450
LifFtD: folds 
Grasquet: folds 
Andre Ortega: calls 360
rocky 7: folds 
*** FLOP *** [5h 3c 9s]
Andre Ortega: checks 
ldf58: checks 
*** TURN *** [5h 3c 9s] [4h]
Andre Ortega: checks 
ldf58: bets 600
Andre Ortega: folds 
Uncalled bet (600) returned to ldf58
ldf58 collected 1080 from pot
ldf58: doesn't show hand 
*** SUMMARY ***
Total pot 1080 | Rake 0 
Board [5h 3c 9s 4h]
Seat 1: rocky 7 folded before Flop
Seat 2: ldf58 (button) collected (1080)
Seat 3: LifFtD (small blind) folded before Flop
Seat 4: Grasquet (big blind) folded before Flop
Seat 5: Mr.Bob-su folded before Flop (didn't bet)
Seat 6: CHIT4 folded before Flop (didn't bet)
Seat 7: R4ID3R12 folded before Flop (didn't bet)
Seat 8: mrbandito27 folded before Flop (didn't bet)
Seat 9: Andre Ortega folded on the Turn



PokerStars Hand #157575154276: Tournament #1641817620, $7.50+$7.50+$1.50 USD Hold'em No Limit - Level I (15/30) - 2016/08/21 18:32:34 ET
Table '1641817620 9' 9-max Seat #3 is the button
Seat 1: kake40 (4900 in chips) 
Seat 2: Cergey1387 (4375 in chips) 
Seat 3: portugajr007 (5703 in chips) 
Seat 4: punkhead89 (5552 in chips) 
Seat 5: nO bUsTeD (4690 in chips) 
Seat 6: edizzz903 (4990 in chips) 
Seat 7: Cuzco83 (4990 in chips) 
Seat 8: maurogynppp (4990 in chips) 
Seat 9: N1COLOSO (4810 in chips) 
kake40: posts the ante 5
Cergey1387: posts the ante 5
portugajr007: posts the ante 5
punkhead89: posts the ante 5
nO bUsTeD: posts the ante 5
edizzz903: posts the ante 5
Cuzco83: posts the ante 5
maurogynppp: posts the ante 5
N1COLOSO: posts the ante 5
punkhead89: posts small blind 15
nO bUsTeD: posts big blind 30
*** HOLE CARDS ***
edizzz903: folds 
Cuzco83: folds 
maurogynppp: folds 
N1COLOSO: folds 
kake40: folds 
Cergey1387: folds 
portugajr007: folds 
punkhead89: folds 
Uncalled bet (15) returned to nO bUsTeD
nO bUsTeD collected 75 from pot
nO bUsTeD: doesn't show hand 
*** SUMMARY ***
Total pot 75 | Rake 0 
Seat 1: kake40 folded before Flop (didn't bet)
Seat 2: Cergey1387 folded before Flop (didn't bet)
Seat 3: portugajr007 (button) folded before Flop (didn't bet)
Seat 4: punkhead89 (small blind) folded before Flop
Seat 5: nO bUsTeD (big blind) collected (75)
Seat 6: edizzz903 folded before Flop (didn't bet)
Seat 7: Cuzco83 folded before Flop (didn't bet)
Seat 8: maurogynppp folded before Flop (didn't bet)
Seat 9: N1COLOSO folded before Flop (didn't bet)



PokerStars Hand #157575155360: Tournament #1641817620, $7.50+$7.50+$1.50 USD Hold'em No Limit - Level I (15/30) - 2016/08/21 18:32:35 ET
Table '1641817620 25' 9-max Seat #5 is the button
Seat 1: MoW3R (4980 in chips) 
Seat 2: pirus157 (5385 in chips) 
Seat 3: MaxBracht (4875 in chips) 
Seat 4: Rex Nelson (5020 in chips) 
Seat 5: ArKip (4935 in chips) 
Seat 6: REALACID (5000 in chips) out of hand (moved from another table into small blind)
Seat 7: AAnaKKonda (4950 in chips) 
Seat 8: Mad Dionysus (4980 in chips) 
Seat 9: IwillCall3 (4890 in chips) 
MoW3R: posts the ante 5
pirus157: posts the ante 5
MaxBracht: posts the ante 5
Rex Nelson: posts the ante 5
ArKip: posts the ante 5
AAnaKKonda: posts the ante 5
Mad Dionysus: posts the ante 5
IwillCall3: posts the ante 5
AAnaKKonda: posts small blind 15
Mad Dionysus: posts big blind 30
*** HOLE CARDS ***
IwillCall3: folds 
MoW3R: folds 
pirus157: raises 30 to 60
MaxBracht: calls 60
Rex Nelson: folds 
ArKip: folds 
AAnaKKonda: folds 
Mad Dionysus: calls 30
*** FLOP *** [3s 6h As]
Mad Dionysus: checks 
pirus157: bets 90
MaxBracht: folds 
Mad Dionysus: folds 
Uncalled bet (90) returned to pirus157
pirus157 collected 235 from pot
pirus157: doesn't show hand 
*** SUMMARY ***
Total pot 235 | Rake 0 
Board [3s 6h As]
Seat 1: MoW3R folded before Flop (didn't bet)
Seat 2: pirus157 collected (235)
Seat 3: MaxBracht folded on the Flop
Seat 4: Rex Nelson folded before Flop (didn't bet)
Seat 5: ArKip (button) folded before Flop (didn't bet)
Seat 7: AAnaKKonda (small blind) folded before Flop
Seat 8: Mad Dionysus (big blind) folded on the Flop
Seat 9: IwillCall3 folded before Flop (didn't bet)



PokerStars Hand #157575155723: Tournament #1641817620, $7.50+$7.50+$1.50 USD Hold'em No Limit - Level I (15/30) - 2016/08/21 18:32:36 ET
Table '1641817620 53' 9-max Seat #4 is the button
Seat 1: star729 (5615 in chips) 
Seat 2: cebola77 (4970 in chips) 
Seat 3: Pekkosaurus (4940 in chips) 
Seat 4: -UNREGPRE- (4940 in chips) 
Seat 5: carlostrend (4595 in chips) 
Seat 6: The39player (4985 in chips) 
Seat 7: MingRey (4985 in chips) 
Seat 8: top@pokker (4985 in chips) 
Seat 9: cruiser5917 (4985 in chips) 
star729: posts the ante 5
cebola77: posts the ante 5
Pekkosaurus: posts the ante 5
-UNREGPRE-: posts the ante 5
carlostrend: posts the ante 5
The39player: posts the ante 5
MingRey: posts the ante 5
top@pokker: posts the ante 5
cruiser5917: posts the ante 5
carlostrend: posts small blind 15
The39player: posts big blind 30
*** HOLE CARDS ***
MingRey: folds 
top@pokker: folds 
cruiser5917: folds 
star729: raises 120 to 150
cebola77: calls 150
Pekkosaurus: folds 
-UNREGPRE-: folds 
carlostrend: calls 135
The39player: folds 
*** FLOP *** [Kh 9d 3s]
carlostrend: checks 
star729: bets 300
cebola77: calls 300
carlostrend: calls 300
*** TURN *** [Kh 9d 3s] [Qs]
carlostrend: checks 
star729: checks 
cebola77: bets 510
carlostrend: folds 
star729: folds 
Uncalled bet (510) returned to cebola77
cebola77 collected 1425 from pot
cebola77: doesn't show hand 
*** SUMMARY ***
Total pot 1425 | Rake 0 
Board [Kh 9d 3s Qs]
Seat 1: star729 folded on the Turn
Seat 2: cebola77 collected (1425)
Seat 3: Pekkosaurus folded before Flop (didn't bet)
Seat 4: -UNREGPRE- (button) folded before Flop (didn't bet)
Seat 5: carlostrend (small blind) folded on the Turn
Seat 6: The39player (big blind) folded before Flop
Seat 7: MingRey folded before Flop (didn't bet)
Seat 8: top@pokker folded before Flop (didn't bet)
Seat 9: cruiser5917 folded before Flop (didn't bet)



PokerStars Hand #157575157743: Tournament #1641817620, $7.50+$7.50+$1.50 USD Hold'em No Limit - Level I (15/30) - 2016/08/21 18:32:39 ET
Table '1641817620 16' 9-max Seat #4 is the button
Seat 1: Kugelbohne79 (5075 in chips) 
Seat 2: Sergei0384 (5096 in chips) 
Seat 3: paschalisbg (4940 in chips) 
Seat 4: Maisiewin (4844 in chips) 
Seat 5: alemaozl (4955 in chips) 
Seat 7: burton14 (4985 in chips) 
Seat 8: Miky_Man993 (4925 in chips) 
Seat 9: ziboin (5195 in chips) 
Kugelbohne79: posts the ante 5
Sergei0384: posts the ante 5
paschalisbg: posts the ante 5
Maisiewin: posts the ante 5
alemaozl: posts the ante 5
burton14: posts the ante 5
Miky_Man993: posts the ante 5
ziboin: posts the ante 5
alemaozl: posts small blind 15
burton14: posts big blind 30
*** HOLE CARDS ***
Miky_Man993: folds 
ziboin: folds 
Kugelbohne79: folds 
Sergei0384: folds 
paschalisbg: folds 
Maisiewin: folds 
alemaozl: folds 
Uncalled bet (15) returned to burton14
burton14 collected 70 from pot
burton14: doesn't show hand 
*** SUMMARY ***
Total pot 70 | Rake 0 
Seat 1: Kugelbohne79 folded before Flop (didn't bet)
Seat 2: Sergei0384 folded before Flop (didn't bet)
Seat 3: paschalisbg folded before Flop (didn't bet)
Seat 4: Maisiewin (button) folded before Flop (didn't bet)
Seat 5: alemaozl (small blind) folded before Flop
Seat 7: burton14 (big blind) collected (70)
Seat 8: Miky_Man993 folded before Flop (didn't bet)
Seat 9: ziboin folded before Flop (didn't bet)



PokerStars Hand #157575157849: Tournament #1641817620, $7.50+$7.50+$1.50 USD Hold'em No Limit - Level I (15/30) - 2016/08/21 18:32:39 ET
Table '1641817620 19' 9-max Seat #3 is the button
Seat 1: ArskaTheMan (4990 in chips) 
Seat 2: renem24 (10040 in chips) 
Seat 3: Paparazzi507 (4490 in chips) 
Seat 4: amondelo (4960 in chips) 
Seat 6: flutzke90 (4990 in chips) 
Seat 7: MrSerks78 (620 in chips) 
Seat 8: le_chefe28 (4990 in chips) 
Seat 9: naumans (4990 in chips) 
ArskaTheMan: posts the ante 5
renem24: posts the ante 5
Paparazzi507: posts the ante 5
amondelo: posts the ante 5
flutzke90: posts the ante 5
MrSerks78: posts the ante 5
le_chefe28: posts the ante 5
naumans: posts the ante 5
amondelo: posts small blind 15
flutzke90: posts big blind 30
*** HOLE CARDS ***
MrSerks78: raises 585 to 615 and is all-in
le_chefe28: raises 4370 to 4985 and is all-in
naumans: folds 
ArskaTheMan: folds 
renem24: folds 
Paparazzi507: folds 
amondelo: folds 
flutzke90: folds 
Uncalled bet (4370) returned to le_chefe28
*** FLOP *** [Qd 6c 6d]
*** TURN *** [Qd 6c 6d] [Jc]
*** RIVER *** [Qd 6c 6d Jc] [7s]
*** SHOW DOWN ***
MrSerks78: shows [3c 9c] (a pair of Sixes)
le_chefe28: shows [Td Qh] (two pair, Queens and Sixes)
le_chefe28 collected 1315 from pot
le_chefe28 wins $3.75 for eliminating MrSerks78 and their own bounty increases by $3.75 to $11.25
MrSerks78 finished the tournament in 999999994th place
*** SUMMARY ***
Total pot 1315 | Rake 0 
Board [Qd 6c 6d Jc 7s]
Seat 1: ArskaTheMan folded before Flop (didn't bet)
Seat 2: renem24 folded before Flop (didn't bet)
Seat 3: Paparazzi507 (button) folded before Flop (didn't bet)
Seat 4: amondelo (small blind) folded before Flop
Seat 6: flutzke90 (big blind) folded before Flop
Seat 7: MrSerks78 showed [3c 9c] and lost with a pair of Sixes
Seat 8: le_chefe28 showed [Td Qh] and won (1315) with two pair, Queens and Sixes
Seat 9: naumans folded before Flop (didn't bet)



PokerStars Hand #157575158142: Tournament #1641817620, $7.50+$7.50+$1.50 USD Hold'em No Limit - Level I (15/30) - 2016/08/21 18:32:39 ET
Table '1641817620 17' 9-max Seat #6 is the button
Seat 1: guitarist68 (5150 in chips) 
Seat 2: Anton163reg (4965 in chips) 
Seat 3: GoldenBeeM (4935 in chips) 
Seat 4: PETER BEATZ (4665 in chips) 
Seat 5: happyminh (5000 in chips) 
Seat 6: dekota222 (4935 in chips) 
Seat 7: rooney69 (5190 in chips) 
Seat 9: Samburger514 (5190 in chips) 
guitarist68: posts the ante 5
Anton163reg: posts the ante 5
GoldenBeeM: posts the ante 5
PETER BEATZ: posts the ante 5
happyminh: posts the ante 5
dekota222: posts the ante 5
rooney69: posts the ante 5
Samburger514: posts the ante 5
rooney69: posts small blind 15
Samburger514: posts big blind 30
*** HOLE CARDS ***
guitarist68: folds 
Anton163reg: folds 
GoldenBeeM: folds 
PETER BEATZ: folds 
happyminh: folds 
dekota222: folds 
rooney69: raises 60 to 90
Samburger514: calls 60
*** FLOP *** [Kh Ks Tc]
rooney69: bets 60
Samburger514: folds 
Uncalled bet (60) returned to rooney69
rooney69 collected 220 from pot
*** SUMMARY ***
Total pot 220 | Rake 0 
Board [Kh Ks Tc]
Seat 1: guitarist68 folded before Flop (didn't bet)
Seat 2: Anton163reg folded before Flop (didn't bet)
Seat 3: GoldenBeeM folded before Flop (didn't bet)
Seat 4: PETER BEATZ folded before Flop (didn't bet)
Seat 5: happyminh folded before Flop (didn't bet)
Seat 6: dekota222 (button) folded before Flop (didn't bet)
Seat 7: rooney69 (small blind) collected (220)
Seat 9: Samburger514 (big blind) folded on the Flop



PokerStars Hand #157575158267: Tournament #1641817620, $7.50+$7.50+$1.50 USD Hold'em No Limit - Level I (15/30) - 2016/08/21 18:32:40 ET
Table '1641817620 37' 9-max Seat #4 is the button
Seat 1: Youbetipush1 (4925 in chips) 
Seat 2: SouzaEduardo (4970 in chips) 
Seat 3: Maisteri (7010 in chips) 
Seat 4: qball911 (4940 in chips) 
Seat 5: dell1961 (5000 in chips) out of hand (moved from another table into small blind)
Seat 6: ColdFire_200 (4955 in chips) 
Seat 7: loachxm (4935 in chips) 
Seat 8: mikke8282 (5000 in chips) 
Seat 9: carabason (8280 in chips) 
Youbetipush1: posts the ante 5
SouzaEduardo: posts the ante 5
Maisteri: posts the ante 5
qball911: posts the ante 5
ColdFire_200: posts the ante 5
loachxm: posts the ante 5
mikke8282: posts the ante 5
carabason: posts the ante 5
ColdFire_200: posts small blind 15
loachxm: posts big blind 30
*** HOLE CARDS ***
mikke8282: folds 
carabason: folds 
Youbetipush1: folds 
SouzaEduardo: folds 
Maisteri: raises 30 to 60
qball911: calls 60
ColdFire_200: calls 45
loachxm: folds 
*** FLOP *** [Jh Th 2d]
ColdFire_200: checks 
Maisteri: bets 120
qball911: folds 
ColdFire_200: folds 
Uncalled bet (120) returned to Maisteri
Maisteri collected 250 from pot
*** SUMMARY ***
Total pot 250 | Rake 0 
Board [Jh Th 2d]
Seat 1: Youbetipush1 folded before Flop (didn't bet)
Seat 2: SouzaEduardo folded before Flop (didn't bet)
Seat 3: Maisteri collected (250)
Seat 4: qball911 (button) folded on the Flop
Seat 6: ColdFire_200 (small blind) folded on the Flop
Seat 7: loachxm (big blind) folded before Flop
Seat 8: mikke8282 folded before Flop (didn't bet)
Seat 9: carabason folded before Flop (didn't bet)



PokerStars Hand #157575158568: Tournament #1641817620, $7.50+$7.50+$1.50 USD Hold'em No Limit - Level I (15/30) - 2016/08/21 18:32:40 ET
Table '1641817620 5' 9-max Seat #4 is the button
Seat 1: PsychixtellO (4995 in chips) 
Seat 2: jonesfi5sh (5445 in chips) 
Seat 3: PhenomPen1 (4925 in chips) 
Seat 4: GrimJoker77 (4980 in chips) 
Seat 5: Bolfra1 (5000 in chips) out of hand (moved from another table into small blind)
Seat 6: Javicho9 (4565 in chips) 
Seat 8: sloty27 (4985 in chips) 
Seat 9: chuny dealer (4985 in chips) 
PsychixtellO: posts the ante 5
jonesfi5sh: posts the ante 5
PhenomPen1: posts the ante 5
GrimJoker77: posts the ante 5
Javicho9: posts the ante 5
sloty27: posts the ante 5
chuny dealer: posts the ante 5
Javicho9: posts small blind 15
sloty27: posts big blind 30
*** HOLE CARDS ***
chuny dealer: calls 30
PsychixtellO: folds 
jonesfi5sh: calls 30
PsychixtellO is disconnected 
PhenomPen1: folds 
GrimJoker77: folds 
Javicho9: folds 
sloty27: checks 
*** FLOP *** [Td 8s 9c]
sloty27: checks 
chuny dealer: checks 
jonesfi5sh: bets 60
sloty27: calls 60
chuny dealer: calls 60
*** TURN *** [Td 8s 9c] [4d]
sloty27: checks 
chuny dealer: checks 
jonesfi5sh: checks 
*** RIVER *** [Td 8s 9c 4d] [9h]
sloty27: checks 
chuny dealer: checks 
PsychixtellO is disconnected 
jonesfi5sh: checks 
*** SHOW DOWN ***
sloty27: shows [Ks 8h] (two pair, Nines and Eights)
chuny dealer: shows [Tc Qd] (two pair, Tens and Nines)
jonesfi5sh: mucks hand 
chuny dealer collected 320 from pot
*** SUMMARY ***
Total pot 320 | Rake 0 
Board [Td 8s 9c 4d 9h]
Seat 1: PsychixtellO folded before Flop (didn't bet)
Seat 2: jonesfi5sh mucked
Seat 3: PhenomPen1 folded before Flop (didn't bet)
Seat 4: GrimJoker77 (button) folded before Flop (didn't bet)
Seat 6: Javicho9 (small blind) folded before Flop
Seat 8: sloty27 (big blind) showed [Ks 8h] and lost with two pair, Nines and Eights
Seat 9: chuny dealer showed [Tc Qd] and won (320) with two pair, Tens and Nines



PokerStars Hand #157575159865: Tournament #1641817620, $7.50+$7.50+$1.50 USD Hold'em No Limit - Level I (15/30) - 2016/08/21 18:32:42 ET
Table '1641817620 27' 9-max Seat #3 is the button
Seat 1: TheKaisa87 (4780 in chips) 
Seat 2: msksevart (4975 in chips) 
Seat 3: SweetieSpy (6295 in chips) 
Seat 4: Mr_Buckworth (5260 in chips) 
Seat 5: ladymadon107 (4360 in chips) 
Seat 6: 6aDyHtry (4360 in chips) 
Seat 7: csfreak (4990 in chips) 
Seat 9: kyzyldurrr (4990 in chips) 
TheKaisa87: posts the ante 5
msksevart: posts the ante 5
SweetieSpy: posts the ante 5
Mr_Buckworth: posts the ante 5
ladymadon107: posts the ante 5
6aDyHtry: posts the ante 5
csfreak: posts the ante 5
kyzyldurrr: posts the ante 5
Mr_Buckworth: posts small blind 15
ladymadon107: posts big blind 30
*** HOLE CARDS ***
6aDyHtry: folds 
csfreak: folds 
kyzyldurrr: raises 60 to 90
TheKaisa87: folds 
msksevart: folds 
SweetieSpy: calls 90
Mr_Buckworth: calls 75
ladymadon107: folds 
*** FLOP *** [7h 3c 7c]
Mr_Buckworth: checks 
kyzyldurrr: bets 136
SweetieSpy: calls 136
Mr_Buckworth: folds 
*** TURN *** [7h 3c 7c] [9s]
kyzyldurrr: bets 244
SweetieSpy: folds 
Uncalled bet (244) returned to kyzyldurrr
kyzyldurrr collected 612 from pot
kyzyldurrr: doesn't show hand 
*** SUMMARY ***
Total pot 612 | Rake 0 
Board [7h 3c 7c 9s]
Seat 1: TheKaisa87 folded before Flop (didn't bet)
Seat 2: msksevart folded before Flop (didn't bet)
Seat 3: SweetieSpy (button) folded on the Turn
Seat 4: Mr_Buckworth (small blind) folded on the Flop
Seat 5: ladymadon107 (big blind) folded before Flop
Seat 6: 6aDyHtry folded before Flop (didn't bet)
Seat 7: csfreak folded before Flop (didn't bet)
Seat 9: kyzyldurrr collected (612)



PokerStars Hand #157575162743: Tournament #1641817620, $7.50+$7.50+$1.50 USD Hold'em No Limit - Level I (15/30) - 2016/08/21 18:32:46 ET
Table '1641817620 42' 9-max Seat #3 is the button
Seat 1: killa187187 (4780 in chips) 
Seat 2: lmiotto88 (5275 in chips) 
Seat 3: Piiirat (4945 in chips) 
Seat 4: skjørring (4960 in chips) 
Seat 5: AcabeiDeSair (4990 in chips) 
Seat 7: ThirtyTw0 (4990 in chips) 
Seat 8: FeFeFeFeFEDE (4990 in chips) 
Seat 9: radekvv777 (10070 in chips) 
killa187187: posts the ante 5
lmiotto88: posts the ante 5
Piiirat: posts the ante 5
skjørring: posts the ante 5
AcabeiDeSair: posts the ante 5
ThirtyTw0: posts the ante 5
FeFeFeFeFEDE: posts the ante 5
radekvv777: posts the ante 5
skjørring: posts small blind 15
AcabeiDeSair: posts big blind 30
*** HOLE CARDS ***
ThirtyTw0: raises 30 to 60
FeFeFeFeFEDE: folds 
radekvv777: folds 
killa187187: folds 
lmiotto88: calls 60
Piiirat: folds 
skjørring: folds 
AcabeiDeSair: folds 
*** FLOP *** [6s 2s 6h]
ThirtyTw0: bets 60
lmiotto88: folds 
Uncalled bet (60) returned to ThirtyTw0
ThirtyTw0 collected 205 from pot
ThirtyTw0: doesn't show hand 
*** SUMMARY ***
Total pot 205 | Rake 0 
Board [6s 2s 6h]
Seat 1: killa187187 folded before Flop (didn't bet)
Seat 2: lmiotto88 folded on the Flop
Seat 3: Piiirat (button) folded before Flop (didn't bet)
Seat 4: skjørring (small blind) folded before Flop
Seat 5: AcabeiDeSair (big blind) folded before Flop
Seat 7: ThirtyTw0 collected (205)
Seat 8: FeFeFeFeFEDE folded before Flop (didn't bet)
Seat 9: radekvv777 folded before Flop (didn't bet)



PokerStars Hand #157575163613: Tournament #1641817620, $7.50+$7.50+$1.50 USD Hold'em No Limit - Level I (15/30) - 2016/08/21 18:32:48 ET
Table '1641817620 52' 9-max Seat #3 is the button
Seat 1: DoubleBBle (5395 in chips) 
Seat 2: FelipeMarlon (4975 in chips) 
Seat 3: michalis009 (4885 in chips) 
Seat 4: Daviderevan (4960 in chips) 
Seat 5: Armin2188 (4990 in chips) 
Seat 6: HORSEPOKER28 (5215 in chips) 
Seat 7: mopeeds87 (4675 in chips) 
Seat 8: vladvladutz (4990 in chips) 
Seat 9: leothefirm (4915 in chips) 
DoubleBBle: posts the ante 5
FelipeMarlon: posts the ante 5
michalis009: posts the ante 5
Daviderevan: posts the ante 5
Armin2188: posts the ante 5
HORSEPOKER28: posts the ante 5
mopeeds87: posts the ante 5
vladvladutz: posts the ante 5
leothefirm: posts the ante 5
Daviderevan: posts small blind 15
Armin2188: posts big blind 30
*** HOLE CARDS ***
HORSEPOKER28: folds 
mopeeds87: folds 
vladvladutz: folds 
leothefirm: folds 
DoubleBBle: raises 60 to 90
FelipeMarlon: folds 
michalis009: folds 
Daviderevan: folds 
Armin2188: folds 
Uncalled bet (60) returned to DoubleBBle
DoubleBBle collected 120 from pot
DoubleBBle: doesn't show hand 
*** SUMMARY ***
Total pot 120 | Rake 0 
Seat 1: DoubleBBle collected (120)
Seat 2: FelipeMarlon folded before Flop (didn't bet)
Seat 3: michalis009 (button) folded before Flop (didn't bet)
Seat 4: Daviderevan (small blind) folded before Flop
Seat 5: Armin2188 (big blind) folded before Flop
Seat 6: HORSEPOKER28 folded before Flop (didn't bet)
Seat 7: mopeeds87 folded before Flop (didn't bet)
Seat 8: vladvladutz folded before Flop (didn't bet)
Seat 9: leothefirm folded before Flop (didn't bet)



PokerStars Hand #157575165534: Tournament #1641817620, $7.50+$7.50+$1.50 USD Hold'em No Limit - Level I (15/30) - 2016/08/21 18:32:51 ET
Table '1641817620 2' 9-max Seat #5 is the button
Seat 1: ChaCha121 (4985 in chips) 
Seat 2: T8yourmoney (4970 in chips) 
Seat 3: mvpalls (4910 in chips) 
Seat 4: Juniorjbm28 (5000 in chips) 
Seat 5: junkshow#1 (4940 in chips) 
Seat 6: Vstoinov (4955 in chips) 
Seat 7: GreenDja (4985 in chips) 
Seat 8: BckDoorFlux (5010 in chips) 
Seat 9: LeaD25 (5460 in chips) 
ChaCha121: posts the ante 5
T8yourmoney: posts the ante 5
mvpalls: posts the ante 5
Juniorjbm28: posts the ante 5
junkshow#1: posts the ante 5
Vstoinov: posts the ante 5
GreenDja: posts the ante 5
BckDoorFlux: posts the ante 5
LeaD25: posts the ante 5
Vstoinov: posts small blind 15
GreenDja: posts big blind 30
*** HOLE CARDS ***
BckDoorFlux: folds 
LeaD25: raises 90 to 120
ChaCha121: calls 120
T8yourmoney: folds 
mvpalls: raises 210 to 330
Juniorjbm28: folds 
junkshow#1: folds 
Vstoinov: calls 315
GreenDja: folds 
LeaD25: calls 210
ChaCha121: calls 210
*** FLOP *** [8d 3h 2c]
Vstoinov: checks 
LeaD25: checks 
ChaCha121: checks 
mvpalls: checks 
*** TURN *** [8d 3h 2c] [2s]
Vstoinov: checks 
LeaD25: bets 480
ChaCha121: calls 480
mvpalls: folds 
Vstoinov: folds 
*** RIVER *** [8d 3h 2c 2s] [3d]
LeaD25: bets 1020
ChaCha121: calls 1020
*** SHOW DOWN ***
LeaD25: shows [Ts Th] (two pair, Tens and Threes)
ChaCha121: mucks hand 
LeaD25 collected 4395 from pot
*** SUMMARY ***
Total pot 4395 | Rake 0 
Board [8d 3h 2c 2s 3d]
Seat 1: ChaCha121 mucked
Seat 2: T8yourmoney folded before Flop (didn't bet)
Seat 3: mvpalls folded on the Turn
Seat 4: Juniorjbm28 folded before Flop (didn't bet)
Seat 5: junkshow#1 (button) folded before Flop (didn't bet)
Seat 6: Vstoinov (small blind) folded on the Turn
Seat 7: GreenDja (big blind) folded before Flop
Seat 8: BckDoorFlux folded before Flop (didn't bet)
Seat 9: LeaD25 showed [Ts Th] and won (4395) with two pair, Tens and Threes



PokerStars Hand #157575166560: Tournament #1641817620, $7.50+$7.50+$1.50 USD Hold'em No Limit - Level I (15/30) - 2016/08/21 18:32:52 ET
Table '1641817620 51' 9-max Seat #4 is the button
Seat 1: yys000 (4985 in chips) 
Seat 2: paulotury (4970 in chips) 
Seat 3: kozloeric (4873 in chips) 
Seat 4: bastef79 (4851 in chips) 
Seat 5: cusirc (4955 in chips) 
Seat 6: demonas05 (5374 in chips) 
Seat 7: boostyz (4985 in chips) 
Seat 8: Garfild740 (4985 in chips) 
Seat 9: Kalvar1 (5022 in chips) 
yys000: posts the ante 5
paulotury: posts the ante 5
kozloeric: posts the ante 5
bastef79: posts the ante 5
cusirc: posts the ante 5
demonas05: posts the ante 5
boostyz: posts the ante 5
Garfild740: posts the ante 5
Kalvar1: posts the ante 5
cusirc: posts small blind 15
demonas05: posts big blind 30
*** HOLE CARDS ***
boostyz: folds 
Garfild740: folds 
Kalvar1: calls 30
yys000: folds 
paulotury: raises 75 to 105
kozloeric: folds 
bastef79: folds 
cusirc: folds 
demonas05: folds 
Kalvar1: calls 75
*** FLOP *** [Js 4s 6d]
Kalvar1: checks 
paulotury: bets 125
Kalvar1: calls 125
*** TURN *** [Js 4s 6d] [9c]
Kalvar1: checks 
paulotury: bets 250
Kalvar1: calls 250
*** RIVER *** [Js 4s 6d 9c] [3s]
Kalvar1: checks 
paulotury: bets 550
Kalvar1: folds 
Uncalled bet (550) returned to paulotury
paulotury collected 1050 from pot
*** SUMMARY ***
Total pot 1050 | Rake 0 
Board [Js 4s 6d 9c 3s]
Seat 1: yys000 folded before Flop (didn't bet)
Seat 2: paulotury collected (1050)
Seat 3: kozloeric folded before Flop (didn't bet)
Seat 4: bastef79 (button) folded before Flop (didn't bet)
Seat 5: cusirc (small blind) folded before Flop
Seat 6: demonas05 (big blind) folded before Flop
Seat 7: boostyz folded before Flop (didn't bet)
Seat 8: Garfild740 folded before Flop (didn't bet)
Seat 9: Kalvar1 folded on the River



PokerStars Hand #157575167051: Tournament #1641817620, $7.50+$7.50+$1.50 USD Hold'em No Limit - Level I (15/30) - 2016/08/21 18:32:53 ET
Table '1641817620 10' 9-max Seat #5 is the button
Seat 1: VANDECO174 (4980 in chips) 
Seat 2: Be Anger (4725 in chips) 
Seat 3: mickyryan (5025 in chips) 
Seat 4: silveira1879 (5355 in chips) 
Seat 5: AndyLou27 (4935 in chips) 
Seat 6: I M GOIN OFF (4950 in chips) 
Seat 7: Nuazo (4980 in chips) 
Seat 8: damibor (5130 in chips) 
Seat 9: Stokesy05 (4920 in chips) 
VANDECO174: posts the ante 5
Be Anger: posts the ante 5
mickyryan: posts the ante 5
silveira1879: posts the ante 5
AndyLou27: posts the ante 5
I M GOIN OFF: posts the ante 5
Nuazo: posts the ante 5
damibor: posts the ante 5
Stokesy05: posts the ante 5
I M GOIN OFF: posts small blind 15
Nuazo: posts big blind 30
*** HOLE CARDS ***
damibor: folds 
Stokesy05: folds 
VANDECO174: folds 
Be Anger: folds 
mickyryan: folds 
silveira1879: folds 
AndyLou27: raises 30 to 60
I M GOIN OFF: folds 
Nuazo: calls 30
*** FLOP *** [8h 2c Kc]
Nuazo: checks 
AndyLou27: checks 
*** TURN *** [8h 2c Kc] [5d]
Nuazo: checks 
AndyLou27: checks 
*** RIVER *** [8h 2c Kc 5d] [8c]
Nuazo: checks 
AndyLou27: checks 
*** SHOW DOWN ***
Nuazo: shows [3h 4h] (a pair of Eights)
AndyLou27: shows [6d Ac] (a pair of Eights - Ace kicker)
AndyLou27 collected 180 from pot
*** SUMMARY ***
Total pot 180 | Rake 0 
Board [8h 2c Kc 5d 8c]
Seat 1: VANDECO174 folded before Flop (didn't bet)
Seat 2: Be Anger folded before Flop (didn't bet)
Seat 3: mickyryan folded before Flop (didn't bet)
Seat 4: silveira1879 folded before Flop (didn't bet)
Seat 5: AndyLou27 (button) showed [6d Ac] and won (180) with a pair of Eights
Seat 6: I M GOIN OFF (small blind) folded before Flop
Seat 7: Nuazo (big blind) showed [3h 4h] and lost with a pair of Eights
Seat 8: damibor folded before Flop (didn't bet)
Seat 9: Stokesy05 folded before Flop (didn't bet)



PokerStars Hand #157575167140: Tournament #1641817620, $7.50+$7.50+$1.50 USD Hold'em No Limit - Level I (15/30) - 2016/08/21 18:32:53 ET
Table '1641817620 40' 9-max Seat #4 is the button
Seat 1: Shiryu100 (4985 in chips) 
Seat 2: nico122527 (4940 in chips) 
Seat 3: ilico (4850 in chips) 
Seat 4: Mr_Giiba (5045 in chips) 
Seat 5: mario342 (5360 in chips) 
Seat 6: MON3Y$HOT (4985 in chips) 
Seat 7: hyratsch (4865 in chips) 
Seat 8: vaggelis1982 (4985 in chips) 
Seat 9: kafu123 (4985 in chips) is sitting out
Shiryu100: posts the ante 5
nico122527: posts the ante 5
ilico: posts the ante 5
Mr_Giiba: posts the ante 5
mario342: posts the ante 5
MON3Y$HOT: posts the ante 5
hyratsch: posts the ante 5
vaggelis1982: posts the ante 5
kafu123: posts the ante 5
mario342: posts small blind 15
MON3Y$HOT: posts big blind 30
*** HOLE CARDS ***
hyratsch: folds 
vaggelis1982: folds 
kafu123: folds 
Shiryu100: folds 
nico122527: folds 
ilico: folds 
Mr_Giiba: folds 
mario342: raises 30 to 60
MON3Y$HOT: raises 165 to 225
mario342: calls 165
*** FLOP *** [5d 7c 8h]
mario342: checks 
MON3Y$HOT: checks 
*** TURN *** [5d 7c 8h] [Ah]
mario342: checks 
MON3Y$HOT: bets 270
mario342: folds 
Uncalled bet (270) returned to MON3Y$HOT
MON3Y$HOT collected 495 from pot
MON3Y$HOT: doesn't show hand 
*** SUMMARY ***
Total pot 495 | Rake 0 
Board [5d 7c 8h Ah]
Seat 1: Shiryu100 folded before Flop (didn't bet)
Seat 2: nico122527 folded before Flop (didn't bet)
Seat 3: ilico folded before Flop (didn't bet)
Seat 4: Mr_Giiba (button) folded before Flop (didn't bet)
Seat 5: mario342 (small blind) folded on the Turn
Seat 6: MON3Y$HOT (big blind) collected (495)
Seat 7: hyratsch folded before Flop (didn't bet)
Seat 8: vaggelis1982 folded before Flop (didn't bet)
Seat 9: kafu123 folded before Flop (didn't bet)



PokerStars Hand #157575167236: Tournament #1641817620, $7.50+$7.50+$1.50 USD Hold'em No Limit - Level I (15/30) - 2016/08/21 18:32:53 ET
Table '1641817620 48' 9-max Seat #3 is the button
Seat 1: soft8981 (4696 in chips) 
Seat 2: getatore (4780 in chips) 
Seat 3: Serg2407 (4855 in chips) 
Seat 4: Zareta (4900 in chips) 
Seat 5: NSStefan (4990 in chips) 
Seat 6: ATE13 (4990 in chips) 
Seat 7: BRUCE999999 (5275 in chips) 
Seat 8: howtown (4696 in chips) 
Seat 9: qcouest (5818 in chips) 
soft8981: posts the ante 5
getatore: posts the ante 5
Serg2407: posts the ante 5
Zareta: posts the ante 5
NSStefan: posts the ante 5
ATE13: posts the ante 5
BRUCE999999: posts the ante 5
howtown: posts the ante 5
qcouest: posts the ante 5
Zareta: posts small blind 15
NSStefan: posts big blind 30
*** HOLE CARDS ***
ATE13: folds 
BRUCE999999: raises 30 to 60
howtown: folds 
qcouest: folds 
soft8981: folds 
getatore: raises 210 to 270
Serg2407: folds 
Zareta: folds 
NSStefan: folds 
BRUCE999999: calls 210
*** FLOP *** [As 4c 5h]
BRUCE999999: checks 
getatore: bets 300
BRUCE999999: folds 
Uncalled bet (300) returned to getatore
getatore collected 630 from pot
getatore: doesn't show hand 
*** SUMMARY ***
Total pot 630 | Rake 0 
Board [As 4c 5h]
Seat 1: soft8981 folded before Flop (didn't bet)
Seat 2: getatore collected (630)
Seat 3: Serg2407 (button) folded before Flop (didn't bet)
Seat 4: Zareta (small blind) folded before Flop
Seat 5: NSStefan (big blind) folded before Flop
Seat 6: ATE13 folded before Flop (didn't bet)
Seat 7: BRUCE999999 folded on the Flop
Seat 8: howtown folded before Flop (didn't bet)
Seat 9: qcouest folded before Flop (didn't bet)



PokerStars Hand #157575167691: Tournament #1641817620, $7.50+$7.50+$1.50 USD Hold'em No Limit - Level I (15/30) - 2016/08/21 18:32:54 ET
Table '1641817620 49' 9-max Seat #3 is the button
Seat 1: Mi2xa (4990 in chips) 
Seat 2: abig89 (5589 in chips) 
Seat 3: nickviso (4945 in chips) 
Seat 4: Colt Cardz (5000 in chips) out of hand (moved from another table into small blind)
Seat 5: Can'tStopMee (4960 in chips) 
Seat 6: PaulDaPole (6113 in chips) 
Seat 7: Prebendk (3690 in chips) 
Seat 8: VixenKoala (4990 in chips) 
Seat 9: logos1428 (4728 in chips) 
Mi2xa: posts the ante 5
abig89: posts the ante 5
nickviso: posts the ante 5
Can'tStopMee: posts the ante 5
PaulDaPole: posts the ante 5
Prebendk: posts the ante 5
VixenKoala: posts the ante 5
logos1428: posts the ante 5
Can'tStopMee: posts small blind 15
PaulDaPole: posts big blind 30
*** HOLE CARDS ***
Prebendk: raises 60 to 90
VixenKoala: folds 
logos1428: folds 
Mi2xa: folds 
abig89: folds 
nickviso: folds 
Can'tStopMee: raises 210 to 300
PaulDaPole: folds 
Prebendk: calls 210
*** FLOP *** [9s Tc 6d]
Can'tStopMee: bets 375
Prebendk: calls 375
*** TURN *** [9s Tc 6d] [Ac]
Can'tStopMee: checks 
Prebendk: checks 
*** RIVER *** [9s Tc 6d Ac] [5c]
Can'tStopMee: checks 
Prebendk: bets 3010 and is all-in
Can'tStopMee: folds 
Uncalled bet (3010) returned to Prebendk
Prebendk collected 1420 from pot
Prebendk: doesn't show hand 
*** SUMMARY ***
Total pot 1420 | Rake 0 
Board [9s Tc 6d Ac 5c]
Seat 1: Mi2xa folded before Flop (didn't bet)
Seat 2: abig89 folded before Flop (didn't bet)
Seat 3: nickviso (button) folded before Flop (didn't bet)
Seat 5: Can'tStopMee (small blind) folded on the River
Seat 6: PaulDaPole (big blind) folded before Flop
Seat 7: Prebendk collected (1420)
Seat 8: VixenKoala folded before Flop (didn't bet)
Seat 9: logos1428 folded before Flop (didn't bet)



PokerStars Hand #157575168825: Tournament #1641817620, $7.50+$7.50+$1.50 USD Hold'em No Limit - Level I (15/30) - 2016/08/21 18:32:56 ET
Table '1641817620 57' 9-max Seat #3 is the button
Seat 1: pedroh2010 (10130 in chips) 
Seat 3: ovekas (5125 in chips) 
Seat 4: ALWAYSBRAVES (4960 in chips) 
Seat 5: BaDBeaT_AK85 (4990 in chips) 
Seat 6: kachumban (4915 in chips) 
Seat 7: ZodiakGB (4990 in chips) 
Seat 8: MeortheMrs (4900 in chips) 
Seat 9: andreiuc (4990 in chips) 
pedroh2010: posts the ante 5
ovekas: posts the ante 5
ALWAYSBRAVES: posts the ante 5
BaDBeaT_AK85: posts the ante 5
kachumban: posts the ante 5
ZodiakGB: posts the ante 5
MeortheMrs: posts the ante 5
andreiuc: posts the ante 5
ALWAYSBRAVES: posts small blind 15
BaDBeaT_AK85: posts big blind 30
*** HOLE CARDS ***
kachumban: folds 
ZodiakGB: folds 
MeortheMrs: folds 
andreiuc: folds 
pedroh2010: calls 30
ovekas: folds 
ALWAYSBRAVES: folds 
BaDBeaT_AK85: checks 
*** FLOP *** [6h As 7d]
BaDBeaT_AK85: checks 
pedroh2010: checks 
*** TURN *** [6h As 7d] [9s]
BaDBeaT_AK85: checks 
pedroh2010: checks 
*** RIVER *** [6h As 7d 9s] [Qc]
BaDBeaT_AK85: checks 
pedroh2010: checks 
*** SHOW DOWN ***
BaDBeaT_AK85: shows [3c 2s] (high card Ace)
pedroh2010: shows [Kh Js] (high card Ace - King kicker)
pedroh2010 collected 115 from pot
*** SUMMARY ***
Total pot 115 | Rake 0 
Board [6h As 7d 9s Qc]
Seat 1: pedroh2010 showed [Kh Js] and won (115) with high card Ace
Seat 3: ovekas (button) folded before Flop (didn't bet)
Seat 4: ALWAYSBRAVES (small blind) folded before Flop
Seat 5: BaDBeaT_AK85 (big blind) showed [3c 2s] and lost with high card Ace
Seat 6: kachumban folded before Flop (didn't bet)
Seat 7: ZodiakGB folded before Flop (didn't bet)
Seat 8: MeortheMrs folded before Flop (didn't bet)
Seat 9: andreiuc folded before Flop (didn't bet)



PokerStars Hand #157575170626: Tournament #1641817620, $7.50+$7.50+$1.50 USD Hold'em No Limit - Level I (15/30) - 2016/08/21 18:32:59 ET
Table '1641817620 21' 9-max Seat #4 is the button
Seat 1: apaixtos1 (5645 in chips) 
Seat 2: ukr_durrrr (4850 in chips) 
Seat 3: ultgamb (4940 in chips) 
Seat 4: fishin1981 (4895 in chips) 
Seat 5: jeroma123 (4430 in chips) 
Seat 6: olleggi (5075 in chips) 
Seat 7: pokerlazik (4985 in chips) 
Seat 8: pokerist2692 (5195 in chips) 
Seat 9: Ferrazz (4985 in chips) 
apaixtos1: posts the ante 5
ukr_durrrr: posts the ante 5
ultgamb: posts the ante 5
fishin1981: posts the ante 5
jeroma123: posts the ante 5
olleggi: posts the ante 5
pokerlazik: posts the ante 5
pokerist2692: posts the ante 5
Ferrazz: posts the ante 5
jeroma123: posts small blind 15
olleggi: posts big blind 30
*** HOLE CARDS ***
pokerlazik: folds 
pokerist2692: folds 
Ferrazz: folds 
apaixtos1: calls 30
ukr_durrrr: folds 
ultgamb: folds 
fishin1981: folds 
jeroma123: raises 90 to 120
olleggi: folds 
apaixtos1: calls 90
*** FLOP *** [Ac 7d Jd]
jeroma123: bets 120
apaixtos1: folds 
Uncalled bet (120) returned to jeroma123
jeroma123 collected 315 from pot
jeroma123: doesn't show hand 
*** SUMMARY ***
Total pot 315 | Rake 0 
Board [Ac 7d Jd]
Seat 1: apaixtos1 folded on the Flop
Seat 2: ukr_durrrr folded before Flop (didn't bet)
Seat 3: ultgamb folded before Flop (didn't bet)
Seat 4: fishin1981 (button) folded before Flop (didn't bet)
Seat 5: jeroma123 (small blind) collected (315)
Seat 6: olleggi (big blind) folded before Flop
Seat 7: pokerlazik folded before Flop (didn't bet)
Seat 8: pokerist2692 folded before Flop (didn't bet)
Seat 9: Ferrazz folded before Flop (didn't bet)



PokerStars Hand #157575171799: Tournament #1641817620, $7.50+$7.50+$1.50 USD Hold'em No Limit - Level I (15/30) - 2016/08/21 18:33:00 ET
Table '1641817620 39' 9-max Seat #4 is the button
Seat 1: BuyMeBMW (4985 in chips) 
Seat 2: ahaknh (4955 in chips) 
Seat 3: Crim44 (5517 in chips) 
Seat 4: Neo_gracz (4940 in chips) 
Seat 5: rinxa30 (5000 in chips) out of hand (moved from another table into small blind)
Seat 6: TxsFrUrMoney (4955 in chips) 
Seat 7: j.williams94 (5195 in chips) 
Seat 8: 88K@la88 (4493 in chips) 
Seat 9: Foggy56 (4835 in chips) 
BuyMeBMW: posts the ante 5
ahaknh: posts the ante 5
Crim44: posts the ante 5
Neo_gracz: posts the ante 5
TxsFrUrMoney: posts the ante 5
j.williams94: posts the ante 5
88K@la88: posts the ante 5
Foggy56: posts the ante 5
TxsFrUrMoney: posts small blind 15
j.williams94: posts big blind 30
*** HOLE CARDS ***
88K@la88: folds 
Foggy56: folds 
BuyMeBMW: folds 
ahaknh: raises 30 to 60
Crim44: calls 60
Neo_gracz: folds 
TxsFrUrMoney: calls 45
j.williams94: calls 30
*** FLOP *** [2c Js 5s]
TxsFrUrMoney: bets 112
j.williams94: folds 
ahaknh: calls 112
Crim44: folds 
*** TURN *** [2c Js 5s] [5c]
TxsFrUrMoney: bets 270
ahaknh: calls 270
*** RIVER *** [2c Js 5s 5c] [6h]
TxsFrUrMoney: bets 480
ahaknh: folds 
Uncalled bet (480) returned to TxsFrUrMoney
TxsFrUrMoney collected 1044 from pot
*** SUMMARY ***
Total pot 1044 | Rake 0 
Board [2c Js 5s 5c 6h]
Seat 1: BuyMeBMW folded before Flop (didn't bet)
Seat 2: ahaknh folded on the River
Seat 3: Crim44 folded on the Flop
Seat 4: Neo_gracz (button) folded before Flop (didn't bet)
Seat 6: TxsFrUrMoney (small blind) collected (1044)
Seat 7: j.williams94 (big blind) folded on the Flop
Seat 8: 88K@la88 folded before Flop (didn't bet)
Seat 9: Foggy56 folded before Flop (didn't bet)



PokerStars Hand #157575172047: Tournament #1641817620, $7.50+$7.50+$1.50 USD Hold'em No Limit - Level I (15/30) - 2016/08/21 18:33:01 ET
Table '1641817620 34' 9-max Seat #4 is the button
Seat 1: Zukertort (4985 in chips) is sitting out
Seat 2: AngelBerley (4970 in chips) 
Seat 3: Zigslick (4940 in chips) 
Seat 4: Snabers (4835 in chips) 
Seat 5: juggaletto (4775 in chips) 
Seat 6: virtus213 (4910 in chips) 
Seat 7: Poher42 (5270 in chips) 
Seat 8: S.FILTH (4985 in chips) 
Seat 9: omar miete (5330 in chips) 
Zukertort: posts the ante 5
AngelBerley: posts the ante 5
Zigslick: posts the ante 5
Snabers: posts the ante 5
juggaletto: posts the ante 5
virtus213: posts the ante 5
Poher42: posts the ante 5
S.FILTH: posts the ante 5
omar miete: posts the ante 5
juggaletto: posts small blind 15
virtus213: posts big blind 30
*** HOLE CARDS ***
Poher42: folds 
S.FILTH: folds 
omar miete: raises 45 to 75
Zukertort: folds 
AngelBerley: folds 
Zigslick: folds 
Snabers: calls 75
juggaletto: calls 60
virtus213: calls 45
*** FLOP *** [Tc 2s Th]
juggaletto: checks 
virtus213: checks 
omar miete: checks 
Snabers: checks 
*** TURN *** [Tc 2s Th] [4h]
juggaletto: bets 345
virtus213: folds 
omar miete: folds 
Snabers: folds 
Uncalled bet (345) returned to juggaletto
juggaletto collected 345 from pot
juggaletto: doesn't show hand 
*** SUMMARY ***
Total pot 345 | Rake 0 
Board [Tc 2s Th 4h]
Seat 1: Zukertort folded before Flop (didn't bet)
Seat 2: AngelBerley folded before Flop (didn't bet)
Seat 3: Zigslick folded before Flop (didn't bet)
Seat 4: Snabers (button) folded on the Turn
Seat 5: juggaletto (small blind) collected (345)
Seat 6: virtus213 (big blind) folded on the Turn
Seat 7: Poher42 folded before Flop (didn't bet)
Seat 8: S.FILTH folded before Flop (didn't bet)
Seat 9: omar miete folded on the Turn



PokerStars Hand #157575172063: Tournament #1641817620, $7.50+$7.50+$1.50 USD Hold'em No Limit - Level I (15/30) - 2016/08/21 18:33:01 ET
Table '1641817620 24' 9-max Seat #4 is the button
Seat 1: heyyy presto (5570 in chips) 
Seat 2: BOW300 (4925 in chips) 
Seat 3: muskto (4690 in chips) 
Seat 4: jt3x87 (4895 in chips) 
Seat 5: PhaniaX (4955 in chips) 
Seat 6: pisti801 (4985 in chips) 
Seat 7: luckydayn (5150 in chips) 
Seat 8: trabey (4845 in chips) 
Seat 9: Quickcard (4985 in chips) 
heyyy presto: posts the ante 5
BOW300: posts the ante 5
muskto: posts the ante 5
jt3x87: posts the ante 5
PhaniaX: posts the ante 5
pisti801: posts the ante 5
luckydayn: posts the ante 5
trabey: posts the ante 5
Quickcard: posts the ante 5
PhaniaX: posts small blind 15
pisti801: posts big blind 30
*** HOLE CARDS ***
luckydayn: folds 
trabey: folds 
Quickcard: calls 30
heyyy presto: folds 
BOW300: calls 30
muskto: folds 
jt3x87: calls 30
PhaniaX: calls 15
pisti801: checks 
*** FLOP *** [3c 9c Qs]
PhaniaX: checks 
pisti801: bets 64
Quickcard: folds 
BOW300: folds 
jt3x87: folds 
PhaniaX: calls 64
*** TURN *** [3c 9c Qs] [Td]
PhaniaX: checks 
pisti801: bets 142
PhaniaX: calls 142
*** RIVER *** [3c 9c Qs Td] [5c]
PhaniaX: checks 
pisti801: checks 
*** SHOW DOWN ***
PhaniaX: shows [Ks 9d] (a pair of Nines)
pisti801: shows [3s Qc] (two pair, Queens and Threes)
pisti801 collected 607 from pot
*** SUMMARY ***
Total pot 607 | Rake 0 
Board [3c 9c Qs Td 5c]
Seat 1: heyyy presto folded before Flop (didn't bet)
Seat 2: BOW300 folded on the Flop
Seat 3: muskto folded before Flop (didn't bet)
Seat 4: jt3x87 (button) folded on the Flop
Seat 5: PhaniaX (small blind) showed [Ks 9d] and lost with a pair of Nines
Seat 6: pisti801 (big blind) showed [3s Qc] and won (607) with two pair, Queens and Threes
Seat 7: luckydayn folded before Flop (didn't bet)
Seat 8: trabey folded before Flop (didn't bet)
Seat 9: Quickcard folded on the Flop



PokerStars Hand #157575172106: Tournament #1641817620, $7.50+$7.50+$1.50 USD Hold'em No Limit - Level I (15/30) - 2016/08/21 18:33:01 ET
Table '1641817620 56' 9-max Seat #3 is the button
Seat 1: PpME_Oe_87 (4990 in chips) 
Seat 2: NrRockeT9 (4840 in chips) 
Seat 3: DontFoldItPL (5080 in chips) 
Seat 4: cla11 (4360 in chips) 
Seat 5: luvlust (4780 in chips) 
Seat 6: pedro300390 (4990 in chips) 
Seat 7: rickyrdmy (4990 in chips) 
Seat 8: M.J.466 (5980 in chips) 
Seat 9: Exan13 (4990 in chips) 
PpME_Oe_87: posts the ante 5
NrRockeT9: posts the ante 5
DontFoldItPL: posts the ante 5
cla11: posts the ante 5
luvlust: posts the ante 5
pedro300390: posts the ante 5
rickyrdmy: posts the ante 5
M.J.466: posts the ante 5
Exan13: posts the ante 5
cla11: posts small blind 15
luvlust: posts big blind 30
*** HOLE CARDS ***
pedro300390: folds 
rickyrdmy: folds 
M.J.466: folds 
Exan13: folds 
PpME_Oe_87: folds 
NrRockeT9: calls 30
DontFoldItPL: raises 75 to 105
cla11: calls 90
luvlust: folds 
NrRockeT9: calls 75
*** FLOP *** [2s Th Kh]
cla11: checks 
NrRockeT9: checks 
DontFoldItPL: checks 
*** TURN *** [2s Th Kh] [6c]
cla11: bets 450
NrRockeT9: folds 
DontFoldItPL: calls 450
*** RIVER *** [2s Th Kh 6c] [As]
cla11: bets 645
DontFoldItPL: calls 645
*** SHOW DOWN ***
cla11: shows [2d 2h] (three of a kind, Deuces)
DontFoldItPL: mucks hand 
cla11 collected 2580 from pot
*** SUMMARY ***
Total pot 2580 | Rake 0 
Board [2s Th Kh 6c As]
Seat 1: PpME_Oe_87 folded before Flop (didn't bet)
Seat 2: NrRockeT9 folded on the Turn
Seat 3: DontFoldItPL (button) mucked
Seat 4: cla11 (small blind) showed [2d 2h] and won (2580) with three of a kind, Deuces
Seat 5: luvlust (big blind) folded before Flop
Seat 6: pedro300390 folded before Flop (didn't bet)
Seat 7: rickyrdmy folded before Flop (didn't bet)
Seat 8: M.J.466 folded before Flop (didn't bet)
Seat 9: Exan13 folded before Flop (didn't bet)



PokerStars Hand #157575172882: Tournament #1641817620, $7.50+$7.50+$1.50 USD Hold'em No Limit - Level I (15/30) - 2016/08/21 18:33:02 ET
Table '1641817620 23' 9-max Seat #4 is the button
Seat 1: Cepillo (4985 in chips) 
Seat 2: erfan86 (4970 in chips) 
Seat 3: derkimos (4865 in chips) 
Seat 4: Carlos11497 (4940 in chips) 
Seat 5: MickJagger86 (4955 in chips) 
Seat 7: jradjo21 (4985 in chips) 
Seat 8: kajarana (4985 in chips) 
Seat 9: -MCASLAN7- (5105 in chips) 
Cepillo: posts the ante 5
erfan86: posts the ante 5
derkimos: posts the ante 5
Carlos11497: posts the ante 5
MickJagger86: posts the ante 5
jradjo21: posts the ante 5
kajarana: posts the ante 5
-MCASLAN7-: posts the ante 5
MickJagger86: posts small blind 15
jradjo21: posts big blind 30
*** HOLE CARDS ***
kajarana: folds 
-MCASLAN7-: raises 90 to 120
Cepillo: folds 
erfan86: folds 
derkimos: folds 
Carlos11497: folds 
MickJagger86: folds 
jradjo21: folds 
Uncalled bet (90) returned to -MCASLAN7-
-MCASLAN7- collected 115 from pot
-MCASLAN7-: doesn't show hand 
*** SUMMARY ***
Total pot 115 | Rake 0 
Seat 1: Cepillo folded before Flop (didn't bet)
Seat 2: erfan86 folded before Flop (didn't bet)
Seat 3: derkimos folded before Flop (didn't bet)
Seat 4: Carlos11497 (button) folded before Flop (didn't bet)
Seat 5: MickJagger86 (small blind) folded before Flop
Seat 7: jradjo21 (big blind) folded before Flop
Seat 8: kajarana folded before Flop (didn't bet)
Seat 9: -MCASLAN7- collected (115)



PokerStars Hand #157575173450: Tournament #1641817620, $7.50+$7.50+$1.50 USD Hold'em No Limit - Level I (15/30) - 2016/08/21 18:33:03 ET
Table '1641817620 9' 9-max Seat #4 is the button
Seat 1: kake40 (4895 in chips) 
Seat 2: Cergey1387 (4370 in chips) 
Seat 3: portugajr007 (5698 in chips) 
Seat 4: punkhead89 (5532 in chips) 
Seat 5: nO bUsTeD (4745 in chips) 
Seat 7: Cuzco83 (4985 in chips) 
Seat 8: maurogynppp (4985 in chips) 
Seat 9: N1COLOSO (4805 in chips) 
kake40: posts the ante 5
Cergey1387: posts the ante 5
portugajr007: posts the ante 5
punkhead89: posts the ante 5
nO bUsTeD: posts the ante 5
Cuzco83: posts the ante 5
maurogynppp: posts the ante 5
N1COLOSO: posts the ante 5
nO bUsTeD: posts small blind 15
Cuzco83: posts big blind 30
*** HOLE CARDS ***
maurogynppp: folds 
N1COLOSO: folds 
kake40: folds 
Cergey1387: raises 4335 to 4365 and is all-in
portugajr007: folds 
punkhead89: folds 
nO bUsTeD: folds 
Cuzco83: folds 
Uncalled bet (4335) returned to Cergey1387
Cergey1387 collected 115 from pot
*** SUMMARY ***
Total pot 115 | Rake 0 
Seat 1: kake40 folded before Flop (didn't bet)
Seat 2: Cergey1387 collected (115)
Seat 3: portugajr007 folded before Flop (didn't bet)
Seat 4: punkhead89 (button) folded before Flop (didn't bet)
Seat 5: nO bUsTeD (small blind) folded before Flop
Seat 7: Cuzco83 (big blind) folded before Flop
Seat 8: maurogynppp folded before Flop (didn't bet)
Seat 9: N1COLOSO folded before Flop (didn't bet)



PokerStars Hand #157575173620: Tournament #1641817620, $7.50+$7.50+$1.50 USD Hold'em No Limit - Level I (15/30) - 2016/08/21 18:33:03 ET
Table '1641817620 1' 9-max Seat #5 is the button
Seat 1: mattyonuts (5138 in chips) 
Seat 2: topaipi (5164 in chips) 
Seat 3: MAMOHT_T (4940 in chips) 
Seat 4: ManMaPayé (5000 in chips) 
Seat 5: LADIEFJ (6005 in chips) 
Seat 6: TheGuerreiro (4733 in chips) 
Seat 8: K. Ichinose (4985 in chips) 
Seat 9: AdiMutu1001 (4985 in chips) 
mattyonuts: posts the ante 5
topaipi: posts the ante 5
MAMOHT_T: posts the ante 5
ManMaPayé: posts the ante 5
LADIEFJ: posts the ante 5
TheGuerreiro: posts the ante 5
K. Ichinose: posts the ante 5
AdiMutu1001: posts the ante 5
TheGuerreiro: posts small blind 15
K. Ichinose: posts big blind 30
*** HOLE CARDS ***
AdiMutu1001: raises 46 to 76
mattyonuts: folds 
topaipi: folds 
MAMOHT_T: folds 
ManMaPayé: folds 
LADIEFJ: folds 
TheGuerreiro: folds 
K. Ichinose: calls 46
*** FLOP *** [Tc Th 4d]
K. Ichinose: checks 
AdiMutu1001: bets 93
K. Ichinose: folds 
Uncalled bet (93) returned to AdiMutu1001
AdiMutu1001 collected 207 from pot
*** SUMMARY ***
Total pot 207 | Rake 0 
Board [Tc Th 4d]
Seat 1: mattyonuts folded before Flop (didn't bet)
Seat 2: topaipi folded before Flop (didn't bet)
Seat 3: MAMOHT_T folded before Flop (didn't bet)
Seat 4: ManMaPayé folded before Flop (didn't bet)
Seat 5: LADIEFJ (button) folded before Flop (didn't bet)
Seat 6: TheGuerreiro (small blind) folded before Flop
Seat 8: K. Ichinose (big blind) folded on the Flop
Seat 9: AdiMutu1001 collected (207)



PokerStars Hand #157575174796: Tournament #1641817620, $7.50+$7.50+$1.50 USD Hold'em No Limit - Level I (15/30) - 2016/08/21 18:33:05 ET
Table '1641817620 59' 9-max Seat #4 is the button
Seat 1: pitoco2012 (5135 in chips) 
Seat 2: M_ORBIT_M (4970 in chips) 
Seat 3: alemaowe (4940 in chips) 
Seat 4: jan monster (4539 in chips) 
Seat 5: laiyitui (4895 in chips) 
Seat 7: 88Xin88 (5075 in chips) 
Seat 8: Enio Pinho (5542 in chips) 
Seat 9: Robsn087 (4919 in chips) 
pitoco2012: posts the ante 5
M_ORBIT_M: posts the ante 5
alemaowe: posts the ante 5
jan monster: posts the ante 5
laiyitui: posts the ante 5
88Xin88: posts the ante 5
Enio Pinho: posts the ante 5
Robsn087: posts the ante 5
laiyitui: posts small blind 15
88Xin88: posts big blind 30
*** HOLE CARDS ***
Enio Pinho: folds 
Robsn087: folds 
pitoco2012: calls 30
M_ORBIT_M: raises 90 to 120
alemaowe: folds 
jan monster: folds 
laiyitui: folds 
88Xin88: folds 
pitoco2012: calls 90
*** FLOP *** [Ad 9c 4s]
pitoco2012: checks 
M_ORBIT_M: bets 180
pitoco2012: folds 
Uncalled bet (180) returned to M_ORBIT_M
M_ORBIT_M collected 325 from pot
*** SUMMARY ***
Total pot 325 | Rake 0 
Board [Ad 9c 4s]
Seat 1: pitoco2012 folded on the Flop
Seat 2: M_ORBIT_M collected (325)
Seat 3: alemaowe folded before Flop (didn't bet)
Seat 4: jan monster (button) folded before Flop (didn't bet)
Seat 5: laiyitui (small blind) folded before Flop
Seat 7: 88Xin88 (big blind) folded before Flop
Seat 8: Enio Pinho folded before Flop (didn't bet)
Seat 9: Robsn087 folded before Flop (didn't bet)



PokerStars Hand #157575175467: Tournament #1641817620, $7.50+$7.50+$1.50 USD Hold'em No Limit - Level I (15/30) - 2016/08/21 18:33:06 ET
Table '1641817620 17' 9-max Seat #7 is the button
Seat 1: guitarist68 (5145 in chips) 
Seat 2: Anton163reg (4960 in chips) 
Seat 3: GoldenBeeM (4930 in chips) 
Seat 5: happyminh (4995 in chips) 
Seat 6: dekota222 (4930 in chips) 
Seat 7: rooney69 (5315 in chips) 
Seat 8: Cechinator (5000 in chips) out of hand (moved from another table into small blind)
Seat 9: Samburger514 (5095 in chips) 
guitarist68: posts the ante 5
Anton163reg: posts the ante 5
GoldenBeeM: posts the ante 5
happyminh: posts the ante 5
dekota222: posts the ante 5
rooney69: posts the ante 5
Samburger514: posts the ante 5
Samburger514: posts small blind 15
guitarist68: posts big blind 30
*** HOLE CARDS ***
Anton163reg: raises 60 to 90
GoldenBeeM: folds 
happyminh: raises 60 to 150
dekota222: folds 
rooney69: folds 
Samburger514: folds 
guitarist68: calls 120
Anton163reg: calls 60
*** FLOP *** [Jc Th Td]
guitarist68: checks 
Anton163reg: checks 
happyminh: checks 
*** TURN *** [Jc Th Td] [2h]
guitarist68: checks 
Anton163reg: checks 
happyminh: bets 240
guitarist68: folds 
Anton163reg: calls 240
*** RIVER *** [Jc Th Td 2h] [Qh]
Anton163reg: bets 656
happyminh: folds 
Uncalled bet (656) returned to Anton163reg
Anton163reg collected 980 from pot
Anton163reg: doesn't show hand 
*** SUMMARY ***
Total pot 980 | Rake 0 
Board [Jc Th Td 2h Qh]
Seat 1: guitarist68 (big blind) folded on the Turn
Seat 2: Anton163reg collected (980)
Seat 3: GoldenBeeM folded before Flop (didn't bet)
Seat 5: happyminh folded on the River
Seat 6: dekota222 folded before Flop (didn't bet)
Seat 7: rooney69 (button) folded before Flop (didn't bet)
Seat 9: Samburger514 (small blind) folded before Flop



PokerStars Hand #157575176545: Tournament #1641817620, $7.50+$7.50+$1.50 USD Hold'em No Limit - Level I (15/30) - 2016/08/21 18:33:08 ET
Table '1641817620 55' 9-max Seat #4 is the button
Seat 2: HayArro (4895 in chips) 
Seat 3: MaxPips (4880 in chips) 
Seat 4: furia75205 (4940 in chips) 
Seat 5: hoolzky (4865 in chips) 
Seat 6: B.Paulino (4985 in chips) 
Seat 7: xLewie (5390 in chips) 
Seat 8: mendozoQ (10060 in chips) 
Seat 9: igara tigara (4985 in chips) 
HayArro: posts the ante 5
MaxPips: posts the ante 5
furia75205: posts the ante 5
hoolzky: posts the ante 5
B.Paulino: posts the ante 5
xLewie: posts the ante 5
mendozoQ: posts the ante 5
igara tigara: posts the ante 5
hoolzky: posts small blind 15
B.Paulino: posts big blind 30
*** HOLE CARDS ***
xLewie: folds 
mendozoQ: raises 60 to 90
igara tigara: folds 
HayArro: folds 
MaxPips: folds 
furia75205: folds 
hoolzky: folds 
B.Paulino: folds 
Uncalled bet (60) returned to mendozoQ
mendozoQ collected 115 from pot
mendozoQ: doesn't show hand 
*** SUMMARY ***
Total pot 115 | Rake 0 
Seat 2: HayArro folded before Flop (didn't bet)
Seat 3: MaxPips folded before Flop (didn't bet)
Seat 4: furia75205 (button) folded before Flop (didn't bet)
Seat 5: hoolzky (small blind) folded before Flop
Seat 6: B.Paulino (big blind) folded before Flop
Seat 7: xLewie folded before Flop (didn't bet)
Seat 8: mendozoQ collected (115)
Seat 9: igara tigara folded before Flop (didn't bet)



PokerStars Hand #157575176615: Tournament #1641817620, $7.50+$7.50+$1.50 USD Hold'em No Limit - Level I (15/30) - 2016/08/21 18:33:08 ET
Table '1641817620 16' 9-max Seat #5 is the button
Seat 1: Kugelbohne79 (5070 in chips) 
Seat 2: Sergei0384 (5091 in chips) 
Seat 3: paschalisbg (4935 in chips) 
Seat 4: Maisiewin (4839 in chips) 
Seat 5: alemaozl (4935 in chips) 
Seat 6: Luis Reye837 (5000 in chips) out of hand (moved from another table into small blind)
Seat 7: burton14 (5035 in chips) 
Seat 8: Miky_Man993 (4920 in chips) 
Seat 9: ziboin (5190 in chips) 
Kugelbohne79: posts the ante 5
Sergei0384: posts the ante 5
paschalisbg: posts the ante 5
Maisiewin: posts the ante 5
alemaozl: posts the ante 5
burton14: posts the ante 5
Miky_Man993: posts the ante 5
ziboin: posts the ante 5
burton14: posts small blind 15
Miky_Man993: posts big blind 30
*** HOLE CARDS ***
ziboin: folds 
Kugelbohne79: raises 30 to 60
Sergei0384: folds 
paschalisbg: folds 
Maisiewin: folds 
alemaozl: folds 
burton14: folds 
Miky_Man993: calls 30
*** FLOP *** [Kh 5c Ad]
Miky_Man993: checks 
Kugelbohne79: bets 87
Miky_Man993: folds 
Uncalled bet (87) returned to Kugelbohne79
Kugelbohne79 collected 175 from pot
Kugelbohne79: doesn't show hand 
*** SUMMARY ***
Total pot 175 | Rake 0 
Board [Kh 5c Ad]
Seat 1: Kugelbohne79 collected (175)
Seat 2: Sergei0384 folded before Flop (didn't bet)
Seat 3: paschalisbg folded before Flop (didn't bet)
Seat 4: Maisiewin folded before Flop (didn't bet)
Seat 5: alemaozl (button) folded before Flop (didn't bet)
Seat 7: burton14 (small blind) folded before Flop
Seat 8: Miky_Man993 (big blind) folded on the Flop
Seat 9: ziboin folded before Flop (didn't bet)



PokerStars Hand #157575177390: Tournament #1641817620, $7.50+$7.50+$1.50 USD Hold'em No Limit - Level I (15/30) - 2016/08/21 18:33:09 ET
Table '1641817620 19' 9-max Seat #4 is the button
Seat 1: ArskaTheMan (4985 in chips) 
Seat 2: renem24 (10035 in chips) 
Seat 3: Paparazzi507 (4485 in chips) 
Seat 4: amondelo (4940 in chips) 
Seat 5: xapnss (5000 in chips) out of hand (moved from another table into small blind)
Seat 6: flutzke90 (4955 in chips) 
Seat 8: le_chefe28 (5685 in chips) 
Seat 9: naumans (4985 in chips) 
ArskaTheMan: posts the ante 5
renem24: posts the ante 5
Paparazzi507: posts the ante 5
amondelo: posts the ante 5
flutzke90: posts the ante 5
le_chefe28: posts the ante 5
naumans: posts the ante 5
flutzke90: posts small blind 15
le_chefe28: posts big blind 30
*** HOLE CARDS ***
naumans: folds 
ArskaTheMan: folds 
renem24: folds 
Paparazzi507: raises 30 to 60
amondelo: calls 60
flutzke90: folds 
le_chefe28: calls 30
*** FLOP *** [Kc 5c 7c]
le_chefe28: bets 115
Paparazzi507: calls 115
amondelo: calls 115
*** TURN *** [Kc 5c 7c] [6c]
le_chefe28: checks 
Paparazzi507: checks 
amondelo: bets 300
le_chefe28: folds 
Paparazzi507: raises 587 to 887
amondelo: folds 
Uncalled bet (587) returned to Paparazzi507
Paparazzi507 collected 1175 from pot
Paparazzi507: doesn't show hand 
*** SUMMARY ***
Total pot 1175 | Rake 0 
Board [Kc 5c 7c 6c]
Seat 1: ArskaTheMan folded before Flop (didn't bet)
Seat 2: renem24 folded before Flop (didn't bet)
Seat 3: Paparazzi507 collected (1175)
Seat 4: amondelo (button) folded on the Turn
Seat 6: flutzke90 (small blind) folded before Flop
Seat 8: le_chefe28 (big blind) folded on the Turn
Seat 9: naumans folded before Flop (didn't bet)



PokerStars Hand #157575177958: Tournament #1641817620, $7.50+$7.50+$1.50 USD Hold'em No Limit - Level I (15/30) - 2016/08/21 18:33:10 ET
Table '1641817620 22' 9-max Seat #5 is the button
Seat 1: glangglang (4980 in chips) 
Seat 3: CHININ118 (4935 in chips) 
Seat 4: Jaliplay (10110 in chips) 
Seat 5: hewx (4935 in chips) 
Seat 6: xxSTORMZYxx (4950 in chips) 
Seat 7: ogotop76 (4980 in chips) 
Seat 8: monterreymx (4980 in chips) 
Seat 9: cash4king (5130 in chips) 
glangglang: posts the ante 5
CHININ118: posts the ante 5
Jaliplay: posts the ante 5
hewx: posts the ante 5
xxSTORMZYxx: posts the ante 5
ogotop76: posts the ante 5
monterreymx: posts the ante 5
cash4king: posts the ante 5
xxSTORMZYxx: posts small blind 15
ogotop76: posts big blind 30
*** HOLE CARDS ***
monterreymx: folds 
cash4king: folds 
glangglang: folds 
CHININ118: folds 
Jaliplay: folds 
hewx: raises 45 to 75
xxSTORMZYxx: folds 
ogotop76: folds 
Uncalled bet (45) returned to hewx
hewx collected 115 from pot
hewx: doesn't show hand 
*** SUMMARY ***
Total pot 115 | Rake 0 
Seat 1: glangglang folded before Flop (didn't bet)
Seat 3: CHININ118 folded before Flop (didn't bet)
Seat 4: Jaliplay folded before Flop (didn't bet)
Seat 5: hewx (button) collected (115)
Seat 6: xxSTORMZYxx (small blind) folded before Flop
Seat 7: ogotop76 (big blind) folded before Flop
Seat 8: monterreymx folded before Flop (didn't bet)
Seat 9: cash4king folded before Flop (didn't bet)



PokerStars Hand #157575178190: Tournament #1641817620, $7.50+$7.50+$1.50 USD Hold'em No Limit - Level I (15/30) - 2016/08/21 18:33:10 ET
Table '1641817620 6' 9-max Seat #7 is the button
Seat 1: ASTRAXANSKI (4980 in chips) 
Seat 2: KOT-BEGEMOT6 (4965 in chips) 
Seat 3: agneseagnese (4990 in chips) 
Seat 4: mekkoramarha (4960 in chips) 
Seat 5: KKKistKKK (3849 in chips) 
Seat 6: brown1967 (5015 in chips) 
Seat 7: Balotelli195 (4935 in chips) 
Seat 8: linoleum006 (5005 in chips) 
Seat 9: Jelsomino79 (6306 in chips) 
ASTRAXANSKI: posts the ante 5
KOT-BEGEMOT6: posts the ante 5
agneseagnese: posts the ante 5
mekkoramarha: posts the ante 5
KKKistKKK: posts the ante 5
brown1967: posts the ante 5
Balotelli195: posts the ante 5
linoleum006: posts the ante 5
Jelsomino79: posts the ante 5
linoleum006: posts small blind 15
Jelsomino79: posts big blind 30
*** HOLE CARDS ***
ASTRAXANSKI: folds 
KOT-BEGEMOT6: folds 
agneseagnese: folds 
mekkoramarha: folds 
KKKistKKK: folds 
brown1967: folds 
Balotelli195: raises 60 to 90
linoleum006: folds 
Jelsomino79: folds 
Uncalled bet (60) returned to Balotelli195
Balotelli195 collected 120 from pot
Balotelli195: doesn't show hand 
*** SUMMARY ***
Total pot 120 | Rake 0 
Seat 1: ASTRAXANSKI folded before Flop (didn't bet)
Seat 2: KOT-BEGEMOT6 folded before Flop (didn't bet)
Seat 3: agneseagnese folded before Flop (didn't bet)
Seat 4: mekkoramarha folded before Flop (didn't bet)
Seat 5: KKKistKKK folded before Flop (didn't bet)
Seat 6: brown1967 folded before Flop (didn't bet)
Seat 7: Balotelli195 (button) collected (120)
Seat 8: linoleum006 (small blind) folded before Flop
Seat 9: Jelsomino79 (big blind) folded before Flop



PokerStars Hand #157575178669: Tournament #1641817620, $7.50+$7.50+$1.50 USD Hold'em No Limit - Level I (15/30) - 2016/08/21 18:33:11 ET
Table '1641817620 13' 9-max Seat #3 is the button
Seat 1: Mindthis (3243 in chips) 
Seat 2: nicka501 (10187 in chips) 
Seat 3: POG_Q4 (7218 in chips) 
Seat 4: sutherland43 (4965 in chips) 
Seat 5: LarikkadoAA (4995 in chips) 
Seat 6: MicroStaker5 (4503 in chips) 
Seat 7: MrMalaLeche (4990 in chips) 
Seat 8: EdsonPecly (4909 in chips) 
Seat 9: wantuirpoker (4985 in chips) 
Mindthis: posts the ante 5
nicka501: posts the ante 5
POG_Q4: posts the ante 5
sutherland43: posts the ante 5
LarikkadoAA: posts the ante 5
MicroStaker5: posts the ante 5
MrMalaLeche: posts the ante 5
EdsonPecly: posts the ante 5
wantuirpoker: posts the ante 5
sutherland43: posts small blind 15
LarikkadoAA: posts big blind 30
*** HOLE CARDS ***
MicroStaker5: folds 
MrMalaLeche: folds 
EdsonPecly: folds 
wantuirpoker: folds 
Mindthis: folds 
nicka501: calls 30
POG_Q4: folds 
sutherland43: folds 
LarikkadoAA: checks 
*** FLOP *** [9h Qs Ts]
LarikkadoAA: checks 
nicka501: bets 60
LarikkadoAA: folds 
Uncalled bet (60) returned to nicka501
nicka501 collected 120 from pot
nicka501: doesn't show hand 
*** SUMMARY ***
Total pot 120 | Rake 0 
Board [9h Qs Ts]
Seat 1: Mindthis folded before Flop (didn't bet)
Seat 2: nicka501 collected (120)
Seat 3: POG_Q4 (button) folded before Flop (didn't bet)
Seat 4: sutherland43 (small blind) folded before Flop
Seat 5: LarikkadoAA (big blind) folded on the Flop
Seat 6: MicroStaker5 folded before Flop (didn't bet)
Seat 7: MrMalaLeche folded before Flop (didn't bet)
Seat 8: EdsonPecly folded before Flop (didn't bet)
Seat 9: wantuirpoker folded before Flop (didn't bet)



PokerStars Hand #157575180155: Tournament #1641817620, $7.50+$7.50+$1.50 USD Hold'em No Limit - Level I (15/30) - 2016/08/21 18:33:13 ET
Table '1641817620 54' 9-max Seat #4 is the button
Seat 1: nixx77 (4985 in chips) 
Seat 2: FábioC.p.br (4970 in chips) 
Seat 3: pinokkioOo (4940 in chips) 
Seat 4: ALLESC-114 (4940 in chips) 
Seat 5: appache55 (3185 in chips) 
Seat 6: hrabbi87 (4925 in chips) 
Seat 7: xpsbynoc (7085 in chips) 
Seat 8: MiltonMorais (4985 in chips) 
Seat 9: ZeckMaverick (4985 in chips) 
nixx77: posts the ante 5
FábioC.p.br: posts the ante 5
pinokkioOo: posts the ante 5
ALLESC-114: posts the ante 5
appache55: posts the ante 5
hrabbi87: posts the ante 5
xpsbynoc: posts the ante 5
MiltonMorais: posts the ante 5
ZeckMaverick: posts the ante 5
appache55: posts small blind 15
hrabbi87: posts big blind 30
*** HOLE CARDS ***
xpsbynoc: folds 
MiltonMorais: folds 
ZeckMaverick: folds 
nixx77: folds 
FábioC.p.br: folds 
pinokkioOo: folds 
ALLESC-114: folds 
appache55: raises 240 to 270
hrabbi87: folds 
Uncalled bet (240) returned to appache55
appache55 collected 105 from pot
appache55: doesn't show hand 
*** SUMMARY ***
Total pot 105 | Rake 0 
Seat 1: nixx77 folded before Flop (didn't bet)
Seat 2: FábioC.p.br folded before Flop (didn't bet)
Seat 3: pinokkioOo folded before Flop (didn't bet)
Seat 4: ALLESC-114 (button) folded before Flop (didn't bet)
Seat 5: appache55 (small blind) collected (105)
Seat 6: hrabbi87 (big blind) folded before Flop
Seat 7: xpsbynoc folded before Flop (didn't bet)
Seat 8: MiltonMorais folded before Flop (didn't bet)
Seat 9: ZeckMaverick folded before Flop (didn't bet)



PokerStars Hand #157575181945: Tournament #1641817620, $7.50+$7.50+$1.50 USD Hold'em No Limit - Level I (15/30) - 2016/08/21 18:33:16 ET
Table '1641817620 8' 9-max Seat #5 is the button
Seat 1: inkjoh (5065 in chips) 
Seat 2: MarcosCLMO (4627 in chips) 
Seat 3: HundTore (5790 in chips) 
Seat 4: Kamikase1805 (5025 in chips) 
Seat 5: younesch (4603 in chips) 
Seat 6: spinne1109 (4965 in chips) 
Seat 7: pavaopics (4980 in chips) 
Seat 8: FastEdiddy (4980 in chips) 
Seat 9: Pokerofwind (4980 in chips) 
inkjoh: posts the ante 5
MarcosCLMO: posts the ante 5
HundTore: posts the ante 5
Kamikase1805: posts the ante 5
younesch: posts the ante 5
spinne1109: posts the ante 5
pavaopics: posts the ante 5
FastEdiddy: posts the ante 5
Pokerofwind: posts the ante 5
spinne1109: posts small blind 15
pavaopics: posts big blind 30
*** HOLE CARDS ***
FastEdiddy: folds 
Pokerofwind: folds 
inkjoh: raises 30 to 60
MarcosCLMO: calls 60
HundTore: folds 
Kamikase1805: folds 
younesch: folds 
spinne1109: folds 
pavaopics: calls 30
*** FLOP *** [Ac 8d 5h]
pavaopics: checks 
inkjoh: checks 
MarcosCLMO: checks 
*** TURN *** [Ac 8d 5h] [3d]
pavaopics: bets 120
inkjoh: calls 120
MarcosCLMO: folds 
*** RIVER *** [Ac 8d 5h 3d] [2s]
pavaopics: checks 
inkjoh: checks 
*** SHOW DOWN ***
pavaopics: shows [2d 9d] (a pair of Deuces)
inkjoh: shows [9s As] (a pair of Aces)
inkjoh collected 480 from pot
*** SUMMARY ***
Total pot 480 | Rake 0 
Board [Ac 8d 5h 3d 2s]
Seat 1: inkjoh showed [9s As] and won (480) with a pair of Aces
Seat 2: MarcosCLMO folded on the Turn
Seat 3: HundTore folded before Flop (didn't bet)
Seat 4: Kamikase1805 folded before Flop (didn't bet)
Seat 5: younesch (button) folded before Flop (didn't bet)
Seat 6: spinne1109 (small blind) folded before Flop
Seat 7: pavaopics (big blind) showed [2d 9d] and lost with a pair of Deuces
Seat 8: FastEdiddy folded before Flop (didn't bet)
Seat 9: Pokerofwind folded before Flop (didn't bet)



PokerStars Hand #157575182313: Tournament #1641817620, $7.50+$7.50+$1.50 USD Hold'em No Limit - Level I (15/30) - 2016/08/21 18:33:17 ET
Table '1641817620 28' 9-max Seat #3 is the button
Seat 1: kidprodigy44 (4990 in chips) 
Seat 2: jamaika high (3375 in chips) 
Seat 3: cairob (4945 in chips) 
Seat 4: NIKOLACG (1873 in chips) 
Seat 5: neckbr4ke (4900 in chips) 
Seat 6: Quaysie (4990 in chips) 
Seat 7: d3ment0r (8115 in chips) 
Seat 8: papan9_p$ (6822 in chips) 
Seat 9: benjicleo (4990 in chips) 
kidprodigy44: posts the ante 5
jamaika high: posts the ante 5
cairob: posts the ante 5
NIKOLACG: posts the ante 5
neckbr4ke: posts the ante 5
Quaysie: posts the ante 5
d3ment0r: posts the ante 5
papan9_p$: posts the ante 5
benjicleo: posts the ante 5
NIKOLACG: posts small blind 15
neckbr4ke: posts big blind 30
*** HOLE CARDS ***
Quaysie: folds 
d3ment0r: folds 
papan9_p$: folds 
benjicleo: folds 
kidprodigy44: folds 
jamaika high: raises 30 to 60
cairob: folds 
NIKOLACG: calls 45
neckbr4ke: calls 30
*** FLOP *** [6h Kd 2h]
NIKOLACG: checks 
neckbr4ke: checks 
jamaika high: bets 210
NIKOLACG: calls 210
neckbr4ke: folds 
*** TURN *** [6h Kd 2h] [4h]
NIKOLACG: checks 
jamaika high: checks 
*** RIVER *** [6h Kd 2h 4h] [Qh]
NIKOLACG: checks 
jamaika high: checks 
*** SHOW DOWN ***
NIKOLACG: shows [As 2d] (a pair of Deuces)
jamaika high: shows [Qs 3c] (a pair of Queens)
jamaika high collected 645 from pot
*** SUMMARY ***
Total pot 645 | Rake 0 
Board [6h Kd 2h 4h Qh]
Seat 1: kidprodigy44 folded before Flop (didn't bet)
Seat 2: jamaika high showed [Qs 3c] and won (645) with a pair of Queens
Seat 3: cairob (button) folded before Flop (didn't bet)
Seat 4: NIKOLACG (small blind) showed [As 2d] and lost with a pair of Deuces
Seat 5: neckbr4ke (big blind) folded on the Flop
Seat 6: Quaysie folded before Flop (didn't bet)
Seat 7: d3ment0r folded before Flop (didn't bet)
Seat 8: papan9_p$ folded before Flop (didn't bet)
Seat 9: benjicleo folded before Flop (didn't bet)



PokerStars Hand #157575182322: Tournament #1641817620, $7.50+$7.50+$1.50 USD Hold'em No Limit - Level I (15/30) - 2016/08/21 18:33:17 ET
Table '1641817620 61' 9-max Seat #5 is the button
Seat 1: talga421 (4213 in chips) 
Seat 2: evgenia19591 (4895 in chips) 
Seat 3: ElliNelly (11332 in chips) 
Seat 4: Adso139 (5000 in chips) 
Seat 5: sasha.yush (4940 in chips) 
Seat 6: houtenboog (4865 in chips) 
Seat 7: setarcos1234 (4985 in chips) 
Seat 9: vininicolato (4775 in chips) 
talga421: posts the ante 5
evgenia19591: posts the ante 5
ElliNelly: posts the ante 5
Adso139: posts the ante 5
sasha.yush: posts the ante 5
houtenboog: posts the ante 5
setarcos1234: posts the ante 5
vininicolato: posts the ante 5
houtenboog: posts small blind 15
setarcos1234: posts big blind 30
*** HOLE CARDS ***
vininicolato: folds 
talga421: raises 60 to 90
evgenia19591: folds 
ElliNelly: folds 
Adso139: folds 
sasha.yush: folds 
houtenboog: folds 
setarcos1234: folds 
Uncalled bet (60) returned to talga421
talga421 collected 115 from pot
talga421: doesn't show hand 
*** SUMMARY ***
Total pot 115 | Rake 0 
Seat 1: talga421 collected (115)
Seat 2: evgenia19591 folded before Flop (didn't bet)
Seat 3: ElliNelly folded before Flop (didn't bet)
Seat 4: Adso139 folded before Flop (didn't bet)
Seat 5: sasha.yush (button) folded before Flop (didn't bet)
Seat 6: houtenboog (small blind) folded before Flop
Seat 7: setarcos1234 (big blind) folded before Flop
Seat 9: vininicolato folded before Flop (didn't bet)



PokerStars Hand #157575182462: Tournament #1641817620, $7.50+$7.50+$1.50 USD Hold'em No Limit - Level I (15/30) - 2016/08/21 18:33:17 ET
Table '1641817620 43' 9-max Seat #4 is the button
Seat 1: VeniG95 (10254 in chips) 
Seat 2: alanyamil (75 in chips) 
Seat 3: Raulop (4775 in chips) 
Seat 4: SoulSlaye166 (5195 in chips) 
Seat 5: DimaRu777 (4955 in chips) 
Seat 6: Taima (4791 in chips) 
Seat 7: Caville88 (4985 in chips) 
Seat 8: BetoFolhaCMC (4985 in chips) 
Seat 9: cajool (4985 in chips) 
VeniG95: posts the ante 5
alanyamil: posts the ante 5
Raulop: posts the ante 5
SoulSlaye166: posts the ante 5
DimaRu777: posts the ante 5
Taima: posts the ante 5
Caville88: posts the ante 5
BetoFolhaCMC: posts the ante 5
cajool: posts the ante 5
DimaRu777: posts small blind 15
Taima: posts big blind 30
*** HOLE CARDS ***
Caville88: folds 
BetoFolhaCMC: folds 
cajool: calls 30
VeniG95: folds 
alanyamil: folds 
Raulop: folds 
SoulSlaye166: folds 
DimaRu777: calls 15
Taima: checks 
*** FLOP *** [Ts Ad Jc]
DimaRu777: checks 
Taima: folds 
cajool: bets 60
DimaRu777: folds 
Uncalled bet (60) returned to cajool
cajool collected 135 from pot
cajool: doesn't show hand 
*** SUMMARY ***
Total pot 135 | Rake 0 
Board [Ts Ad Jc]
Seat 1: VeniG95 folded before Flop (didn't bet)
Seat 2: alanyamil folded before Flop (didn't bet)
Seat 3: Raulop folded before Flop (didn't bet)
Seat 4: SoulSlaye166 (button) folded before Flop (didn't bet)
Seat 5: DimaRu777 (small blind) folded on the Flop
Seat 6: Taima (big blind) folded on the Flop
Seat 7: Caville88 folded before Flop (didn't bet)
Seat 8: BetoFolhaCMC folded before Flop (didn't bet)
Seat 9: cajool collected (135)



PokerStars Hand #157575182868: Tournament #1641817620, $7.50+$7.50+$1.50 USD Hold'em No Limit - Level I (15/30) - 2016/08/21 18:33:18 ET
Table '1641817620 33' 9-max Seat #7 is the button
Seat 1: fungyou (4975 in chips) 
Seat 2: titauhu (4960 in chips) is sitting out
Seat 3: gmdef.2001 (4930 in chips) 
Seat 4: natahha_92 (4990 in chips) 
Seat 5: T@keItDown (5015 in chips) 
Seat 6: REPPARTFLOW (5020 in chips) 
Seat 7: dennismitru (5110 in chips) 
Seat 8: Joao Valli (4945 in chips) 
Seat 9: Pablos701 (5060 in chips) 
fungyou: posts the ante 5
titauhu: posts the ante 5
gmdef.2001: posts the ante 5
natahha_92: posts the ante 5
T@keItDown: posts the ante 5
REPPARTFLOW: posts the ante 5
dennismitru: posts the ante 5
Joao Valli: posts the ante 5
Pablos701: posts the ante 5
Joao Valli: posts small blind 15
Pablos701: posts big blind 30
*** HOLE CARDS ***
fungyou: folds 
titauhu: folds 
titauhu has returned
gmdef.2001: folds 
natahha_92: folds 
T@keItDown: folds 
REPPARTFLOW: folds 
dennismitru: folds 
Joao Valli: folds 
Uncalled bet (15) returned to Pablos701
Pablos701 collected 75 from pot
Pablos701: doesn't show hand 
*** SUMMARY ***
Total pot 75 | Rake 0 
Seat 1: fungyou folded before Flop (didn't bet)
Seat 2: titauhu folded before Flop (didn't bet)
Seat 3: gmdef.2001 folded before Flop (didn't bet)
Seat 4: natahha_92 folded before Flop (didn't bet)
Seat 5: T@keItDown folded before Flop (didn't bet)
Seat 6: REPPARTFLOW folded before Flop (didn't bet)
Seat 7: dennismitru (button) folded before Flop (didn't bet)
Seat 8: Joao Valli (small blind) folded before Flop
Seat 9: Pablos701 (big blind) collected (75)



PokerStars Hand #157575182869: Tournament #1641817620, $7.50+$7.50+$1.50 USD Hold'em No Limit - Level I (15/30) - 2016/08/21 18:33:18 ET
Table '1641817620 37' 9-max Seat #6 is the button
Seat 1: Youbetipush1 (4920 in chips) 
Seat 2: SouzaEduardo (4965 in chips) 
Seat 3: Maisteri (7195 in chips) 
Seat 4: qball911 (4875 in chips) 
Seat 5: dell1961 (5000 in chips) 
Seat 6: ColdFire_200 (4890 in chips) 
Seat 7: loachxm (4900 in chips) 
Seat 8: mikke8282 (4995 in chips) 
Seat 9: carabason (8275 in chips) 
Youbetipush1: posts the ante 5
SouzaEduardo: posts the ante 5
Maisteri: posts the ante 5
qball911: posts the ante 5
dell1961: posts the ante 5
ColdFire_200: posts the ante 5
loachxm: posts the ante 5
mikke8282: posts the ante 5
carabason: posts the ante 5
loachxm: posts small blind 15
mikke8282: posts big blind 30
*** HOLE CARDS ***
carabason: folds 
Youbetipush1: folds 
SouzaEduardo: folds 
Maisteri: folds 
qball911: folds 
dell1961: raises 120 to 150
ColdFire_200: folds 
loachxm: folds 
mikke8282: calls 120
*** FLOP *** [Qs Ad 3c]
mikke8282: checks 
dell1961: checks 
*** TURN *** [Qs Ad 3c] [6c]
mikke8282: bets 172
dell1961: folds 
Uncalled bet (172) returned to mikke8282
mikke8282 collected 360 from pot
mikke8282: doesn't show hand 
*** SUMMARY ***
Total pot 360 | Rake 0 
Board [Qs Ad 3c 6c]
Seat 1: Youbetipush1 folded before Flop (didn't bet)
Seat 2: SouzaEduardo folded before Flop (didn't bet)
Seat 3: Maisteri folded before Flop (didn't bet)
Seat 4: qball911 folded before Flop (didn't bet)
Seat 5: dell1961 folded on the Turn
Seat 6: ColdFire_200 (button) folded before Flop (didn't bet)
Seat 7: loachxm (small blind) folded before Flop
Seat 8: mikke8282 (big blind) collected (360)
Seat 9: carabason folded before Flop (didn't bet)



PokerStars Hand #157575182991: Tournament #1641817620, $7.50+$7.50+$1.50 USD Hold'em No Limit - Level I (15/30) - 2016/08/21 18:33:18 ET
Table '1641817620 30' 9-max Seat #3 is the button
Seat 1: riginvl (4990 in chips) 
Seat 2: flashesflash (4960 in chips) 
Seat 3: Drogbaaaaaaa (4930 in chips) 
Seat 4: staplesking (5000 in chips) out of hand (moved from another table into small blind)
Seat 5: islidur99 (5970 in chips) 
Seat 6: jeanjrg1 (4990 in chips) 
Seat 7: GazRaz21 (4050 in chips) 
Seat 8: karlson1986 (5155 in chips) 
Seat 9: YNWA UA (4960 in chips) 
riginvl: posts the ante 5
flashesflash: posts the ante 5
Drogbaaaaaaa: posts the ante 5
islidur99: posts the ante 5
jeanjrg1: posts the ante 5
GazRaz21: posts the ante 5
karlson1986: posts the ante 5
YNWA UA: posts the ante 5
islidur99: posts small blind 15
jeanjrg1: posts big blind 30
*** HOLE CARDS ***
GazRaz21: calls 30
karlson1986: calls 30
YNWA UA: folds 
riginvl: folds 
flashesflash: folds 
Drogbaaaaaaa: folds 
islidur99: calls 15
jeanjrg1: checks 
*** FLOP *** [As 6h 9d]
islidur99: checks 
jeanjrg1: checks 
GazRaz21: checks 
karlson1986: bets 60
islidur99: calls 60
jeanjrg1: folds 
GazRaz21: folds 
*** TURN *** [As 6h 9d] [5d]
islidur99: checks 
karlson1986: bets 140
islidur99: folds 
Uncalled bet (140) returned to karlson1986
karlson1986 collected 280 from pot
*** SUMMARY ***
Total pot 280 | Rake 0 
Board [As 6h 9d 5d]
Seat 1: riginvl folded before Flop (didn't bet)
Seat 2: flashesflash folded before Flop (didn't bet)
Seat 3: Drogbaaaaaaa (button) folded before Flop (didn't bet)
Seat 5: islidur99 (small blind) folded on the Turn
Seat 6: jeanjrg1 (big blind) folded on the Flop
Seat 7: GazRaz21 folded on the Flop
Seat 8: karlson1986 collected (280)
Seat 9: YNWA UA folded before Flop (didn't bet)



PokerStars Hand #157575183703: Tournament #1641817620, $7.50+$7.50+$1.50 USD Hold'em No Limit - Level I (15/30) - 2016/08/21 18:33:19 ET
Table '1641817620 38' 9-max Seat #3 is the button
Seat 1: chechako#8 (4690 in chips) 
Seat 2: kristofxm8 (5690 in chips) 
Seat 3: persephoney (4900 in chips) 
Seat 4: Folladorwin (5000 in chips) out of hand (moved from another table into small blind)
Seat 5: jager1987 (4960 in chips) 
Seat 6: Dr.Durrrq (5125 in chips) 
Seat 7: Myschkin_Lev (4960 in chips) 
Seat 8: Bon_Choueur (4690 in chips) 
Seat 9: dtb1978 (4990 in chips) 
chechako#8: posts the ante 5
kristofxm8: posts the ante 5
persephoney: posts the ante 5
jager1987: posts the ante 5
Dr.Durrrq: posts the ante 5
Myschkin_Lev: posts the ante 5
Bon_Choueur: posts the ante 5
dtb1978: posts the ante 5
jager1987: posts small blind 15
Dr.Durrrq: posts big blind 30
*** HOLE CARDS ***
Myschkin_Lev: folds 
Bon_Choueur: folds 
dtb1978: calls 30
chechako#8: raises 90 to 120
kristofxm8: folds 
persephoney: folds 
jager1987: calls 105
Dr.Durrrq: folds 
dtb1978: calls 90
*** FLOP *** [Th 6c 5s]
jager1987: checks 
dtb1978: checks 
chechako#8: bets 172
jager1987: folds 
dtb1978: folds 
Uncalled bet (172) returned to chechako#8
chechako#8 collected 430 from pot
chechako#8: doesn't show hand 
*** SUMMARY ***
Total pot 430 | Rake 0 
Board [Th 6c 5s]
Seat 1: chechako#8 collected (430)
Seat 2: kristofxm8 folded before Flop (didn't bet)
Seat 3: persephoney (button) folded before Flop (didn't bet)
Seat 5: jager1987 (small blind) folded on the Flop
Seat 6: Dr.Durrrq (big blind) folded before Flop
Seat 7: Myschkin_Lev folded before Flop (didn't bet)
Seat 8: Bon_Choueur folded before Flop (didn't bet)
Seat 9: dtb1978 folded on the Flop



PokerStars Hand #157575184339: Tournament #1641817620, $7.50+$7.50+$1.50 USD Hold'em No Limit - Level I (15/30) - 2016/08/21 18:33:20 ET
Table '1641817620 44' 9-max Seat #7 is the button
Seat 1: BurrGrylls (4975 in chips) 
Seat 2: moisesgosu (4801 in chips) 
Seat 3: kduwork (5147 in chips) 
Seat 4: starkstud (5110 in chips) 
Seat 5: rbcowboy27 (4995 in chips) 
Seat 6: lesley hu (4930 in chips) is sitting out
Seat 7: ongggg (4903 in chips) 
Seat 8: heynow21 (5194 in chips) 
Seat 9: Pro_Tunis (5060 in chips) 
BurrGrylls: posts the ante 5
moisesgosu: posts the ante 5
kduwork: posts the ante 5
starkstud: posts the ante 5
rbcowboy27: posts the ante 5
lesley hu: posts the ante 5
ongggg: posts the ante 5
heynow21: posts the ante 5
Pro_Tunis: posts the ante 5
heynow21: posts small blind 15
Pro_Tunis: posts big blind 30
*** HOLE CARDS ***
BurrGrylls: folds 
moisesgosu: raises 60 to 90
kduwork: folds 
starkstud: folds 
rbcowboy27: folds 
lesley hu: folds 
ongggg: folds 
heynow21: folds 
Pro_Tunis: calls 60
*** FLOP *** [4d 9h 6d]
Pro_Tunis: bets 160
moisesgosu: calls 160
*** TURN *** [4d 9h 6d] [7d]
Pro_Tunis: bets 525
moisesgosu: folds 
Uncalled bet (525) returned to Pro_Tunis
Pro_Tunis collected 560 from pot
Pro_Tunis: doesn't show hand 
*** SUMMARY ***
Total pot 560 | Rake 0 
Board [4d 9h 6d 7d]
Seat 1: BurrGrylls folded before Flop (didn't bet)
Seat 2: moisesgosu folded on the Turn
Seat 3: kduwork folded before Flop (didn't bet)
Seat 4: starkstud folded before Flop (didn't bet)
Seat 5: rbcowboy27 folded before Flop (didn't bet)
Seat 6: lesley hu folded before Flop (didn't bet)
Seat 7: ongggg (button) folded before Flop (didn't bet)
Seat 8: heynow21 (small blind) folded before Flop
Seat 9: Pro_Tunis (big blind) collected (560)



PokerStars Hand #157575184445: Tournament #1641817620, $7.50+$7.50+$1.50 USD Hold'em No Limit - Level I (15/30) - 2016/08/21 18:33:20 ET
Table '1641817620 47' 9-max Seat #5 is the button
Seat 1: sovikeen (4985 in chips) 
Seat 2: RipperRooo (5360 in chips) 
Seat 3: gtavares10 (4727 in chips) 
Seat 4: FredyROKSTAR (5000 in chips) 
Seat 5: IvnAK (4640 in chips) 
Seat 6: sergiooker (5343 in chips) 
Seat 7: T3chnojunk (4985 in chips) 
Seat 8: bruff3l (5070 in chips) 
Seat 9: ppmaster (4895 in chips) 
sovikeen: posts the ante 5
RipperRooo: posts the ante 5
gtavares10: posts the ante 5
FredyROKSTAR: posts the ante 5
IvnAK: posts the ante 5
sergiooker: posts the ante 5
T3chnojunk: posts the ante 5
bruff3l: posts the ante 5
ppmaster: posts the ante 5
sergiooker: posts small blind 15
T3chnojunk: posts big blind 30
*** HOLE CARDS ***
bruff3l: folds 
ppmaster: folds 
sovikeen: raises 90 to 120
RipperRooo: folds 
FredyROKSTAR is disconnected 
gtavares10: folds 
FredyROKSTAR is connected 
FredyROKSTAR: folds 
IvnAK: folds 
sergiooker: folds 
T3chnojunk: folds 
Uncalled bet (90) returned to sovikeen
sovikeen collected 120 from pot
sovikeen: doesn't show hand 
*** SUMMARY ***
Total pot 120 | Rake 0 
Seat 1: sovikeen collected (120)
Seat 2: RipperRooo folded before Flop (didn't bet)
Seat 3: gtavares10 folded before Flop (didn't bet)
Seat 4: FredyROKSTAR folded before Flop (didn't bet)
Seat 5: IvnAK (button) folded before Flop (didn't bet)
Seat 6: sergiooker (small blind) folded before Flop
Seat 7: T3chnojunk (big blind) folded before Flop
Seat 8: bruff3l folded before Flop (didn't bet)
Seat 9: ppmaster folded before Flop (didn't bet)



PokerStars Hand #157575185945: Tournament #1641817620, $7.50+$7.50+$1.50 USD Hold'em No Limit - Level I (15/30) - 2016/08/21 18:33:23 ET
Table '1641817620 18' 9-max Seat #3 is the button
Seat 1: Declan387 (4477 in chips) 
Seat 2: silvina35 (5167 in chips) 
Seat 3: TBP23 (4462 in chips) 
Seat 4: One_Cigar (4960 in chips) 
Seat 5: 111santos (4840 in chips) 
Seat 6: Krauser2589 (4990 in chips) 
Seat 7: shaxmatiist (4990 in chips) 
Seat 8: Lestatdiego (4747 in chips) 
Seat 9: kokandija (6367 in chips) 
Declan387: posts the ante 5
silvina35: posts the ante 5
TBP23: posts the ante 5
One_Cigar: posts the ante 5
111santos: posts the ante 5
Krauser2589: posts the ante 5
shaxmatiist: posts the ante 5
Lestatdiego: posts the ante 5
kokandija: posts the ante 5
One_Cigar: posts small blind 15
111santos: posts big blind 30
*** HOLE CARDS ***
Krauser2589: raises 30 to 60
shaxmatiist: folds 
Lestatdiego: folds 
kokandija: folds 
Declan387: calls 60
silvina35 is disconnected 
silvina35 is connected 
silvina35: folds 
TBP23: raises 125 to 185
One_Cigar: folds 
111santos: folds 
Krauser2589: calls 125
Declan387: calls 125
*** FLOP *** [4s Ts Ac]
Krauser2589: checks 
Declan387: checks 
TBP23: checks 
*** TURN *** [4s Ts Ac] [Qd]
kokandija is sitting out
Krauser2589: bets 150
Declan387: folds 
TBP23: calls 150
*** RIVER *** [4s Ts Ac Qd] [3s]
Krauser2589: bets 240
TBP23: folds 
Uncalled bet (240) returned to Krauser2589
Krauser2589 collected 945 from pot
*** SUMMARY ***
Cruger: ?!!????!??!!!??!?!!!!!
Total pot 945 | Rake 0 
Board [4s Ts Ac Qd 3s]
Seat 1: Declan387 folded on the Turn
Seat 2: silvina35 folded before Flop (didn't bet)
Seat 3: TBP23 (button) folded on the River
Seat 4: One_Cigar (small blind) folded before Flop
Seat 5: 111santos (big blind) folded before Flop
Seat 6: Krauser2589 collected (945)
Seat 7: shaxmatiist folded before Flop (didn't bet)
Seat 8: Lestatdiego folded before Flop (didn't bet)
Seat 9: kokandija folded before Flop (didn't bet)



PokerStars Hand #157575186881: Tournament #1641817620, $7.50+$7.50+$1.50 USD Hold'em No Limit - Level I (15/30) - 2016/08/21 18:33:24 ET
Table '1641817620 4' 9-max Seat #3 is the button
Seat 1: coldboy23 (4917 in chips) 
Seat 2: Velho Sábio (4902 in chips) 
Seat 3: manukk2 (4585 in chips) 
Seat 4: slk55amg (4527 in chips) 
Seat 5: sica26 (5337 in chips) 
Seat 6: thenewme32 (5000 in chips) 
Seat 7: AleksZy (4990 in chips) 
Seat 8: petersonmach (4990 in chips) 
Seat 9: DagobertQuad (4917 in chips) 
coldboy23: posts the ante 5
Velho Sábio: posts the ante 5
manukk2: posts the ante 5
slk55amg: posts the ante 5
sica26: posts the ante 5
thenewme32: posts the ante 5
AleksZy: posts the ante 5
petersonmach: posts the ante 5
DagobertQuad: posts the ante 5
slk55amg: posts small blind 15
sica26: posts big blind 30
*** HOLE CARDS ***
thenewme32: folds 
AleksZy: folds 
petersonmach: folds 
DagobertQuad: folds 
coldboy23: folds 
Velho Sábio: raises 30 to 60
manukk2: raises 90 to 150
slk55amg: calls 135
sica26: folds 
Velho Sábio: calls 90
*** FLOP *** [Ad Td 5d]
slk55amg: checks 
Velho Sábio: checks 
manukk2: bets 270
slk55amg: calls 270
Velho Sábio: calls 270
*** TURN *** [Ad Td 5d] [9h]
slk55amg: checks 
Velho Sábio: checks 
manukk2: bets 390
slk55amg: folds 
Velho Sábio: folds 
Uncalled bet (390) returned to manukk2
manukk2 collected 1335 from pot
*** SUMMARY ***
Total pot 1335 | Rake 0 
Board [Ad Td 5d 9h]
Seat 1: coldboy23 folded before Flop (didn't bet)
Seat 2: Velho Sábio folded on the Turn
Seat 3: manukk2 (button) collected (1335)
Seat 4: slk55amg (small blind) folded on the Turn
Seat 5: sica26 (big blind) folded before Flop
Seat 6: thenewme32 folded before Flop (didn't bet)
Seat 7: AleksZy folded before Flop (didn't bet)
Seat 8: petersonmach folded before Flop (didn't bet)
Seat 9: DagobertQuad folded before Flop (didn't bet)



PokerStars Hand #157575188274: Tournament #1641817620, $7.50+$7.50+$1.50 USD Hold'em No Limit - Level I (15/30) - 2016/08/21 18:33:26 ET
Table '1641817620 31' 9-max Seat #5 is the button
Seat 1: JmanRz (5079 in chips) 
Seat 2: Esp2011 (4702 in chips) 
Seat 3: karanikolass (5184 in chips) 
Seat 4: Famzinha10 (5000 in chips) 
Seat 5: jucielitheco (4940 in chips) 
Seat 6: Ant_md (5145 in chips) 
Seat 7: fkamus (4985 in chips) 
Seat 8: RENA79 (4985 in chips) 
Seat 9: Jack.Siete (4985 in chips) 
JmanRz: posts the ante 5
Esp2011: posts the ante 5
karanikolass: posts the ante 5
Famzinha10: posts the ante 5
jucielitheco: posts the ante 5
Ant_md: posts the ante 5
fkamus: posts the ante 5
RENA79: posts the ante 5
Jack.Siete: posts the ante 5
Ant_md: posts small blind 15
fkamus: posts big blind 30
*** HOLE CARDS ***
RENA79: folds 
Jack.Siete: folds 
JmanRz: folds 
Esp2011: folds 
karanikolass: calls 30
Famzinha10: calls 30
jucielitheco: calls 30
Ant_md: raises 90 to 120
fkamus: folds 
karanikolass: calls 90
Famzinha10: calls 90
jucielitheco: calls 90
*** FLOP *** [7s Td 9d]
Ant_md: bets 277
karanikolass: folds 
Famzinha10: folds 
jucielitheco: folds 
Uncalled bet (277) returned to Ant_md
Ant_md collected 555 from pot
*** SUMMARY ***
Total pot 555 | Rake 0 
Board [7s Td 9d]
Seat 1: JmanRz folded before Flop (didn't bet)
Seat 2: Esp2011 folded before Flop (didn't bet)
Seat 3: karanikolass folded on the Flop
Seat 4: Famzinha10 folded on the Flop
Seat 5: jucielitheco (button) folded on the Flop
Seat 6: Ant_md (small blind) collected (555)
Seat 7: fkamus (big blind) folded before Flop
Seat 8: RENA79 folded before Flop (didn't bet)
Seat 9: Jack.Siete folded before Flop (didn't bet)



PokerStars Hand #157575188573: Tournament #1641817620, $7.50+$7.50+$1.50 USD Hold'em No Limit - Level I (15/30) - 2016/08/21 18:33:27 ET
Table '1641817620 12' 9-max Seat #4 is the button
Seat 1: Vlacerda (5124 in chips) 
Seat 2: aiaolinda (4370 in chips) 
Seat 3: faza29 (4891 in chips) 
Seat 4: Gottlieb007 (5150 in chips) 
Seat 5: ALEX-RSN (4955 in chips) 
Seat 6: MANJUS89 (4985 in chips) 
Seat 7: Mr. Burns501 (4505 in chips) 
Seat 8: CHARRUA1122 (6035 in chips) 
Seat 9: FrankLDrex (4985 in chips) 
Vlacerda: posts the ante 5
aiaolinda: posts the ante 5
faza29: posts the ante 5
Gottlieb007: posts the ante 5
ALEX-RSN: posts the ante 5
MANJUS89: posts the ante 5
Mr. Burns501: posts the ante 5
CHARRUA1122: posts the ante 5
FrankLDrex: posts the ante 5
ALEX-RSN: posts small blind 15
MANJUS89: posts big blind 30
*** HOLE CARDS ***
Mr. Burns501: folds 
CHARRUA1122: calls 30
FrankLDrex: calls 30
Vlacerda: folds 
aiaolinda: folds 
faza29: folds 
Gottlieb007: folds 
ALEX-RSN: calls 15
MANJUS89: checks 
*** FLOP *** [7c 2s Td]
ALEX-RSN: checks 
MANJUS89: checks 
CHARRUA1122: checks 
FrankLDrex: bets 120
ALEX-RSN: folds 
MANJUS89: folds 
CHARRUA1122: calls 120
*** TURN *** [7c 2s Td] [7d]
CHARRUA1122: checks 
FrankLDrex: checks 
*** RIVER *** [7c 2s Td 7d] [Jh]
CHARRUA1122: bets 240
FrankLDrex: raises 270 to 510
CHARRUA1122: calls 270
*** SHOW DOWN ***
FrankLDrex: shows [8h 9h] (a straight, Seven to Jack)
CHARRUA1122: mucks hand 
FrankLDrex collected 1425 from pot
*** SUMMARY ***
Total pot 1425 | Rake 0 
Board [7c 2s Td 7d Jh]
Seat 1: Vlacerda folded before Flop (didn't bet)
Seat 2: aiaolinda folded before Flop (didn't bet)
Seat 3: faza29 folded before Flop (didn't bet)
Seat 4: Gottlieb007 (button) folded before Flop (didn't bet)
Seat 5: ALEX-RSN (small blind) folded on the Flop
Seat 6: MANJUS89 (big blind) folded on the Flop
Seat 7: Mr. Burns501 folded before Flop (didn't bet)
Seat 8: CHARRUA1122 mucked
Seat 9: FrankLDrex showed [8h 9h] and won (1425) with a straight, Seven to Jack



PokerStars Hand #157575188600: Tournament #1641817620, $7.50+$7.50+$1.50 USD Hold'em No Limit - Level I (15/30) - 2016/08/21 18:33:27 ET
Table '1641817620 25' 9-max Seat #7 is the button
Seat 1: MoW3R (4975 in chips) 
Seat 2: pirus157 (5555 in chips) 
Seat 3: MaxBracht (4810 in chips) 
Seat 4: Rex Nelson (5015 in chips) 
Seat 5: ArKip (4930 in chips) 
Seat 6: REALACID (5000 in chips) 
Seat 7: AAnaKKonda (4930 in chips) 
Seat 8: Mad Dionysus (4915 in chips) 
Seat 9: IwillCall3 (4885 in chips) 
MoW3R: posts the ante 5
pirus157: posts the ante 5
MaxBracht: posts the ante 5
Rex Nelson: posts the ante 5
ArKip: posts the ante 5
REALACID: posts the ante 5
AAnaKKonda: posts the ante 5
Mad Dionysus: posts the ante 5
IwillCall3: posts the ante 5
Mad Dionysus: posts small blind 15
IwillCall3: posts big blind 30
*** HOLE CARDS ***
MoW3R: folds 
pirus157: folds 
MaxBracht: folds 
Rex Nelson: folds 
ArKip: folds 
REALACID: folds 
AAnaKKonda: folds 
Mad Dionysus: raises 30 to 60
IwillCall3: calls 30
*** FLOP *** [8c 4s 9c]
Mad Dionysus: bets 118
IwillCall3: folds 
Uncalled bet (118) returned to Mad Dionysus
Mad Dionysus collected 165 from pot
*** SUMMARY ***
Total pot 165 | Rake 0 
Board [8c 4s 9c]
Seat 1: MoW3R folded before Flop (didn't bet)
Seat 2: pirus157 folded before Flop (didn't bet)
Seat 3: MaxBracht folded before Flop (didn't bet)
Seat 4: Rex Nelson folded before Flop (didn't bet)
Seat 5: ArKip folded before Flop (didn't bet)
Seat 6: REALACID folded before Flop (didn't bet)
Seat 7: AAnaKKonda (button) folded before Flop (didn't bet)
Seat 8: Mad Dionysus (small blind) collected (165)
Seat 9: IwillCall3 (big blind) folded on the Flop



PokerStars Hand #157575188609: Tournament #1641817620, $7.50+$7.50+$1.50 USD Hold'em No Limit - Level I (15/30) - 2016/08/21 18:33:27 ET
Table '1641817620 52' 9-max Seat #4 is the button
Seat 1: DoubleBBle (5480 in chips) 
Seat 2: FelipeMarlon (4970 in chips) 
Seat 3: michalis009 (4880 in chips) 
Seat 4: Daviderevan (4940 in chips) 
Seat 5: Armin2188 (4955 in chips) 
Seat 6: HORSEPOKER28 (5210 in chips) 
Seat 7: mopeeds87 (4670 in chips) 
Seat 8: vladvladutz (4985 in chips) 
Seat 9: leothefirm (4910 in chips) 
DoubleBBle: posts the ante 5
FelipeMarlon: posts the ante 5
michalis009: posts the ante 5
Daviderevan: posts the ante 5
Armin2188: posts the ante 5
HORSEPOKER28: posts the ante 5
mopeeds87: posts the ante 5
vladvladutz: posts the ante 5
leothefirm: posts the ante 5
Armin2188: posts small blind 15
HORSEPOKER28: posts big blind 30
*** HOLE CARDS ***
mopeeds87: calls 30
vladvladutz: folds 
leothefirm: folds 
DoubleBBle: folds 
FelipeMarlon: raises 60 to 90
michalis009: folds 
Daviderevan: folds 
Armin2188: folds 
HORSEPOKER28: calls 60
mopeeds87: calls 60
*** FLOP *** [Jd Kc 4c]
HORSEPOKER28: checks 
mopeeds87: checks 
FelipeMarlon: bets 210
HORSEPOKER28: folds 
mopeeds87: folds 
Uncalled bet (210) returned to FelipeMarlon
FelipeMarlon collected 330 from pot
FelipeMarlon: doesn't show hand 
*** SUMMARY ***
Total pot 330 | Rake 0 
Board [Jd Kc 4c]
Seat 1: DoubleBBle folded before Flop (didn't bet)
Seat 2: FelipeMarlon collected (330)
Seat 3: michalis009 folded before Flop (didn't bet)
Seat 4: Daviderevan (button) folded before Flop (didn't bet)
Seat 5: Armin2188 (small blind) folded before Flop
Seat 6: HORSEPOKER28 (big blind) folded on the Flop
Seat 7: mopeeds87 folded on the Flop
Seat 8: vladvladutz folded before Flop (didn't bet)
Seat 9: leothefirm folded before Flop (didn't bet)



PokerStars Hand #157575189302: Tournament #1641817620, $7.50+$7.50+$1.50 USD Hold'em No Limit - Level I (15/30) - 2016/08/21 18:33:28 ET
Table '1641817620 3' 9-max Seat #6 is the button
Seat 1: IwantplayNL (4518 in chips) 
Seat 2: dufino (7356 in chips) 
Seat 3: zIggY-7-rAc3 (4935 in chips) 
Seat 4: gerald0jr (4935 in chips) 
Seat 5: Arkadius1975 (5000 in chips) 
Seat 6: BrunoCastroR (2905 in chips) 
Seat 7: alehirazawa (4950 in chips) 
Seat 8: markosharko (5431 in chips) 
Seat 9: VictorZh14 (4980 in chips) 
IwantplayNL: posts the ante 5
dufino: posts the ante 5
zIggY-7-rAc3: posts the ante 5
gerald0jr: posts the ante 5
Arkadius1975: posts the ante 5
BrunoCastroR: posts the ante 5
alehirazawa: posts the ante 5
markosharko: posts the ante 5
VictorZh14: posts the ante 5
alehirazawa: posts small blind 15
markosharko: posts big blind 30
*** HOLE CARDS ***
VictorZh14: folds 
IwantplayNL: folds 
dufino: calls 30
zIggY-7-rAc3: raises 60 to 90
gerald0jr: folds 
Arkadius1975: folds 
BrunoCastroR: folds 
alehirazawa: folds 
markosharko: folds 
dufino: calls 60
*** FLOP *** [Qs 7s 3s]
dufino: checks 
zIggY-7-rAc3: bets 120
dufino: calls 120
*** TURN *** [Qs 7s 3s] [8h]
dufino: checks 
zIggY-7-rAc3: bets 240
dufino: folds 
Uncalled bet (240) returned to zIggY-7-rAc3
zIggY-7-rAc3 collected 510 from pot
zIggY-7-rAc3: doesn't show hand 
*** SUMMARY ***
Total pot 510 | Rake 0 
Board [Qs 7s 3s 8h]
Seat 1: IwantplayNL folded before Flop (didn't bet)
Seat 2: dufino folded on the Turn
Seat 3: zIggY-7-rAc3 collected (510)
Seat 4: gerald0jr folded before Flop (didn't bet)
Seat 5: Arkadius1975 folded before Flop (didn't bet)
Seat 6: BrunoCastroR (button) folded before Flop (didn't bet)
Seat 7: alehirazawa (small blind) folded before Flop
Seat 8: markosharko (big blind) folded before Flop
Seat 9: VictorZh14 folded before Flop (didn't bet)



PokerStars Hand #157575189794: Tournament #1641817620, $7.50+$7.50+$1.50 USD Hold'em No Limit - Level I (15/30) - 2016/08/21 18:33:29 ET
Table '1641817620 45' 9-max Seat #3 is the button
Seat 1: rocky 7 (4900 in chips) 
Seat 2: ldf58 (5605 in chips) 
Seat 3: LifFtD (4945 in chips) 
Seat 4: Grasquet (4960 in chips) 
Seat 5: Mr.Bob-su (2680 in chips) 
Seat 6: CHIT4 (4990 in chips) 
Seat 7: R4ID3R12 (4990 in chips) 
Seat 8: mrbandito27 (4900 in chips) 
Seat 9: Andre Ortega (7030 in chips) 
rocky 7: posts the ante 5
ldf58: posts the ante 5
LifFtD: posts the ante 5
Grasquet: posts the ante 5
Mr.Bob-su: posts the ante 5
CHIT4: posts the ante 5
R4ID3R12: posts the ante 5
mrbandito27: posts the ante 5
Andre Ortega: posts the ante 5
Grasquet: posts small blind 15
Mr.Bob-su: posts big blind 30
*** HOLE CARDS ***
CHIT4: folds 
R4ID3R12: folds 
mrbandito27: folds 
Andre Ortega: folds 
rocky 7: calls 30
ldf58: calls 30
LifFtD: calls 30
Grasquet: calls 15
Mr.Bob-su: raises 90 to 120
rocky 7: calls 90
ldf58: calls 90
LifFtD: calls 90
Grasquet: calls 90
*** FLOP *** [2h Jd 7s]
Grasquet: checks 
Mr.Bob-su: bets 322
rocky 7: folds 
ldf58: folds 
LifFtD: folds 
Grasquet: calls 322
*** TURN *** [2h Jd 7s] [Ah]
Grasquet: checks 
Mr.Bob-su: checks 
*** RIVER *** [2h Jd 7s Ah] [5d]
Grasquet: bets 708
Mr.Bob-su: folds 
Uncalled bet (708) returned to Grasquet
Grasquet collected 1289 from pot
Grasquet: doesn't show hand 
*** SUMMARY ***
Total pot 1289 | Rake 0 
Board [2h Jd 7s Ah 5d]
Seat 1: rocky 7 folded on the Flop
Seat 2: ldf58 folded on the Flop
Seat 3: LifFtD (button) folded on the Flop
Seat 4: Grasquet (small blind) collected (1289)
Seat 5: Mr.Bob-su (big blind) folded on the River
Seat 6: CHIT4 folded before Flop (didn't bet)
Seat 7: R4ID3R12 folded before Flop (didn't bet)
Seat 8: mrbandito27 folded before Flop (didn't bet)
Seat 9: Andre Ortega folded before Flop (didn't bet)



PokerStars Hand #157575190057: Tournament #1641817620, $7.50+$7.50+$1.50 USD Hold'em No Limit - Level I (15/30) - 2016/08/21 18:33:29 ET
Table '1641817620 41' 9-max Seat #3 is the button
Seat 1: vettecha (4990 in chips) 
Seat 2: ARAVNOA (4975 in chips) 
Seat 3: FlaxonJin (4945 in chips) 
Seat 4: gigibaston (4960 in chips) 
Seat 5: Jujubh (4634 in chips) 
Seat 6: Matiellão (4990 in chips) 
Seat 7: MayFuNg1979 (5436 in chips) 
Seat 8: relmat (7111 in chips) 
Seat 9: Gwermort (2959 in chips) 
vettecha: posts the ante 5
ARAVNOA: posts the ante 5
FlaxonJin: posts the ante 5
gigibaston: posts the ante 5
Jujubh: posts the ante 5
Matiellão: posts the ante 5
MayFuNg1979: posts the ante 5
relmat: posts the ante 5
Gwermort: posts the ante 5
gigibaston: posts small blind 15
Jujubh: posts big blind 30
*** HOLE CARDS ***
Matiellão: folds 
MayFuNg1979: folds 
relmat: folds 
Gwermort: raises 42 to 72
vettecha: calls 72
ARAVNOA: folds 
FlaxonJin: raises 78 to 150
gigibaston: folds 
Jujubh: folds 
Gwermort: calls 78
vettecha: calls 78
*** FLOP *** [4c Tc Td]
Gwermort: checks 
vettecha: checks 
FlaxonJin: bets 270
Gwermort: folds 
vettecha: folds 
Uncalled bet (270) returned to FlaxonJin
FlaxonJin collected 540 from pot
*** SUMMARY ***
Total pot 540 | Rake 0 
Board [4c Tc Td]
Seat 1: vettecha folded on the Flop
Seat 2: ARAVNOA folded before Flop (didn't bet)
Seat 3: FlaxonJin (button) collected (540)
Seat 4: gigibaston (small blind) folded before Flop
Seat 5: Jujubh (big blind) folded before Flop
Seat 6: Matiellão folded before Flop (didn't bet)
Seat 7: MayFuNg1979 folded before Flop (didn't bet)
Seat 8: relmat folded before Flop (didn't bet)
Seat 9: Gwermort folded on the Flop



PokerStars Hand #157575190511: Tournament #1641817620, $7.50+$7.50+$1.50 USD Hold'em No Limit - Level I (15/30) - 2016/08/21 18:33:30 ET
Table '1641817620 50' 9-max Seat #5 is the button
Seat 1: Alpentraum (4103 in chips) 
Seat 2: FrEmpireAk (10217 in chips) 
Seat 3: hat_coates (4940 in chips) 
Seat 4: GiCi40 (5000 in chips) 
Seat 5: Herbettigre (4835 in chips) 
Seat 6: saintP20 (1090 in chips) 
Seat 7: Shab26 (4850 in chips) 
Seat 8: thinkfeeldo (4985 in chips) 
Seat 9: ziomekek (4985 in chips) 
Alpentraum: posts the ante 5
FrEmpireAk: posts the ante 5
hat_coates: posts the ante 5
GiCi40: posts the ante 5
Herbettigre: posts the ante 5
saintP20: posts the ante 5
Shab26: posts the ante 5
thinkfeeldo: posts the ante 5
ziomekek: posts the ante 5
saintP20: posts small blind 15
Shab26: posts big blind 30
*** HOLE CARDS ***
thinkfeeldo: folds 
ziomekek: folds 
Alpentraum: folds 
FrEmpireAk: raises 30 to 60
hat_coates: folds 
GiCi40: folds 
Herbettigre: raises 90 to 150
saintP20: folds 
Shab26: folds 
FrEmpireAk: folds 
Uncalled bet (90) returned to Herbettigre
Herbettigre collected 210 from pot
*** SUMMARY ***
Total pot 210 | Rake 0 
Seat 1: Alpentraum folded before Flop (didn't bet)
Seat 2: FrEmpireAk folded before Flop
Seat 3: hat_coates folded before Flop (didn't bet)
Seat 4: GiCi40 folded before Flop (didn't bet)
Seat 5: Herbettigre (button) collected (210)
Seat 6: saintP20 (small blind) folded before Flop
Seat 7: Shab26 (big blind) folded before Flop
Seat 8: thinkfeeldo folded before Flop (didn't bet)
Seat 9: ziomekek folded before Flop (didn't bet)



PokerStars Hand #157575191122: Tournament #1641817620, $7.50+$7.50+$1.50 USD Hold'em No Limit - Level I (15/30) - 2016/08/21 18:33:31 ET
Table '1641817620 11' 9-max Seat #4 is the button
Seat 1: GambleGrill (4985 in chips) 
Seat 2: Dionakabarbi (4970 in chips) 
Seat 3: TriviGn'R (5025 in chips) 
Seat 4: rapo007 (4940 in chips) 
Seat 5: vanilaice88 (4745 in chips) 
Seat 6: buzios38 (5615 in chips) 
Seat 7: BAIGUATE (4750 in chips) 
Seat 8: luisnrd (4985 in chips) 
Seat 9: kylix42 (4985 in chips) 
GambleGrill: posts the ante 5
Dionakabarbi: posts the ante 5
TriviGn'R: posts the ante 5
rapo007: posts the ante 5
vanilaice88: posts the ante 5
buzios38: posts the ante 5
BAIGUATE: posts the ante 5
luisnrd: posts the ante 5
kylix42: posts the ante 5
vanilaice88: posts small blind 15
buzios38: posts big blind 30
*** HOLE CARDS ***
BAIGUATE: raises 30 to 60
luisnrd: calls 60
kylix42: folds 
GambleGrill: folds 
Dionakabarbi has timed out
Dionakabarbi: folds 
Dionakabarbi is sitting out
TriviGn'R: folds 
Dionakabarbi has returned
rapo007: folds 
vanilaice88: folds 
buzios38: calls 30
*** FLOP *** [2d Kh 7s]
buzios38: checks 
BAIGUATE: bets 120
luisnrd: folds 
buzios38: folds 
Uncalled bet (120) returned to BAIGUATE
BAIGUATE collected 240 from pot
*** SUMMARY ***
Total pot 240 | Rake 0 
Board [2d Kh 7s]
Seat 1: GambleGrill folded before Flop (didn't bet)
Seat 2: Dionakabarbi folded before Flop (didn't bet)
Seat 3: TriviGn'R folded before Flop (didn't bet)
Seat 4: rapo007 (button) folded before Flop (didn't bet)
Seat 5: vanilaice88 (small blind) folded before Flop
Seat 6: buzios38 (big blind) folded on the Flop
Seat 7: BAIGUATE collected (240)
Seat 8: luisnrd folded on the Flop
Seat 9: kylix42 folded before Flop (didn't bet)



PokerStars Hand #157575192017: Tournament #1641817620, $7.50+$7.50+$1.50 USD Hold'em No Limit - Level I (15/30) - 2016/08/21 18:33:32 ET
Table '1641817620 7' 9-max Seat #6 is the button
Seat 1: jad castelo (5075 in chips) 
Seat 2: ricar1749 (4985 in chips) 
Seat 3: Steve G009 (4970 in chips) 
Seat 4: nbmom (4880 in chips) 
Seat 5: bernardijack (5000 in chips) 
Seat 6: POKEMONSTRO (4925 in chips) 
Seat 7: NemeanDanny (5055 in chips) 
Seat 8: Original02 (5370 in chips) 
Seat 9: cjgarceau (4985 in chips) 
jad castelo: posts the ante 5
ricar1749: posts the ante 5
Steve G009: posts the ante 5
nbmom: posts the ante 5
bernardijack: posts the ante 5
POKEMONSTRO: posts the ante 5
NemeanDanny: posts the ante 5
Original02: posts the ante 5
cjgarceau: posts the ante 5
NemeanDanny: posts small blind 15
Original02: posts big blind 30
*** HOLE CARDS ***
cjgarceau: raises 30 to 60
jad castelo: folds 
ricar1749: folds 
Steve G009: folds 
nbmom: folds 
bernardijack: calls 60
POKEMONSTRO: folds 
NemeanDanny: folds 
Original02: folds 
*** FLOP *** [2c 5c 6c]
cjgarceau: checks 
bernardijack: bets 105
cjgarceau: folds 
Uncalled bet (105) returned to bernardijack
bernardijack collected 210 from pot
bernardijack: doesn't show hand 
*** SUMMARY ***
Total pot 210 | Rake 0 
Board [2c 5c 6c]
Seat 1: jad castelo folded before Flop (didn't bet)
Seat 2: ricar1749 folded before Flop (didn't bet)
Seat 3: Steve G009 folded before Flop (didn't bet)
Seat 4: nbmom folded before Flop (didn't bet)
Seat 5: bernardijack collected (210)
Seat 6: POKEMONSTRO (button) folded before Flop (didn't bet)
Seat 7: NemeanDanny (small blind) folded before Flop
Seat 8: Original02 (big blind) folded before Flop
Seat 9: cjgarceau folded on the Flop



PokerStars Hand #157575193874: Tournament #1641817620, $7.50+$7.50+$1.50 USD Hold'em No Limit - Level I (15/30) - 2016/08/21 18:33:35 ET
Table '1641817620 48' 9-max Seat #4 is the button
Seat 1: soft8981 (4691 in chips) 
Seat 2: getatore (5135 in chips) 
Seat 3: Serg2407 (4850 in chips) 
Seat 4: Zareta (4880 in chips) 
Seat 5: NSStefan (4955 in chips) 
Seat 6: ATE13 (4985 in chips) 
Seat 7: BRUCE999999 (5000 in chips) 
Seat 8: howtown (4691 in chips) 
Seat 9: qcouest (5813 in chips) 
soft8981: posts the ante 5
getatore: posts the ante 5
Serg2407: posts the ante 5
Zareta: posts the ante 5
NSStefan: posts the ante 5
ATE13: posts the ante 5
BRUCE999999: posts the ante 5
howtown: posts the ante 5
qcouest: posts the ante 5
NSStefan: posts small blind 15
ATE13: posts big blind 30
*** HOLE CARDS ***
BRUCE999999: raises 30 to 60
howtown: folds 
qcouest: folds 
soft8981: calls 60
getatore: folds 
Serg2407: folds 
Zareta: folds 
NSStefan: folds 
ATE13: calls 30
*** FLOP *** [4h Jh 6h]
ATE13: checks 
BRUCE999999: bets 60
soft8981: raises 120 to 180
ATE13: folds 
BRUCE999999: folds 
Uncalled bet (120) returned to soft8981
soft8981 collected 360 from pot
*** SUMMARY ***
Total pot 360 | Rake 0 
Board [4h Jh 6h]
Seat 1: soft8981 collected (360)
Seat 2: getatore folded before Flop (didn't bet)
Seat 3: Serg2407 folded before Flop (didn't bet)
Seat 4: Zareta (button) folded before Flop (didn't bet)
Seat 5: NSStefan (small blind) folded before Flop
Seat 6: ATE13 (big blind) folded on the Flop
Seat 7: BRUCE999999 folded on the Flop
Seat 8: howtown folded before Flop (didn't bet)
Seat 9: qcouest folded before Flop (didn't bet)



PokerStars Hand #157575194799: Tournament #1641817620, $7.50+$7.50+$1.50 USD Hold'em No Limit - Level I (15/30) - 2016/08/21 18:33:36 ET
Table '1641817620 6' 9-max Seat #8 is the button
Seat 1: ASTRAXANSKI (4975 in chips) 
Seat 2: KOT-BEGEMOT6 (4960 in chips) 
Seat 3: agneseagnese (4985 in chips) 
Seat 4: mekkoramarha (4955 in chips) 
Seat 5: KKKistKKK (3844 in chips) 
Seat 6: brown1967 (5010 in chips) 
Seat 7: Balotelli195 (5020 in chips) 
Seat 8: linoleum006 (4985 in chips) 
Seat 9: Jelsomino79 (6271 in chips) 
ASTRAXANSKI: posts the ante 5
KOT-BEGEMOT6: posts the ante 5
agneseagnese: posts the ante 5
mekkoramarha: posts the ante 5
KKKistKKK: posts the ante 5
brown1967: posts the ante 5
Balotelli195: posts the ante 5
linoleum006: posts the ante 5
Jelsomino79: posts the ante 5
Jelsomino79: posts small blind 15
ASTRAXANSKI: posts big blind 30
*** HOLE CARDS ***
KOT-BEGEMOT6: folds 
agneseagnese: calls 30
mekkoramarha: folds 
KKKistKKK: calls 30
brown1967: folds 
Balotelli195: raises 60 to 90
linoleum006: raises 347 to 437
Jelsomino79: folds 
ASTRAXANSKI: folds 
agneseagnese: folds 
KKKistKKK: folds 
Balotelli195: raises 763 to 1200
linoleum006: raises 3780 to 4980 and is all-in
Balotelli195: calls 3780
*** FLOP *** [Jc 8h 5d]
*** TURN *** [Jc 8h 5d] [Qs]
*** RIVER *** [Jc 8h 5d Qs] [4h]
*** SHOW DOWN ***
Balotelli195: shows [Qc Qh] (three of a kind, Queens)
linoleum006: shows [Ah Kh] (high card Ace)
Balotelli195 collected 10110 from pot
Balotelli195 wins $3.75 for eliminating linoleum006 and their own bounty increases by $3.75 to $11.25
linoleum006 finished the tournament in 999999988th place
*** SUMMARY ***
Total pot 10110 | Rake 0 
Board [Jc 8h 5d Qs 4h]
Seat 1: ASTRAXANSKI (big blind) folded before Flop
Seat 2: KOT-BEGEMOT6 folded before Flop (didn't bet)
Seat 3: agneseagnese folded before Flop
Seat 4: mekkoramarha folded before Flop (didn't bet)
Seat 5: KKKistKKK folded before Flop
Seat 6: brown1967 folded before Flop (didn't bet)
Seat 7: Balotelli195 showed [Qc Qh] and won (10110) with three of a kind, Queens
Seat 8: linoleum006 (button) showed [Ah Kh] and lost with high card Ace
Seat 9: Jelsomino79 (small blind) folded before Flop



PokerStars Hand #157575194943: Tournament #1641817620, $7.50+$7.50+$1.50 USD Hold'em No Limit - Level I (15/30) - 2016/08/21 18:33:36 ET
Table '1641817620 9' 9-max Seat #5 is the button
Seat 1: kake40 (4890 in chips) 
Seat 2: Cergey1387 (4450 in chips) 
Seat 3: portugajr007 (5693 in chips) 
Seat 4: punkhead89 (5527 in chips) 
Seat 5: nO bUsTeD (4725 in chips) 
Seat 6: Greeno93 (5000 in chips) out of hand (moved from another table into small blind)
Seat 7: Cuzco83 (4950 in chips) 
Seat 8: maurogynppp (4980 in chips) 
Seat 9: N1COLOSO (4800 in chips) 
kake40: posts the ante 5
Cergey1387: posts the ante 5
portugajr007: posts the ante 5
punkhead89: posts the ante 5
nO bUsTeD: posts the ante 5
Cuzco83: posts the ante 5
maurogynppp: posts the ante 5
N1COLOSO: posts the ante 5
Cuzco83: posts small blind 15
maurogynppp: posts big blind 30
*** HOLE CARDS ***
N1COLOSO: folds 
kake40: folds 
Cergey1387: raises 30 to 60
portugajr007: folds 
punkhead89: folds 
nO bUsTeD: folds 
Cuzco83: calls 45
maurogynppp: calls 30
*** FLOP *** [2d 5s 5h]
Cuzco83: checks 
maurogynppp: checks 
Cergey1387: bets 60
Cuzco83: folds 
maurogynppp: folds 
Uncalled bet (60) returned to Cergey1387
Cergey1387 collected 220 from pot
*** SUMMARY ***
Total pot 220 | Rake 0 
Board [2d 5s 5h]
Seat 1: kake40 folded before Flop (didn't bet)
Seat 2: Cergey1387 collected (220)
Seat 3: portugajr007 folded before Flop (didn't bet)
Seat 4: punkhead89 folded before Flop (didn't bet)
Seat 5: nO bUsTeD (button) folded before Flop (didn't bet)
Seat 7: Cuzco83 (small blind) folded on the Flop
Seat 8: maurogynppp (big blind) folded on the Flop
Seat 9: N1COLOSO folded before Flop (didn't bet)



PokerStars Hand #157575194983: Tournament #1641817620, $7.50+$7.50+$1.50 USD Hold'em No Limit - Level I (15/30) - 2016/08/21 18:33:37 ET
Table '1641817620 58' 9-max Seat #3 is the button
Seat 1: bld66 (4660 in chips) 
Seat 2: FACEBUHH (7240 in chips) 
Seat 3: CFgabriel (4945 in chips) 
Seat 4: nejirose (4960 in chips) 
Seat 5: pokercr7721 (4990 in chips) 
Seat 6: verdao134 (4990 in chips) 
Seat 7: I_R0B0T_90 (4990 in chips) 
Seat 8: lovebigpairs (2710 in chips) 
Seat 9: binho1806 (5515 in chips) 
bld66: posts the ante 5
FACEBUHH: posts the ante 5
CFgabriel: posts the ante 5
nejirose: posts the ante 5
pokercr7721: posts the ante 5
verdao134: posts the ante 5
I_R0B0T_90: posts the ante 5
lovebigpairs: posts the ante 5
binho1806: posts the ante 5
nejirose: posts small blind 15
pokercr7721: posts big blind 30
*** HOLE CARDS ***
verdao134: folds 
I_R0B0T_90: folds 
lovebigpairs: raises 2675 to 2705 and is all-in
binho1806: folds 
bld66: folds 
FACEBUHH: folds 
CFgabriel: folds 
nejirose: folds 
pokercr7721: folds 
Uncalled bet (2675) returned to lovebigpairs
lovebigpairs collected 120 from pot
lovebigpairs: doesn't show hand 
*** SUMMARY ***
Total pot 120 | Rake 0 
Seat 1: bld66 folded before Flop (didn't bet)
Seat 2: FACEBUHH folded before Flop (didn't bet)
Seat 3: CFgabriel (button) folded before Flop (didn't bet)
Seat 4: nejirose (small blind) folded before Flop
Seat 5: pokercr7721 (big blind) folded before Flop
Seat 6: verdao134 folded before Flop (didn't bet)
Seat 7: I_R0B0T_90 folded before Flop (didn't bet)
Seat 8: lovebigpairs collected (120)
Seat 9: binho1806 folded before Flop (didn't bet)



PokerStars Hand #157575198152: Tournament #1641817620, $7.50+$7.50+$1.50 USD Hold'em No Limit - Level I (15/30) - 2016/08/21 18:33:41 ET
Table '1641817620 26' 9-max Seat #6 is the button
Seat 1: duplo1182 (4980 in chips) 
Seat 2: Heretic66688 (4965 in chips) 
Seat 3: Axkj (4935 in chips) 
Seat 4: h1per1on (5280 in chips) 
Seat 5: zuzlica (5000 in chips) 
Seat 6: Archibal_17 (4525 in chips) 
Seat 7: GDLW26 (4950 in chips) 
Seat 9: danius111 (5155 in chips) 
duplo1182: posts the ante 5
Heretic66688: posts the ante 5
Axkj: posts the ante 5
h1per1on: posts the ante 5
zuzlica: posts the ante 5
Archibal_17: posts the ante 5
GDLW26: posts the ante 5
danius111: posts the ante 5
GDLW26: posts small blind 15
danius111: posts big blind 30
*** HOLE CARDS ***
duplo1182: raises 60 to 90
Heretic66688: folds 
Axkj: folds 
h1per1on: folds 
zuzlica: calls 90
Archibal_17: folds 
GDLW26: calls 75
danius111: folds 
*** FLOP *** [4h Qs 5d]
GDLW26: checks 
duplo1182: bets 170
zuzlica: calls 170
GDLW26: folds 
*** TURN *** [4h Qs 5d] [Qh]
duplo1182: checks 
zuzlica: bets 340
duplo1182: folds 
Uncalled bet (340) returned to zuzlica
zuzlica collected 680 from pot
zuzlica: doesn't show hand 
*** SUMMARY ***
Total pot 680 | Rake 0 
Board [4h Qs 5d Qh]
Seat 1: duplo1182 folded on the Turn
Seat 2: Heretic66688 folded before Flop (didn't bet)
Seat 3: Axkj folded before Flop (didn't bet)
Seat 4: h1per1on folded before Flop (didn't bet)
Seat 5: zuzlica collected (680)
Seat 6: Archibal_17 (button) folded before Flop (didn't bet)
Seat 7: GDLW26 (small blind) folded on the Flop
Seat 9: danius111 (big blind) folded before Flop



PokerStars Hand #157575198201: Tournament #1641817620, $7.50+$7.50+$1.50 USD Hold'em No Limit - Level I (15/30) - 2016/08/21 18:33:41 ET
Table '1641817620 54' 9-max Seat #5 is the button
Seat 1: nixx77 (4980 in chips) 
Seat 2: FábioC.p.br (4965 in chips) 
Seat 3: pinokkioOo (4935 in chips) 
Seat 4: ALLESC-114 (4935 in chips) 
Seat 5: appache55 (3255 in chips) 
Seat 6: hrabbi87 (4890 in chips) 
Seat 8: MiltonMorais (4980 in chips) 
Seat 9: ZeckMaverick (4980 in chips) 
nixx77: posts the ante 5
FábioC.p.br: posts the ante 5
pinokkioOo: posts the ante 5
ALLESC-114: posts the ante 5
appache55: posts the ante 5
hrabbi87: posts the ante 5
MiltonMorais: posts the ante 5
ZeckMaverick: posts the ante 5
hrabbi87: posts small blind 15
MiltonMorais: posts big blind 30
*** HOLE CARDS ***
ZeckMaverick: folds 
nixx77: folds 
FábioC.p.br: folds 
pinokkioOo: folds 
ALLESC-114: folds 
appache55: calls 30
hrabbi87: folds 
MiltonMorais: checks 
*** FLOP *** [As 6c 3s]
MiltonMorais: checks 
appache55: checks 
*** TURN *** [As 6c 3s] [2s]
MiltonMorais: checks 
appache55: checks 
*** RIVER *** [As 6c 3s 2s] [5s]
MiltonMorais: checks 
appache55: checks 
*** SHOW DOWN ***
MiltonMorais: shows [Jh 4c] (a straight, Deuce to Six)
appache55: mucks hand 
MiltonMorais collected 115 from pot
*** SUMMARY ***
Total pot 115 | Rake 0 
Board [As 6c 3s 2s 5s]
Seat 1: nixx77 folded before Flop (didn't bet)
Seat 2: FábioC.p.br folded before Flop (didn't bet)
Seat 3: pinokkioOo folded before Flop (didn't bet)
Seat 4: ALLESC-114 folded before Flop (didn't bet)
Seat 5: appache55 (button) mucked
Seat 6: hrabbi87 (small blind) folded before Flop
Seat 8: MiltonMorais (big blind) showed [Jh 4c] and won (115) with a straight, Deuce to Six
Seat 9: ZeckMaverick folded before Flop (didn't bet)



PokerStars Hand #157575198260: Tournament #1641817620, $7.50+$7.50+$1.50 USD Hold'em No Limit - Level I (15/30) - 2016/08/21 18:33:42 ET
Table '1641817620 1' 9-max Seat #6 is the button
Seat 1: mattyonuts (5133 in chips) 
Seat 2: topaipi (5159 in chips) 
Seat 3: MAMOHT_T (4935 in chips) 
Seat 4: ManMaPayé (4995 in chips) 
Seat 5: LADIEFJ (6000 in chips) 
Seat 6: TheGuerreiro (4713 in chips) 
Seat 7: spiderhami (5000 in chips) out of hand (moved from another table into small blind)
Seat 8: K. Ichinose (4904 in chips) 
mattyonuts: posts the ante 5
topaipi: posts the ante 5
MAMOHT_T: posts the ante 5
ManMaPayé: posts the ante 5
LADIEFJ: posts the ante 5
TheGuerreiro: posts the ante 5
K. Ichinose: posts the ante 5
K. Ichinose: posts small blind 15
mattyonuts: posts big blind 30
*** HOLE CARDS ***
topaipi: folds 
MAMOHT_T: folds 
ManMaPayé: folds 
LADIEFJ: folds 
TheGuerreiro: folds 
K. Ichinose: raises 60 to 90
mattyonuts: folds 
Uncalled bet (60) returned to K. Ichinose
K. Ichinose collected 95 from pot
K. Ichinose: doesn't show hand 
*** SUMMARY ***
Total pot 95 | Rake 0 
Seat 1: mattyonuts (big blind) folded before Flop
Seat 2: topaipi folded before Flop (didn't bet)
Seat 3: MAMOHT_T folded before Flop (didn't bet)
Seat 4: ManMaPayé folded before Flop (didn't bet)
Seat 5: LADIEFJ folded before Flop (didn't bet)
Seat 6: TheGuerreiro (button) folded before Flop (didn't bet)
Seat 8: K. Ichinose (small blind) collected (95)



PokerStars Hand #157575199127: Tournament #1641817620, $7.50+$7.50+$1.50 USD Hold'em No Limit - Level I (15/30) - 2016/08/21 18:33:43 ET
Table '1641817620 27' 9-max Seat #4 is the button
Seat 1: TheKaisa87 (4775 in chips) 
Seat 3: SweetieSpy (6064 in chips) 
Seat 4: Mr_Buckworth (5165 in chips) 
Seat 5: ladymadon107 (4325 in chips) 
Seat 6: 6aDyHtry (4355 in chips) 
Seat 7: csfreak (4985 in chips) 
Seat 8: MasteDonBull (5000 in chips) 
Seat 9: kyzyldurrr (5371 in chips) 
TheKaisa87: posts the ante 5
SweetieSpy: posts the ante 5
Mr_Buckworth: posts the ante 5
ladymadon107: posts the ante 5
6aDyHtry: posts the ante 5
csfreak: posts the ante 5
MasteDonBull: posts the ante 5
kyzyldurrr: posts the ante 5
ladymadon107: posts small blind 15
6aDyHtry: posts big blind 30
*** HOLE CARDS ***
csfreak: folds 
MasteDonBull: folds 
kyzyldurrr: folds 
TheKaisa87: folds 
SweetieSpy: folds 
Mr_Buckworth: folds 
ladymadon107: calls 15
6aDyHtry: checks 
*** FLOP *** [Ac 3d 5c]
ladymadon107: checks 
6aDyHtry: bets 30
ladymadon107: folds 
Uncalled bet (30) returned to 6aDyHtry
6aDyHtry collected 100 from pot
6aDyHtry: doesn't show hand 
*** SUMMARY ***
Total pot 100 | Rake 0 
Board [Ac 3d 5c]
Seat 1: TheKaisa87 folded before Flop (didn't bet)
Seat 3: SweetieSpy folded before Flop (didn't bet)
Seat 4: Mr_Buckworth (button) folded before Flop (didn't bet)
Seat 5: ladymadon107 (small blind) folded on the Flop
Seat 6: 6aDyHtry (big blind) collected (100)
Seat 7: csfreak folded before Flop (didn't bet)
Seat 8: MasteDonBull folded before Flop (didn't bet)
Seat 9: kyzyldurrr folded before Flop (didn't bet)



PokerStars Hand #157575200108: Tournament #1641817620, $7.50+$7.50+$1.50 USD Hold'em No Limit - Level I (15/30) - 2016/08/21 18:33:44 ET
Table '1641817620 42' 9-max Seat #4 is the button
Seat 1: killa187187 (4775 in chips) 
Seat 2: lmiotto88 (5210 in chips) 
Seat 3: Piiirat (4940 in chips) 
Seat 4: skjørring (4940 in chips) 
Seat 5: AcabeiDeSair (4955 in chips) 
Seat 6: phathead109 (5000 in chips) 
Seat 7: ThirtyTw0 (5130 in chips) 
Seat 8: FeFeFeFeFEDE (4985 in chips) 
Seat 9: radekvv777 (10065 in chips) 
killa187187: posts the ante 5
lmiotto88: posts the ante 5
Piiirat: posts the ante 5
skjørring: posts the ante 5
AcabeiDeSair: posts the ante 5
phathead109: posts the ante 5
ThirtyTw0: posts the ante 5
FeFeFeFeFEDE: posts the ante 5
radekvv777: posts the ante 5
AcabeiDeSair: posts small blind 15
phathead109: posts big blind 30
*** HOLE CARDS ***
ThirtyTw0: folds 
FeFeFeFeFEDE: raises 60 to 90
radekvv777: calls 90
killa187187: folds 
lmiotto88: folds 
Piiirat: folds 
skjørring: calls 90
AcabeiDeSair: folds 
phathead109: folds 
*** FLOP *** [3d 7h 7c]
FeFeFeFeFEDE: checks 
radekvv777: checks 
skjørring: checks 
*** TURN *** [3d 7h 7c] [8s]
FeFeFeFeFEDE: checks 
radekvv777: checks 
skjørring: checks 
*** RIVER *** [3d 7h 7c 8s] [Kh]
FeFeFeFeFEDE: checks 
radekvv777: bets 390
skjørring: raises 390 to 780
FeFeFeFeFEDE: folds 
radekvv777: folds 
Uncalled bet (390) returned to skjørring
skjørring collected 1140 from pot
skjørring: doesn't show hand 
*** SUMMARY ***
Total pot 1140 | Rake 0 
Board [3d 7h 7c 8s Kh]
Seat 1: killa187187 folded before Flop (didn't bet)
Seat 2: lmiotto88 folded before Flop (didn't bet)
Seat 3: Piiirat folded before Flop (didn't bet)
Seat 4: skjørring (button) collected (1140)
Seat 5: AcabeiDeSair (small blind) folded before Flop
Seat 6: phathead109 (big blind) folded before Flop
Seat 7: ThirtyTw0 folded before Flop (didn't bet)
Seat 8: FeFeFeFeFEDE folded on the River
Seat 9: radekvv777 folded on the River



PokerStars Hand #157575200310: Tournament #1641817620, $7.50+$7.50+$1.50 USD Hold'em No Limit - Level I (15/30) - 2016/08/21 18:33:45 ET
Table '1641817620 32' 9-max Seat #6 is the button
Seat 1: RoribeiroS (6593 in chips) 
Seat 2: tomgan (5110 in chips) 
Seat 3: patou99957 (4391 in chips) 
Seat 4: JAhodaZ (4905 in chips) 
Seat 5: bdiddy1313 (5320 in chips) 
Seat 6: 69 hearts 69 (4166 in chips) 
Seat 7: rimis9999 (4950 in chips) 
Seat 8: noah5555 (4680 in chips) 
Seat 9: gamesAREover (4890 in chips) 
RoribeiroS: posts the ante 5
tomgan: posts the ante 5
patou99957: posts the ante 5
JAhodaZ: posts the ante 5
bdiddy1313: posts the ante 5
69 hearts 69: posts the ante 5
rimis9999: posts the ante 5
noah5555: posts the ante 5
gamesAREover: posts the ante 5
rimis9999: posts small blind 15
noah5555: posts big blind 30
*** HOLE CARDS ***
gamesAREover: folds 
RoribeiroS: folds 
tomgan: folds 
patou99957: calls 30
JAhodaZ: folds 
bdiddy1313: folds 
69 hearts 69: folds 
rimis9999: folds 
noah5555: checks 
*** FLOP *** [3s 8s 9h]
noah5555: checks 
patou99957: checks 
*** TURN *** [3s 8s 9h] [Kd]
noah5555: checks 
patou99957: checks 
*** RIVER *** [3s 8s 9h Kd] [4d]
noah5555: checks 
patou99957: checks 
*** SHOW DOWN ***
noah5555: shows [5s 2d] (high card King)
patou99957: shows [7d Qd] (high card King - Queen kicker)
patou99957 collected 120 from pot
*** SUMMARY ***
Total pot 120 | Rake 0 
Board [3s 8s 9h Kd 4d]
Seat 1: RoribeiroS folded before Flop (didn't bet)
Seat 2: tomgan folded before Flop (didn't bet)
Seat 3: patou99957 showed [7d Qd] and won (120) with high card King
Seat 4: JAhodaZ folded before Flop (didn't bet)
Seat 5: bdiddy1313 folded before Flop (didn't bet)
Seat 6: 69 hearts 69 (button) folded before Flop (didn't bet)
Seat 7: rimis9999 (small blind) folded before Flop
Seat 8: noah5555 (big blind) showed [5s 2d] and lost with high card King
Seat 9: gamesAREover folded before Flop (didn't bet)



PokerStars Hand #157575200931: Tournament #1641817620, $7.50+$7.50+$1.50 USD Hold'em No Limit - Level I (15/30) - 2016/08/21 18:33:46 ET
Table '1641817620 33' 9-max Seat #8 is the button
Seat 1: fungyou (4970 in chips) 
Seat 2: titauhu (4955 in chips) 
Seat 3: gmdef.2001 (4925 in chips) 
Seat 4: natahha_92 (4985 in chips) 
Seat 5: T@keItDown (5010 in chips) 
Seat 6: REPPARTFLOW (5015 in chips) 
Seat 7: dennismitru (5105 in chips) 
Seat 8: Joao Valli (4925 in chips) 
Seat 9: Pablos701 (5115 in chips) 
fungyou: posts the ante 5
titauhu: posts the ante 5
gmdef.2001: posts the ante 5
natahha_92: posts the ante 5
T@keItDown: posts the ante 5
REPPARTFLOW: posts the ante 5
dennismitru: posts the ante 5
Joao Valli: posts the ante 5
Pablos701: posts the ante 5
Pablos701: posts small blind 15
fungyou: posts big blind 30
*** HOLE CARDS ***
titauhu: raises 60 to 90
gmdef.2001: folds 
natahha_92: folds 
T@keItDown: folds 
REPPARTFLOW: folds 
dennismitru: folds 
Joao Valli: folds 
Pablos701: raises 195 to 285
fungyou: folds 
titauhu: calls 195
*** FLOP *** [Ac Td 5c]
Pablos701: checks 
titauhu: checks 
*** TURN *** [Ac Td 5c] [8d]
Pablos701: checks 
titauhu: checks 
*** RIVER *** [Ac Td 5c 8d] [3s]
Pablos701: bets 328
titauhu: calls 328
*** SHOW DOWN ***
Pablos701: shows [Kh Kc] (a pair of Kings)
titauhu: mucks hand 
Pablos701 collected 1301 from pot
*** SUMMARY ***
Total pot 1301 | Rake 0 
Board [Ac Td 5c 8d 3s]
Seat 1: fungyou (big blind) folded before Flop
Seat 2: titauhu mucked
Seat 3: gmdef.2001 folded before Flop (didn't bet)
Seat 4: natahha_92 folded before Flop (didn't bet)
Seat 5: T@keItDown folded before Flop (didn't bet)
Seat 6: REPPARTFLOW folded before Flop (didn't bet)
Seat 7: dennismitru folded before Flop (didn't bet)
Seat 8: Joao Valli (button) folded before Flop (didn't bet)
Seat 9: Pablos701 (small blind) showed [Kh Kc] and won (1301) with a pair of Kings



PokerStars Hand #157575201670: Tournament #1641817620, $7.50+$7.50+$1.50 USD Hold'em No Limit - Level I (15/30) - 2016/08/21 18:33:47 ET
Table '1641817620 5' 9-max Seat #6 is the button
Seat 1: PsychixtellO (4990 in chips) 
Seat 2: jonesfi5sh (5350 in chips) 
Seat 3: PhenomPen1 (4920 in chips) 
Seat 4: GrimJoker77 (4975 in chips) 
Seat 5: Bolfra1 (5000 in chips) 
Seat 6: Javicho9 (4545 in chips) 
Seat 7: pokertepec (5000 in chips) out of hand (moved from another table into small blind)
Seat 8: sloty27 (4890 in chips) 
Seat 9: chuny dealer (5210 in chips) 
PsychixtellO: posts the ante 5
jonesfi5sh: posts the ante 5
PhenomPen1: posts the ante 5
GrimJoker77: posts the ante 5
Bolfra1: posts the ante 5
Javicho9: posts the ante 5
sloty27: posts the ante 5
chuny dealer: posts the ante 5
sloty27: posts small blind 15
chuny dealer: posts big blind 30
*** HOLE CARDS ***
PsychixtellO is connected 
PsychixtellO: folds 
jonesfi5sh: raises 30 to 60
PhenomPen1: folds 
GrimJoker77: folds 
Bolfra1: calls 60
Javicho9: folds 
sloty27: folds 
chuny dealer: calls 30
*** FLOP *** [5c 8d Jh]
chuny dealer: checks 
jonesfi5sh: checks 
Bolfra1: checks 
*** TURN *** [5c 8d Jh] [4c]
chuny dealer: bets 110
jonesfi5sh: calls 110
Bolfra1: calls 110
*** RIVER *** [5c 8d Jh 4c] [Qc]
chuny dealer: checks 
jonesfi5sh: bets 300
Bolfra1: folds 
chuny dealer: calls 300
*** SHOW DOWN ***
jonesfi5sh: shows [6c Ac] (a flush, Ace high)
chuny dealer: mucks hand 
jonesfi5sh collected 1165 from pot
*** SUMMARY ***
Total pot 1165 | Rake 0 
Board [5c 8d Jh 4c Qc]
Seat 1: PsychixtellO folded before Flop (didn't bet)
Seat 2: jonesfi5sh showed [6c Ac] and won (1165) with a flush, Ace high
Seat 3: PhenomPen1 folded before Flop (didn't bet)
Seat 4: GrimJoker77 folded before Flop (didn't bet)
Seat 5: Bolfra1 folded on the River
Seat 6: Javicho9 (button) folded before Flop (didn't bet)
Seat 8: sloty27 (small blind) folded before Flop
Seat 9: chuny dealer (big blind) mucked



PokerStars Hand #157575201730: Tournament #1641817620, $7.50+$7.50+$1.50 USD Hold'em No Limit - Level I (15/30) - 2016/08/21 18:33:47 ET
Table '1641817620 34' 9-max Seat #5 is the button
Seat 1: Zukertort (4980 in chips) is sitting out
Seat 2: AngelBerley (4965 in chips) 
Seat 3: Zigslick (4935 in chips) 
Seat 4: Snabers (4755 in chips) 
Seat 5: juggaletto (5040 in chips) 
Seat 6: virtus213 (4830 in chips) 
Seat 7: Poher42 (5265 in chips) 
Seat 8: S.FILTH (4980 in chips) 
Seat 9: omar miete (5250 in chips) 
Zukertort: posts the ante 5
AngelBerley: posts the ante 5
Zigslick: posts the ante 5
Snabers: posts the ante 5
juggaletto: posts the ante 5
virtus213: posts the ante 5
Poher42: posts the ante 5
S.FILTH: posts the ante 5
omar miete: posts the ante 5
virtus213: posts small blind 15
Poher42: posts big blind 30
*** HOLE CARDS ***
S.FILTH: folds 
omar miete: folds 
Zukertort: folds 
AngelBerley: raises 60 to 90
Zigslick: folds 
Snabers: folds 
juggaletto: calls 90
virtus213: folds 
Poher42: folds 
*** FLOP *** [5h 3s 4h]
AngelBerley: bets 135
juggaletto: calls 135
*** TURN *** [5h 3s 4h] [3d]
AngelBerley: bets 120
juggaletto: calls 120
*** RIVER *** [5h 3s 4h 3d] [Js]
AngelBerley: checks 
juggaletto: bets 390
AngelBerley: folds 
Uncalled bet (390) returned to juggaletto
juggaletto collected 780 from pot
juggaletto: doesn't show hand 
*** SUMMARY ***
Total pot 780 | Rake 0 
Board [5h 3s 4h 3d Js]
Seat 1: Zukertort folded before Flop (didn't bet)
Seat 2: AngelBerley folded on the River
Seat 3: Zigslick folded before Flop (didn't bet)
Seat 4: Snabers folded before Flop (didn't bet)
Seat 5: juggaletto (button) collected (780)
Seat 6: virtus213 (small blind) folded before Flop
Seat 7: Poher42 (big blind) folded before Flop
Seat 8: S.FILTH folded before Flop (didn't bet)
Seat 9: omar miete folded before Flop (didn't bet)



PokerStars Hand #157575201788: Tournament #1641817620, $7.50+$7.50+$1.50 USD Hold'em No Limit - Level I (15/30) - 2016/08/21 18:33:47 ET
Table '1641817620 16' 9-max Seat #7 is the button
Seat 1: Kugelbohne79 (5180 in chips) 
Seat 2: Sergei0384 (5086 in chips) 
Seat 3: paschalisbg (4930 in chips) 
Seat 4: Maisiewin (4834 in chips) 
Seat 5: alemaozl (4930 in chips) 
Seat 6: Luis Reye837 (5000 in chips) 
Seat 7: burton14 (5015 in chips) 
Seat 8: Miky_Man993 (4855 in chips) 
Seat 9: ziboin (5185 in chips) 
Kugelbohne79: posts the ante 5
Sergei0384: posts the ante 5
paschalisbg: posts the ante 5
Maisiewin: posts the ante 5
alemaozl: posts the ante 5
Luis Reye837: posts the ante 5
burton14: posts the ante 5
Miky_Man993: posts the ante 5
ziboin: posts the ante 5
Miky_Man993: posts small blind 15
ziboin: posts big blind 30
*** HOLE CARDS ***
Kugelbohne79: folds 
Sergei0384: folds 
paschalisbg: folds 
Maisiewin: folds 
alemaozl: folds 
Luis Reye837: folds 
burton14: raises 30 to 60
Miky_Man993: folds 
ziboin: folds 
Uncalled bet (30) returned to burton14
burton14 collected 120 from pot
burton14: doesn't show hand 
*** SUMMARY ***
Total pot 120 | Rake 0 
Seat 1: Kugelbohne79 folded before Flop (didn't bet)
Seat 2: Sergei0384 folded before Flop (didn't bet)
Seat 3: paschalisbg folded before Flop (didn't bet)
Seat 4: Maisiewin folded before Flop (didn't bet)
Seat 5: alemaozl folded before Flop (didn't bet)
Seat 6: Luis Reye837 folded before Flop (didn't bet)
Seat 7: burton14 (button) collected (120)
Seat 8: Miky_Man993 (small blind) folded before Flop
Seat 9: ziboin (big blind) folded before Flop



PokerStars Hand #157575202673: Tournament #1641817620, $7.50+$7.50+$1.50 USD Hold'em No Limit - Level I (15/30) - 2016/08/21 18:33:48 ET
Table '1641817620 21' 9-max Seat #5 is the button
Seat 1: apaixtos1 (5520 in chips) 
Seat 2: ukr_durrrr (4845 in chips) 
Seat 3: ultgamb (4935 in chips) 
Seat 4: fishin1981 (4890 in chips) 
Seat 5: jeroma123 (4620 in chips) 
Seat 6: olleggi (5040 in chips) 
Seat 7: pokerlazik (4980 in chips) 
Seat 8: pokerist2692 (5190 in chips) 
Seat 9: Ferrazz (4980 in chips) 
apaixtos1: posts the ante 5
ukr_durrrr: posts the ante 5
ultgamb: posts the ante 5
fishin1981: posts the ante 5
jeroma123: posts the ante 5
olleggi: posts the ante 5
pokerlazik: posts the ante 5
pokerist2692: posts the ante 5
Ferrazz: posts the ante 5
olleggi: posts small blind 15
pokerlazik: posts big blind 30
*** HOLE CARDS ***
pokerist2692: raises 30 to 60
Ferrazz: raises 120 to 180
apaixtos1: folds 
ukr_durrrr: folds 
ultgamb: folds 
fishin1981: folds 
jeroma123: folds 
olleggi: folds 
pokerlazik: folds 
pokerist2692: calls 120
*** FLOP *** [5d 6s Jc]
pokerist2692: checks 
Ferrazz: bets 199
pokerist2692: calls 199
*** TURN *** [5d 6s Jc] [8s]
pokerist2692: checks 
Ferrazz: bets 510
pokerist2692: folds 
Uncalled bet (510) returned to Ferrazz
Ferrazz collected 848 from pot
Ferrazz: doesn't show hand 
*** SUMMARY ***
Total pot 848 | Rake 0 
Board [5d 6s Jc 8s]
Seat 1: apaixtos1 folded before Flop (didn't bet)
Seat 2: ukr_durrrr folded before Flop (didn't bet)
Seat 3: ultgamb folded before Flop (didn't bet)
Seat 4: fishin1981 folded before Flop (didn't bet)
Seat 5: jeroma123 (button) folded before Flop (didn't bet)
Seat 6: olleggi (small blind) folded before Flop
Seat 7: pokerlazik (big blind) folded before Flop
Seat 8: pokerist2692 folded on the Turn
Seat 9: Ferrazz collected (848)



PokerStars Hand #157575202733: Tournament #1641817620, $7.50+$7.50+$1.50 USD Hold'em No Limit - Level I (15/30) - 2016/08/21 18:33:48 ET
Table '1641817620 57' 9-max Seat #4 is the button
Seat 1: pedroh2010 (10210 in chips) 
Seat 2: PANOYRGIAS73 (5000 in chips) 
Seat 3: ovekas (5120 in chips) 
Seat 4: ALWAYSBRAVES (4940 in chips) 
Seat 5: BaDBeaT_AK85 (4955 in chips) 
Seat 6: kachumban (4910 in chips) 
Seat 7: ZodiakGB (4985 in chips) 
Seat 8: MeortheMrs (4895 in chips) 
Seat 9: andreiuc (4985 in chips) 
pedroh2010: posts the ante 5
PANOYRGIAS73: posts the ante 5
ovekas: posts the ante 5
ALWAYSBRAVES: posts the ante 5
BaDBeaT_AK85: posts the ante 5
kachumban: posts the ante 5
ZodiakGB: posts the ante 5
MeortheMrs: posts the ante 5
andreiuc: posts the ante 5
BaDBeaT_AK85: posts small blind 15
kachumban: posts big blind 30
*** HOLE CARDS ***
ZodiakGB: folds 
MeortheMrs: calls 30
andreiuc: folds 
pedroh2010: calls 30
PANOYRGIAS73: raises 180 to 210
ovekas: folds 
ALWAYSBRAVES: folds 
BaDBeaT_AK85: folds 
kachumban: folds 
MeortheMrs: calls 180
pedroh2010: folds 
*** FLOP *** [7h 6s Qs]
MeortheMrs: bets 90
PANOYRGIAS73: raises 360 to 450
MeortheMrs: calls 360
*** TURN *** [7h 6s Qs] [2s]
MeortheMrs: checks 
PANOYRGIAS73: checks 
*** RIVER *** [7h 6s Qs 2s] [8h]
MeortheMrs: bets 720
PANOYRGIAS73: calls 720
*** SHOW DOWN ***
MeortheMrs: shows [Qd Ah] (a pair of Queens)
PANOYRGIAS73: shows [Kc Kh] (a pair of Kings)
PANOYRGIAS73 collected 2880 from pot
*** SUMMARY ***
Total pot 2880 | Rake 0 
Board [7h 6s Qs 2s 8h]
Seat 1: pedroh2010 folded before Flop
Seat 2: PANOYRGIAS73 showed [Kc Kh] and won (2880) with a pair of Kings
Seat 3: ovekas folded before Flop (didn't bet)
Seat 4: ALWAYSBRAVES (button) folded before Flop (didn't bet)
Seat 5: BaDBeaT_AK85 (small blind) folded before Flop
Seat 6: kachumban (big blind) folded before Flop
Seat 7: ZodiakGB folded before Flop (didn't bet)
Seat 8: MeortheMrs showed [Qd Ah] and lost with a pair of Queens
Seat 9: andreiuc folded before Flop (didn't bet)



PokerStars Hand #157575203393: Tournament #1641817620, $7.50+$7.50+$1.50 USD Hold'em No Limit - Level I (15/30) - 2016/08/21 18:33:49 ET
Table '1641817620 55' 9-max Seat #5 is the button
Seat 1: M Patoine (5000 in chips) 
Seat 2: HayArro (4890 in chips) 
Seat 3: MaxPips (4875 in chips) 
Seat 4: furia75205 (4935 in chips) 
Seat 5: hoolzky (4845 in chips) 
Seat 6: B.Paulino (4950 in chips) 
Seat 7: xLewie (5385 in chips) 
Seat 8: mendozoQ (10140 in chips) 
Seat 9: igara tigara (4980 in chips) 
M Patoine: posts the ante 5
HayArro: posts the ante 5
MaxPips: posts the ante 5
furia75205: posts the ante 5
hoolzky: posts the ante 5
B.Paulino: posts the ante 5
xLewie: posts the ante 5
mendozoQ: posts the ante 5
igara tigara: posts the ante 5
B.Paulino: posts small blind 15
xLewie: posts big blind 30
*** HOLE CARDS ***
mendozoQ: folds 
igara tigara: raises 60 to 90
M Patoine: calls 90
HayArro: folds 
MaxPips: folds 
furia75205: folds 
hoolzky: folds 
B.Paulino: folds 
xLewie: folds 
*** FLOP *** [Kh Qd 9d]
igara tigara: bets 148
M Patoine: folds 
Uncalled bet (148) returned to igara tigara
igara tigara collected 270 from pot
*** SUMMARY ***
Total pot 270 | Rake 0 
Board [Kh Qd 9d]
Seat 1: M Patoine folded on the Flop
Seat 2: HayArro folded before Flop (didn't bet)
Seat 3: MaxPips folded before Flop (didn't bet)
Seat 4: furia75205 folded before Flop (didn't bet)
Seat 5: hoolzky (button) folded before Flop (didn't bet)
Seat 6: B.Paulino (small blind) folded before Flop
Seat 7: xLewie (big blind) folded before Flop
Seat 8: mendozoQ folded before Flop (didn't bet)
Seat 9: igara tigara collected (270)



PokerStars Hand #157575203548: Tournament #1641817620, $7.50+$7.50+$1.50 USD Hold'em No Limit - Level I (15/30) - 2016/08/21 18:33:50 ET
Table '1641817620 13' 9-max Seat #4 is the button
Seat 1: Mindthis (3238 in chips) 
Seat 2: nicka501 (10272 in chips) 
Seat 3: POG_Q4 (7213 in chips) 
Seat 4: sutherland43 (4945 in chips) 
Seat 5: LarikkadoAA (4960 in chips) 
Seat 6: MicroStaker5 (4498 in chips) 
Seat 7: MrMalaLeche (4985 in chips) 
Seat 8: EdsonPecly (4904 in chips) 
Seat 9: wantuirpoker (4980 in chips) 
Mindthis: posts the ante 5
nicka501: posts the ante 5
POG_Q4: posts the ante 5
sutherland43: posts the ante 5
LarikkadoAA: posts the ante 5
MicroStaker5: posts the ante 5
MrMalaLeche: posts the ante 5
EdsonPecly: posts the ante 5
wantuirpoker: posts the ante 5
LarikkadoAA: posts small blind 15
MicroStaker5: posts big blind 30
*** HOLE CARDS ***
MrMalaLeche: folds 
EdsonPecly: raises 51 to 81
wantuirpoker: folds 
Mindthis: folds 
nicka501: folds 
POG_Q4: folds 
sutherland43: folds 
LarikkadoAA: folds 
MicroStaker5: folds 
Uncalled bet (51) returned to EdsonPecly
EdsonPecly collected 120 from pot
*** SUMMARY ***
Total pot 120 | Rake 0 
Seat 1: Mindthis folded before Flop (didn't bet)
Seat 2: nicka501 folded before Flop (didn't bet)
Seat 3: POG_Q4 folded before Flop (didn't bet)
Seat 4: sutherland43 (button) folded before Flop (didn't bet)
Seat 5: LarikkadoAA (small blind) folded before Flop
Seat 6: MicroStaker5 (big blind) folded before Flop
Seat 7: MrMalaLeche folded before Flop (didn't bet)
Seat 8: EdsonPecly collected (120)
Seat 9: wantuirpoker folded before Flop (didn't bet)



PokerStars Hand #157575203976: Tournament #1641817620, $7.50+$7.50+$1.50 USD Hold'em No Limit - Level I (15/30) - 2016/08/21 18:33:50 ET
Table '1641817620 40' 9-max Seat #5 is the button
Seat 1: Shiryu100 (4980 in chips) 
Seat 2: nico122527 (4935 in chips) 
Seat 3: ilico (4845 in chips) 
Seat 4: Mr_Giiba (5040 in chips) 
Seat 5: mario342 (5130 in chips) 
Seat 6: MON3Y$HOT (5250 in chips) 
Seat 7: hyratsch (4860 in chips) 
Seat 8: vaggelis1982 (4980 in chips) 
Seat 9: kafu123 (4980 in chips) is sitting out
Shiryu100: posts the ante 5
nico122527: posts the ante 5
ilico: posts the ante 5
Mr_Giiba: posts the ante 5
mario342: posts the ante 5
MON3Y$HOT: posts the ante 5
hyratsch: posts the ante 5
vaggelis1982: posts the ante 5
kafu123: posts the ante 5
MON3Y$HOT: posts small blind 15
hyratsch: posts big blind 30
*** HOLE CARDS ***
vaggelis1982: folds 
kafu123: folds 
Shiryu100: folds 
nico122527: folds 
ilico: raises 52 to 82
Mr_Giiba: folds 
mario342: folds 
MON3Y$HOT: folds 
hyratsch: calls 52
*** FLOP *** [Qd 4c 8s]
hyratsch: checks 
ilico: bets 116
hyratsch: calls 116
*** TURN *** [Qd 4c 8s] [7s]
hyratsch: checks 
ilico: bets 296
hyratsch: calls 296
*** RIVER *** [Qd 4c 8s 7s] [4h]
hyratsch: checks 
ilico: bets 681
hyratsch: folds 
Uncalled bet (681) returned to ilico
ilico collected 1048 from pot
ilico: doesn't show hand 
*** SUMMARY ***
Total pot 1048 | Rake 0 
Board [Qd 4c 8s 7s 4h]
Seat 1: Shiryu100 folded before Flop (didn't bet)
Seat 2: nico122527 folded before Flop (didn't bet)
Seat 3: ilico collected (1048)
Seat 4: Mr_Giiba folded before Flop (didn't bet)
Seat 5: mario342 (button) folded before Flop (didn't bet)
Seat 6: MON3Y$HOT (small blind) folded before Flop
Seat 7: hyratsch (big blind) folded on the River
Seat 8: vaggelis1982 folded before Flop (didn't bet)
Seat 9: kafu123 folded before Flop (didn't bet)



PokerStars Hand #157575205724: Tournament #1641817620, $7.50+$7.50+$1.50 USD Hold'em No Limit - Level I (15/30) - 2016/08/21 18:33:53 ET
Table '1641817620 23' 9-max Seat #5 is the button
Seat 1: Cepillo (4980 in chips) 
Seat 2: erfan86 (4965 in chips) 
Seat 3: derkimos (4860 in chips) 
Seat 4: Carlos11497 (4935 in chips) 
Seat 5: MickJagger86 (4935 in chips) 
Seat 6: wolll888 (5000 in chips) out of hand (moved from another table into small blind)
Seat 7: jradjo21 (4950 in chips) 
Seat 9: -MCASLAN7- (5185 in chips) 
Cepillo: posts the ante 5
erfan86: posts the ante 5
derkimos: posts the ante 5
Carlos11497: posts the ante 5
MickJagger86: posts the ante 5
jradjo21: posts the ante 5
-MCASLAN7-: posts the ante 5
jradjo21: posts small blind 15
-MCASLAN7-: posts big blind 30
*** HOLE CARDS ***
Cepillo: folds 
erfan86: folds 
derkimos: calls 30
Carlos11497: calls 30
MickJagger86: raises 170 to 200
jradjo21: folds 
-MCASLAN7-: folds 
derkimos: calls 170
Carlos11497: calls 170
*** FLOP *** [Qd 7s 6d]
derkimos: checks 
Carlos11497: checks 
MickJagger86: bets 476
derkimos: calls 476
Carlos11497: folds 
*** TURN *** [Qd 7s 6d] [9h]
derkimos: bets 1632
MickJagger86: raises 2622 to 4254 and is all-in
derkimos: calls 2547 and is all-in
Uncalled bet (75) returned to MickJagger86
*** RIVER *** [Qd 7s 6d 9h] [9c]
*** SHOW DOWN ***
derkimos: shows [7h 7d] (a full house, Sevens full of Nines)
MickJagger86: shows [6s 9s] (a full house, Nines full of Sixes)
MickJagger86 collected 9990 from pot
MickJagger86 wins $3.75 for eliminating derkimos and their own bounty increases by $3.75 to $11.25
derkimos finished the tournament in 999999987th place
*** SUMMARY ***
Total pot 9990 | Rake 0 
Board [Qd 7s 6d 9h 9c]
Seat 1: Cepillo folded before Flop (didn't bet)
Seat 2: erfan86 folded before Flop (didn't bet)
Seat 3: derkimos showed [7h 7d] and lost with a full house, Sevens full of Nines
Seat 4: Carlos11497 folded on the Flop
Seat 5: MickJagger86 (button) showed [6s 9s] and won (9990) with a full house, Nines full of Sixes
Seat 7: jradjo21 (small blind) folded before Flop
Seat 9: -MCASLAN7- (big blind) folded before Flop



PokerStars Hand #157575205841: Tournament #1641817620, $7.50+$7.50+$1.50 USD Hold'em No Limit - Level I (15/30) - 2016/08/21 18:33:53 ET
Table '1641817620 60' 9-max Seat #3 is the button
Seat 1: C0rpsbal (4990 in chips) 
Seat 2: LuckyRin (4975 in chips) 
Seat 3: Mattzy1 (6876 in chips) 
Seat 4: loco2202 (4900 in chips) 
Seat 6: sexyhands (4190 in chips) 
Seat 7: vodao1 (4370 in chips) 
Seat 8: TarDinaCash (4990 in chips) 
Seat 9: Eibsee08 (4990 in chips) 
C0rpsbal: posts the ante 5
LuckyRin: posts the ante 5
Mattzy1: posts the ante 5
loco2202: posts the ante 5
sexyhands: posts the ante 5
vodao1: posts the ante 5
TarDinaCash: posts the ante 5
Eibsee08: posts the ante 5
loco2202: posts small blind 15
sexyhands: posts big blind 30
*** HOLE CARDS ***
vodao1: raises 45 to 75
TarDinaCash: calls 75
Eibsee08: folds 
C0rpsbal: folds 
LuckyRin: folds 
Mattzy1: calls 75
loco2202: folds 
sexyhands: folds 
*** FLOP *** [5c Kh Td]
vodao1: checks 
TarDinaCash: checks 
Mattzy1: bets 155
vodao1: calls 155
TarDinaCash: folds 
*** TURN *** [5c Kh Td] [Kd]
vodao1: checks 
Mattzy1: checks 
*** RIVER *** [5c Kh Td Kd] [3c]
vodao1: bets 510
Mattzy1: calls 510
*** SHOW DOWN ***
vodao1: shows [Jd Qc] (a pair of Kings)
Mattzy1: shows [Qh 3h] (two pair, Kings and Threes)
Mattzy1 collected 1640 from pot
*** SUMMARY ***
Total pot 1640 | Rake 0 
Board [5c Kh Td Kd 3c]
Seat 1: C0rpsbal folded before Flop (didn't bet)
Seat 2: LuckyRin folded before Flop (didn't bet)
Seat 3: Mattzy1 (button) showed [Qh 3h] and won (1640) with two pair, Kings and Threes
Seat 4: loco2202 (small blind) folded before Flop
Seat 6: sexyhands (big blind) folded before Flop
Seat 7: vodao1 showed [Jd Qc] and lost with a pair of Kings
Seat 8: TarDinaCash folded on the Flop
Seat 9: Eibsee08 folded before Flop (didn't bet)



PokerStars Hand #157575206425: Tournament #1641817620, $7.50+$7.50+$1.50 USD Hold'em No Limit - Level I (15/30) - 2016/08/21 18:33:54 ET
Table '1641817620 46' 9-max Seat #4 is the button
Seat 1: Kotakera (4818 in chips) 
Seat 2: estebangocu (4970 in chips) 
Seat 3: butler992 (4880 in chips) 
Seat 4: ZuzanaM (4940 in chips) 
Seat 5: Koeike (4930 in chips) 
Seat 7: clavito691 (5401 in chips) 
Seat 8: Violetarose (5096 in chips) 
Seat 9: staknchips83 (4985 in chips) 
Kotakera: posts the ante 5
estebangocu: posts the ante 5
butler992: posts the ante 5
ZuzanaM: posts the ante 5
Koeike: posts the ante 5
clavito691: posts the ante 5
Violetarose: posts the ante 5
staknchips83: posts the ante 5
Koeike: posts small blind 15
clavito691: posts big blind 30
*** HOLE CARDS ***
Violetarose: folds 
staknchips83: raises 60 to 90
Kotakera: folds 
estebangocu: folds 
butler992: folds 
ZuzanaM: folds 
Koeike: calls 75
clavito691: calls 60
*** FLOP *** [4c 2h 7d]
Koeike: checks 
clavito691: checks 
staknchips83: checks 
*** TURN *** [4c 2h 7d] [9h]
Koeike: checks 
clavito691: bets 151
staknchips83: folds 
Koeike: folds 
Uncalled bet (151) returned to clavito691
clavito691 collected 310 from pot
*** SUMMARY ***
Total pot 310 | Rake 0 
Board [4c 2h 7d 9h]
Seat 1: Kotakera folded before Flop (didn't bet)
Seat 2: estebangocu folded before Flop (didn't bet)
Seat 3: butler992 folded before Flop (didn't bet)
Seat 4: ZuzanaM (button) folded before Flop (didn't bet)
Seat 5: Koeike (small blind) folded on the Turn
Seat 7: clavito691 (big blind) collected (310)
Seat 8: Violetarose folded before Flop (didn't bet)
Seat 9: staknchips83 folded on the Turn



PokerStars Hand #157575206527: Tournament #1641817620, $7.50+$7.50+$1.50 USD Hold'em No Limit - Level I (15/30) - 2016/08/21 18:33:54 ET
Table '1641817620 61' 9-max Seat #6 is the button
Seat 1: talga421 (4293 in chips) 
Seat 2: evgenia19591 (4890 in chips) 
Seat 3: ElliNelly (11327 in chips) 
Seat 4: Adso139 (4995 in chips) 
Seat 5: sasha.yush (4935 in chips) 
Seat 6: houtenboog (4845 in chips) 
Seat 7: setarcos1234 (4950 in chips) 
Seat 8: mcgcork (5000 in chips) 
talga421: posts the ante 5
evgenia19591: posts the ante 5
ElliNelly: posts the ante 5
Adso139: posts the ante 5
sasha.yush: posts the ante 5
houtenboog: posts the ante 5
setarcos1234: posts the ante 5
mcgcork: posts the ante 5
setarcos1234: posts small blind 15
mcgcork: posts big blind 30
*** HOLE CARDS ***
talga421: folds 
evgenia19591: folds 
ElliNelly: folds 
Adso139: folds 
sasha.yush: folds 
houtenboog: folds 
setarcos1234: folds 
Uncalled bet (15) returned to mcgcork
mcgcork collected 70 from pot
mcgcork: doesn't show hand 
*** SUMMARY ***
Total pot 70 | Rake 0 
Seat 1: talga421 folded before Flop (didn't bet)
Seat 2: evgenia19591 folded before Flop (didn't bet)
Seat 3: ElliNelly folded before Flop (didn't bet)
Seat 4: Adso139 folded before Flop (didn't bet)
Seat 5: sasha.yush folded before Flop (didn't bet)
Seat 6: houtenboog (button) folded before Flop (didn't bet)
Seat 7: setarcos1234 (small blind) folded before Flop
Seat 8: mcgcork (big blind) collected (70)



PokerStars Hand #157575206831: Tournament #1641817620, $7.50+$7.50+$1.50 USD Hold'em No Limit - Level I (15/30) - 2016/08/21 18:33:55 ET
Table '1641817620 53' 9-max Seat #5 is the button
Seat 1: star729 (5160 in chips) 
Seat 2: cebola77 (5940 in chips) 
Seat 3: Pekkosaurus (4935 in chips) 
Seat 4: -UNREGPRE- (4935 in chips) 
Seat 5: carlostrend (4140 in chips) 
Seat 6: The39player (4950 in chips) 
Seat 8: top@pokker (4980 in chips) 
Seat 9: cruiser5917 (4980 in chips) 
star729: posts the ante 5
cebola77: posts the ante 5
Pekkosaurus: posts the ante 5
-UNREGPRE-: posts the ante 5
carlostrend: posts the ante 5
The39player: posts the ante 5
top@pokker: posts the ante 5
cruiser5917: posts the ante 5
The39player: posts small blind 15
top@pokker: posts big blind 30
*** HOLE CARDS ***
cruiser5917: folds 
star729: raises 30 to 60
cebola77: folds 
Pekkosaurus: folds 
-UNREGPRE-: folds 
carlostrend: calls 60
The39player: folds 
top@pokker: folds 
*** FLOP *** [6d Js Qd]
star729: checks 
carlostrend: bets 60
star729: folds 
Uncalled bet (60) returned to carlostrend
carlostrend collected 205 from pot
carlostrend: doesn't show hand 
*** SUMMARY ***
Total pot 205 | Rake 0 
Board [6d Js Qd]
Seat 1: star729 folded on the Flop
Seat 2: cebola77 folded before Flop (didn't bet)
Seat 3: Pekkosaurus folded before Flop (didn't bet)
Seat 4: -UNREGPRE- folded before Flop (didn't bet)
Seat 5: carlostrend (button) collected (205)
Seat 6: The39player (small blind) folded before Flop
Seat 8: top@pokker (big blind) folded before Flop
Seat 9: cruiser5917 folded before Flop (didn't bet)



PokerStars Hand #157575207997: Tournament #1641817620, $7.50+$7.50+$1.50 USD Hold'em No Limit - Level I (15/30) - 2016/08/21 18:33:57 ET
Table '1641817620 22' 9-max Seat #6 is the button
Seat 2: hanshabraken (5000 in chips) 
Seat 3: CHININ118 (4930 in chips) 
Seat 4: Jaliplay (10105 in chips) 
Seat 5: hewx (5015 in chips) 
Seat 6: xxSTORMZYxx (4930 in chips) 
Seat 7: ogotop76 (4945 in chips) 
Seat 8: monterreymx (4975 in chips) 
Seat 9: cash4king (5125 in chips) 
hanshabraken: posts the ante 5
CHININ118: posts the ante 5
Jaliplay: posts the ante 5
hewx: posts the ante 5
xxSTORMZYxx: posts the ante 5
ogotop76: posts the ante 5
monterreymx: posts the ante 5
cash4king: posts the ante 5
ogotop76: posts small blind 15
monterreymx: posts big blind 30
*** HOLE CARDS ***
cash4king: raises 90 to 120
hanshabraken: folds 
CHININ118: calls 120
Jaliplay: folds 
hewx: calls 120
xxSTORMZYxx: calls 120
ogotop76: folds 
monterreymx: calls 90
*** FLOP *** [8c Qc 5c]
monterreymx: checks 
cash4king: checks 
CHININ118: bets 216
hewx: calls 216
xxSTORMZYxx: raises 4589 to 4805 and is all-in
monterreymx: folds 
cash4king: folds 
CHININ118: folds 
hewx: calls 4589
*** TURN *** [8c Qc 5c] [Kc]
*** RIVER *** [8c Qc 5c Kc] [9d]
*** SHOW DOWN ***
hewx: shows [Ac 6c] (a flush, Ace high)
xxSTORMZYxx: shows [5h 5d] (three of a kind, Fives)
hewx collected 10481 from pot
hewx wins $3.75 for eliminating xxSTORMZYxx and their own bounty increases by $3.75 to $11.25
xxSTORMZYxx finished the tournament in 999999990th place
*** SUMMARY ***
Total pot 10481 | Rake 0 
Board [8c Qc 5c Kc 9d]
Seat 2: hanshabraken folded before Flop (didn't bet)
Seat 3: CHININ118 folded on the Flop
Seat 4: Jaliplay folded before Flop (didn't bet)
Seat 5: hewx showed [Ac 6c] and won (10481) with a flush, Ace high
Seat 6: xxSTORMZYxx (button) showed [5h 5d] and lost with three of a kind, Fives
Seat 7: ogotop76 (small blind) folded before Flop
Seat 8: monterreymx (big blind) folded on the Flop
Seat 9: cash4king folded on the Flop



PokerStars Hand #157575208490: Tournament #1641817620, $7.50+$7.50+$1.50 USD Hold'em No Limit - Level I (15/30) - 2016/08/21 18:33:57 ET
Table '1641817620 59' 9-max Seat #5 is the button
Seat 1: pitoco2012 (5010 in chips) 
Seat 2: M_ORBIT_M (5170 in chips) 
Seat 3: alemaowe (4935 in chips) 
Seat 4: jan monster (4534 in chips) 
Seat 5: laiyitui (4875 in chips) 
Seat 6: ryo1980 (5000 in chips) out of hand (moved from another table into small blind)
Seat 7: 88Xin88 (5040 in chips) 
Seat 8: Enio Pinho (5537 in chips) 
Seat 9: Robsn087 (4914 in chips) 
pitoco2012: posts the ante 5
M_ORBIT_M: posts the ante 5
alemaowe: posts the ante 5
jan monster: posts the ante 5
laiyitui: posts the ante 5
88Xin88: posts the ante 5
Enio Pinho: posts the ante 5
Robsn087: posts the ante 5
88Xin88: posts small blind 15
Enio Pinho: posts big blind 30
*** HOLE CARDS ***
Robsn087: folds 
pitoco2012: folds 
M_ORBIT_M: folds 
alemaowe: raises 30 to 60
jan monster: folds 
laiyitui: folds 
88Xin88: folds 
Enio Pinho: folds 
Uncalled bet (30) returned to alemaowe
alemaowe collected 115 from pot
*** SUMMARY ***
Total pot 115 | Rake 0 
Seat 1: pitoco2012 folded before Flop (didn't bet)
Seat 2: M_ORBIT_M folded before Flop (didn't bet)
Seat 3: alemaowe collected (115)
Seat 4: jan monster folded before Flop (didn't bet)
Seat 5: laiyitui (button) folded before Flop (didn't bet)
Seat 7: 88Xin88 (small blind) folded before Flop
Seat 8: Enio Pinho (big blind) folded before Flop
Seat 9: Robsn087 folded before Flop (didn't bet)



PokerStars Hand #157575210551: Tournament #1641817620, $7.50+$7.50+$1.50 USD Hold'em No Limit - Level I (15/30) - 2016/08/21 18:34:01 ET
Table '1641817620 15' 9-max Seat #5 is the button
Seat 1: WRussia (4805 in chips) 
Seat 2: miche1301 (5605 in chips) 
Seat 3: tsolias87 (4940 in chips) 
Seat 4: daveholden4 (5000 in chips) 
Seat 5: mdf92 (4595 in chips) 
Seat 6: aramio29 (5000 in chips) out of hand (moved from another table into small blind)
Seat 7: Yokiro (4685 in chips) 
Seat 8: Rob.nl (4715 in chips) 
Seat 9: mfalmeidacs (5435 in chips) 
WRussia: posts the ante 5
miche1301: posts the ante 5
tsolias87: posts the ante 5
daveholden4: posts the ante 5
mdf92: posts the ante 5
Yokiro: posts the ante 5
Rob.nl: posts the ante 5
mfalmeidacs: posts the ante 5
Yokiro: posts small blind 15
Rob.nl: posts big blind 30
*** HOLE CARDS ***
mfalmeidacs: folds 
WRussia: folds 
miche1301: folds 
tsolias87: raises 45 to 75
daveholden4: folds 
mdf92: folds 
Yokiro: folds 
Rob.nl: folds 
Uncalled bet (45) returned to tsolias87
tsolias87 collected 115 from pot
*** SUMMARY ***
Total pot 115 | Rake 0 
Seat 1: WRussia folded before Flop (didn't bet)
Seat 2: miche1301 folded before Flop (didn't bet)
Seat 3: tsolias87 collected (115)
Seat 4: daveholden4 folded before Flop (didn't bet)
Seat 5: mdf92 (button) folded before Flop (didn't bet)
Seat 7: Yokiro (small blind) folded before Flop
Seat 8: Rob.nl (big blind) folded before Flop
Seat 9: mfalmeidacs folded before Flop (didn't bet)



PokerStars Hand #157575210643: Tournament #1641817620, $7.50+$7.50+$1.50 USD Hold'em No Limit - Level I (15/30) - 2016/08/21 18:34:01 ET
Table '1641817620 10' 9-max Seat #6 is the button
Seat 1: VANDECO174 (4975 in chips) 
Seat 2: Be Anger (4720 in chips) 
Seat 3: mickyryan (5020 in chips) 
Seat 4: silveira1879 (5350 in chips) 
Seat 5: AndyLou27 (5050 in chips) 
Seat 6: I M GOIN OFF (4930 in chips) 
Seat 7: Nuazo (4915 in chips) 
Seat 8: damibor (5125 in chips) 
Seat 9: Stokesy05 (4915 in chips) 
VANDECO174: posts the ante 5
Be Anger: posts the ante 5
mickyryan: posts the ante 5
silveira1879: posts the ante 5
AndyLou27: posts the ante 5
I M GOIN OFF: posts the ante 5
Nuazo: posts the ante 5
damibor: posts the ante 5
Stokesy05: posts the ante 5
Nuazo: posts small blind 15
damibor: posts big blind 30
*** HOLE CARDS ***
Stokesy05: folds 
VANDECO174: folds 
Be Anger: folds 
mickyryan: raises 60 to 90
silveira1879: calls 90
AndyLou27: raises 360 to 450
I M GOIN OFF: folds 
Nuazo: folds 
damibor: folds 
mickyryan: folds 
silveira1879: folds 
Uncalled bet (360) returned to AndyLou27
AndyLou27 collected 360 from pot
AndyLou27: doesn't show hand 
*** SUMMARY ***
Total pot 360 | Rake 0 
Seat 1: VANDECO174 folded before Flop (didn't bet)
Seat 2: Be Anger folded before Flop (didn't bet)
Seat 3: mickyryan folded before Flop
Seat 4: silveira1879 folded before Flop
Seat 5: AndyLou27 collected (360)
Seat 6: I M GOIN OFF (button) folded before Flop (didn't bet)
Seat 7: Nuazo (small blind) folded before Flop
Seat 8: damibor (big blind) folded before Flop
Seat 9: Stokesy05 folded before Flop (didn't bet)



PokerStars Hand #157575210960: Tournament #1641817620, $7.50+$7.50+$1.50 USD Hold'em No Limit - Level I (15/30) - 2016/08/21 18:34:01 ET
Table '1641817620 14' 9-max Seat #3 is the button
Seat 1: japazzz1001 (4990 in chips) 
Seat 2: zigolo77 (5275 in chips) 
Seat 3: $Koha$88 (4885 in chips) 
Seat 4: Ed_brisal (4915 in chips) 
Seat 5: kashlaw (4995 in chips) 
Seat 6: sweetlips6 (4562 in chips) 
Seat 7: zerowiec (5398 in chips) 
Seat 8: tim_pro_405! (4990 in chips) 
Seat 9: bacibaci67 (4990 in chips) 
japazzz1001: posts the ante 5
zigolo77: posts the ante 5
$Koha$88: posts the ante 5
Ed_brisal: posts the ante 5
kashlaw: posts the ante 5
sweetlips6: posts the ante 5
zerowiec: posts the ante 5
tim_pro_405!: posts the ante 5
bacibaci67: posts the ante 5
Ed_brisal: posts small blind 15
kashlaw: posts big blind 30
*** HOLE CARDS ***
sweetlips6: folds 
zerowiec: folds 
tim_pro_405!: folds 
bacibaci67: folds 
japazzz1001: folds 
zigolo77: folds 
$Koha$88: folds 
Ed_brisal: raises 30 to 60
kashlaw: calls 30
*** FLOP *** [Kc Jd Th]
Ed_brisal: bets 120
kashlaw: folds 
Uncalled bet (120) returned to Ed_brisal
Ed_brisal collected 165 from pot
Ed_brisal: doesn't show hand 
*** SUMMARY ***
Total pot 165 | Rake 0 
Board [Kc Jd Th]
Seat 1: japazzz1001 folded before Flop (didn't bet)
Seat 2: zigolo77 folded before Flop (didn't bet)
Seat 3: $Koha$88 (button) folded before Flop (didn't bet)
Seat 4: Ed_brisal (small blind) collected (165)
Seat 5: kashlaw (big blind) folded on the Flop
Seat 6: sweetlips6 folded before Flop (didn't bet)
Seat 7: zerowiec folded before Flop (didn't bet)
Seat 8: tim_pro_405! folded before Flop (didn't bet)
Seat 9: bacibaci67 folded before Flop (didn't bet)



PokerStars Hand #157575211875: Tournament #1641817620, $7.50+$7.50+$1.50 USD Hold'em No Limit - Level I (15/30) - 2016/08/21 18:34:03 ET
Table '1641817620 43' 9-max Seat #5 is the button
Seat 1: VeniG95 (10249 in chips) 
Seat 2: alanyamil (70 in chips) 
Seat 3: Raulop (4770 in chips) 
Seat 4: SoulSlaye166 (5190 in chips) 
Seat 5: DimaRu777 (4920 in chips) 
Seat 6: Taima (4756 in chips) 
Seat 7: Caville88 (4980 in chips) 
Seat 8: BetoFolhaCMC (4980 in chips) 
Seat 9: cajool (5085 in chips) 
VeniG95: posts the ante 5
alanyamil: posts the ante 5
Raulop: posts the ante 5
SoulSlaye166: posts the ante 5
DimaRu777: posts the ante 5
Taima: posts the ante 5
Caville88: posts the ante 5
BetoFolhaCMC: posts the ante 5
cajool: posts the ante 5
Taima: posts small blind 15
Caville88: posts big blind 30
*** HOLE CARDS ***
BetoFolhaCMC: folds 
cajool: folds 
VeniG95: folds 
alanyamil: folds 
Raulop: folds 
SoulSlaye166: raises 54 to 84
DimaRu777: raises 111 to 195
Taima: folds 
Caville88: folds 
SoulSlaye166: calls 111
*** FLOP *** [8h 9c 2d]
SoulSlaye166: checks 
DimaRu777: bets 255
SoulSlaye166: folds 
Uncalled bet (255) returned to DimaRu777
DimaRu777 collected 480 from pot
*** SUMMARY ***
Total pot 480 | Rake 0 
Board [8h 9c 2d]
Seat 1: VeniG95 folded before Flop (didn't bet)
Seat 2: alanyamil folded before Flop (didn't bet)
Seat 3: Raulop folded before Flop (didn't bet)
Seat 4: SoulSlaye166 folded on the Flop
Seat 5: DimaRu777 (button) collected (480)
Seat 6: Taima (small blind) folded before Flop
Seat 7: Caville88 (big blind) folded before Flop
Seat 8: BetoFolhaCMC folded before Flop (didn't bet)
Seat 9: cajool folded before Flop (didn't bet)



PokerStars Hand #157575212151: Tournament #1641817620, $7.50+$7.50+$1.50 USD Hold'em No Limit - Level I (15/30) - 2016/08/21 18:34:03 ET
Table '1641817620 1' 9-max Seat #8 is the button
Seat 1: mattyonuts (5098 in chips) 
Seat 2: topaipi (5154 in chips) 
Seat 3: MAMOHT_T (4930 in chips) 
Seat 4: ManMaPayé (4990 in chips) 
Seat 5: LADIEFJ (5995 in chips) 
Seat 6: TheGuerreiro (4708 in chips) 
Seat 7: spiderhami (5000 in chips) 
Seat 8: K. Ichinose (4964 in chips) 
Seat 9: jonespkr (5000 in chips) out of hand (moved from another table into small blind)
mattyonuts: posts the ante 5
topaipi: posts the ante 5
MAMOHT_T: posts the ante 5
ManMaPayé: posts the ante 5
LADIEFJ: posts the ante 5
TheGuerreiro: posts the ante 5
spiderhami: posts the ante 5
K. Ichinose: posts the ante 5
mattyonuts: posts small blind 15
topaipi: posts big blind 30
*** HOLE CARDS ***
MAMOHT_T: folds 
ManMaPayé: folds 
LADIEFJ: raises 30 to 60
TheGuerreiro: folds 
spiderhami: folds 
K. Ichinose: folds 
mattyonuts: calls 45
topaipi: raises 220 to 280
LADIEFJ: calls 220
mattyonuts: calls 220
*** FLOP *** [7s 5d Ks]
mattyonuts: checks 
topaipi: checks 
LADIEFJ: checks 
*** TURN *** [7s 5d Ks] [Th]
mattyonuts: checks 
topaipi: bets 484
LADIEFJ: calls 484
mattyonuts: folds 
*** RIVER *** [7s 5d Ks Th] [Jh]
topaipi: checks 
LADIEFJ: checks 
*** SHOW DOWN ***
topaipi: shows [Ts Td] (three of a kind, Tens)
LADIEFJ: mucks hand 
topaipi collected 1848 from pot
*** SUMMARY ***
Total pot 1848 | Rake 0 
Board [7s 5d Ks Th Jh]
Seat 1: mattyonuts (small blind) folded on the Turn
Seat 2: topaipi (big blind) showed [Ts Td] and won (1848) with three of a kind, Tens
Seat 3: MAMOHT_T folded before Flop (didn't bet)
Seat 4: ManMaPayé folded before Flop (didn't bet)
Seat 5: LADIEFJ mucked
Seat 6: TheGuerreiro folded before Flop (didn't bet)
Seat 7: spiderhami folded before Flop (didn't bet)
Seat 8: K. Ichinose (button) folded before Flop (didn't bet)



PokerStars Hand #157575212887: Tournament #1641817620, $7.50+$7.50+$1.50 USD Hold'em No Limit - Level I (15/30) - 2016/08/21 18:34:04 ET
Table '1641817620 25' 9-max Seat #8 is the button
Seat 1: MoW3R (4970 in chips) 
Seat 2: pirus157 (5550 in chips) 
Seat 3: MaxBracht (4805 in chips) 
Seat 4: Rex Nelson (5010 in chips) 
Seat 5: ArKip (4925 in chips) 
Seat 6: REALACID (4995 in chips) 
Seat 7: AAnaKKonda (4925 in chips) 
Seat 8: Mad Dionysus (5015 in chips) 
Seat 9: IwillCall3 (4820 in chips) 
MoW3R: posts the ante 5
pirus157: posts the ante 5
MaxBracht: posts the ante 5
Rex Nelson: posts the ante 5
ArKip: posts the ante 5
REALACID: posts the ante 5
AAnaKKonda: posts the ante 5
Mad Dionysus: posts the ante 5
IwillCall3: posts the ante 5
IwillCall3: posts small blind 15
MoW3R: posts big blind 30
*** HOLE CARDS ***
pirus157: folds 
MaxBracht: folds 
Rex Nelson: raises 60 to 90
ArKip: folds 
REALACID: folds 
AAnaKKonda: raises 150 to 240
Mad Dionysus: folds 
IwillCall3: folds 
MoW3R: folds 
Rex Nelson: calls 150
*** FLOP *** [2c 7c Kc]
Rex Nelson: checks 
AAnaKKonda: bets 256
Rex Nelson: folds 
Uncalled bet (256) returned to AAnaKKonda
AAnaKKonda collected 570 from pot
*** SUMMARY ***
Total pot 570 | Rake 0 
Board [2c 7c Kc]
Seat 1: MoW3R (big blind) folded before Flop
Seat 2: pirus157 folded before Flop (didn't bet)
Seat 3: MaxBracht folded before Flop (didn't bet)
Seat 4: Rex Nelson folded on the Flop
Seat 5: ArKip folded before Flop (didn't bet)
Seat 6: REALACID folded before Flop (didn't bet)
Seat 7: AAnaKKonda collected (570)
Seat 8: Mad Dionysus (button) folded before Flop (didn't bet)
Seat 9: IwillCall3 (small blind) folded before Flop



PokerStars Hand #157575214397: Tournament #1641817620, $7.50+$7.50+$1.50 USD Hold'em No Limit - Level I (15/30) - 2016/08/21 18:34:06 ET
Table '1641817620 36' 9-max Seat #5 is the button
Seat 1: craiger1976 (4985 in chips) 
Seat 2: Winston4ever (4860 in chips) 
Seat 3: sarxa (4940 in chips) 
Seat 4: rakeshguru (5000 in chips) 
Seat 5: blufface88 (4130 in chips) 
Seat 6: xanja (4955 in chips) 
Seat 7: jadrankokec (4985 in chips) 
Seat 8: ruben marley (4985 in chips) 
Seat 9: wowbizz2 (6165 in chips) 
craiger1976: posts the ante 5
Winston4ever: posts the ante 5
sarxa: posts the ante 5
rakeshguru: posts the ante 5
blufface88: posts the ante 5
xanja: posts the ante 5
jadrankokec: posts the ante 5
ruben marley: posts the ante 5
wowbizz2: posts the ante 5
xanja: posts small blind 15
jadrankokec: posts big blind 30
*** HOLE CARDS ***
ruben marley: folds 
wowbizz2: folds 
craiger1976: folds 
Winston4ever: calls 30
sarxa: folds 
rakeshguru: raises 30 to 60
blufface88: folds 
xanja: folds 
jadrankokec: folds 
Winston4ever: calls 30
*** FLOP *** [Jc Ad Jd]
Winston4ever: checks 
rakeshguru: bets 210
Winston4ever: folds 
Uncalled bet (210) returned to rakeshguru
rakeshguru collected 210 from pot
rakeshguru: doesn't show hand 
*** SUMMARY ***
Total pot 210 | Rake 0 
Board [Jc Ad Jd]
Seat 1: craiger1976 folded before Flop (didn't bet)
Seat 2: Winston4ever folded on the Flop
Seat 3: sarxa folded before Flop (didn't bet)
Seat 4: rakeshguru collected (210)
Seat 5: blufface88 (button) folded before Flop (didn't bet)
Seat 6: xanja (small blind) folded before Flop
Seat 7: jadrankokec (big blind) folded before Flop
Seat 8: ruben marley folded before Flop (didn't bet)
Seat 9: wowbizz2 folded before Flop (didn't bet)



PokerStars Hand #157575215717: Tournament #1641817620, $7.50+$7.50+$1.50 USD Hold'em No Limit - Level I (15/30) - 2016/08/21 18:34:09 ET
Table '1641817620 44' 9-max Seat #8 is the button
Seat 1: BurrGrylls (4970 in chips) 
Seat 2: moisesgosu (4546 in chips) 
Seat 3: kduwork (5142 in chips) 
Seat 4: starkstud (5105 in chips) 
Seat 5: rbcowboy27 (4990 in chips) 
Seat 6: lesley hu (4925 in chips) is sitting out
Seat 7: ongggg (4898 in chips) 
Seat 8: heynow21 (5174 in chips) 
Seat 9: Pro_Tunis (5365 in chips) 
BurrGrylls: posts the ante 5
moisesgosu: posts the ante 5
kduwork: posts the ante 5
starkstud: posts the ante 5
rbcowboy27: posts the ante 5
lesley hu: posts the ante 5
ongggg: posts the ante 5
heynow21: posts the ante 5
Pro_Tunis: posts the ante 5
Pro_Tunis: posts small blind 15
BurrGrylls: posts big blind 30
*** HOLE CARDS ***
moisesgosu: folds 
kduwork: folds 
starkstud: folds 
rbcowboy27: folds 
lesley hu: folds 
ongggg: folds 
heynow21: raises 60 to 90
Pro_Tunis: calls 75
BurrGrylls: folds 
*** FLOP *** [As 4c 8c]
Pro_Tunis: checks 
heynow21: bets 145
Pro_Tunis: raises 5125 to 5270 and is all-in
heynow21: folds 
Uncalled bet (5125) returned to Pro_Tunis
Pro_Tunis collected 545 from pot
Pro_Tunis: doesn't show hand 
*** SUMMARY ***
Total pot 545 | Rake 0 
Board [As 4c 8c]
Seat 1: BurrGrylls (big blind) folded before Flop
Seat 2: moisesgosu folded before Flop (didn't bet)
Seat 3: kduwork folded before Flop (didn't bet)
Seat 4: starkstud folded before Flop (didn't bet)
Seat 5: rbcowboy27 folded before Flop (didn't bet)
Seat 6: lesley hu folded before Flop (didn't bet)
Seat 7: ongggg folded before Flop (didn't bet)
Seat 8: heynow21 (button) folded on the Flop
Seat 9: Pro_Tunis (small blind) collected (545)



PokerStars Hand #157575216868: Tournament #1641817620, $7.50+$7.50+$1.50 USD Hold'em No Limit - Level I (15/30) - 2016/08/21 18:34:10 ET
Table '1641817620 24' 9-max Seat #5 is the button
Seat 1: heyyy presto (5565 in chips) 
Seat 2: BOW300 (4890 in chips) 
Seat 3: muskto (4685 in chips) 
Seat 4: jt3x87 (4860 in chips) 
Seat 5: PhaniaX (4714 in chips) 
Seat 6: pisti801 (5351 in chips) 
Seat 8: trabey (4840 in chips) 
Seat 9: Quickcard (4950 in chips) 
heyyy presto: posts the ante 5
BOW300: posts the ante 5
muskto: posts the ante 5
jt3x87: posts the ante 5
PhaniaX: posts the ante 5
pisti801: posts the ante 5
trabey: posts the ante 5
Quickcard: posts the ante 5
pisti801: posts small blind 15
trabey: posts big blind 30
*** HOLE CARDS ***
Quickcard: folds 
heyyy presto: folds 
BOW300: folds 
muskto: raises 115 to 145
jt3x87: folds 
PhaniaX: folds 
pisti801: folds 
trabey: folds 
Uncalled bet (115) returned to muskto
muskto collected 115 from pot
muskto: doesn't show hand 
*** SUMMARY ***
Total pot 115 | Rake 0 
Seat 1: heyyy presto folded before Flop (didn't bet)
Seat 2: BOW300 folded before Flop (didn't bet)
Seat 3: muskto collected (115)
Seat 4: jt3x87 folded before Flop (didn't bet)
Seat 5: PhaniaX (button) folded before Flop (didn't bet)
Seat 6: pisti801 (small blind) folded before Flop
Seat 8: trabey (big blind) folded before Flop
Seat 9: Quickcard folded before Flop (didn't bet)



PokerStars Hand #157575218860: Tournament #1641817620, $7.50+$7.50+$1.50 USD Hold'em No Limit - Level I (15/30) - 2016/08/21 18:34:13 ET
Table '1641817620 16' 9-max Seat #8 is the button
Seat 2: Sergei0384 (5081 in chips) 
Seat 3: paschalisbg (4925 in chips) 
Seat 4: Maisiewin (4829 in chips) 
Seat 5: alemaozl (4925 in chips) 
Seat 6: Luis Reye837 (4995 in chips) 
Seat 7: burton14 (5100 in chips) 
Seat 8: Miky_Man993 (4835 in chips) 
Seat 9: ziboin (5150 in chips) 
Sergei0384: posts the ante 5
paschalisbg: posts the ante 5
Maisiewin: posts the ante 5
alemaozl: posts the ante 5
Luis Reye837: posts the ante 5
burton14: posts the ante 5
Miky_Man993: posts the ante 5
ziboin: posts the ante 5
ziboin: posts small blind 15
Sergei0384: posts big blind 30
*** HOLE CARDS ***
paschalisbg: folds 
Maisiewin: folds 
alemaozl: folds 
Luis Reye837: folds 
burton14: raises 60 to 90
Miky_Man993: folds 
ziboin: folds 
Sergei0384: folds 
Uncalled bet (60) returned to burton14
burton14 collected 115 from pot
burton14: doesn't show hand 
*** SUMMARY ***
Total pot 115 | Rake 0 
Seat 2: Sergei0384 (big blind) folded before Flop
Seat 3: paschalisbg folded before Flop (didn't bet)
Seat 4: Maisiewin folded before Flop (didn't bet)
Seat 5: alemaozl folded before Flop (didn't bet)
Seat 6: Luis Reye837 folded before Flop (didn't bet)
Seat 7: burton14 collected (115)
Seat 8: Miky_Man993 (button) folded before Flop (didn't bet)
Seat 9: ziboin (small blind) folded before Flop



PokerStars Hand #157575219121: Tournament #1641817620, $7.50+$7.50+$1.50 USD Hold'em No Limit - Level I (15/30) - 2016/08/21 18:34:14 ET
Table '1641817620 48' 9-max Seat #5 is the button
Seat 1: soft8981 (4926 in chips) 
Seat 2: getatore (5130 in chips) 
Seat 3: Serg2407 (4845 in chips) 
Seat 4: Zareta (4875 in chips) 
Seat 5: NSStefan (4935 in chips) 
Seat 6: ATE13 (4920 in chips) 
Seat 8: howtown (4686 in chips) 
Seat 9: qcouest (5808 in chips) 
soft8981: posts the ante 5
getatore: posts the ante 5
Serg2407: posts the ante 5
Zareta: posts the ante 5
NSStefan: posts the ante 5
ATE13: posts the ante 5
howtown: posts the ante 5
qcouest: posts the ante 5
ATE13: posts small blind 15
howtown: posts big blind 30
*** HOLE CARDS ***
qcouest: folds 
soft8981: calls 30
getatore: folds 
Serg2407: folds 
Zareta: folds 
NSStefan: folds 
ATE13: raises 150 to 180
howtown: raises 330 to 510
soft8981: folds 
ATE13: calls 330
*** FLOP *** [Tc Ah 4s]
ATE13: checks 
howtown: checks 
*** TURN *** [Tc Ah 4s] [2h]
ATE13: bets 540
howtown: calls 540
*** RIVER *** [Tc Ah 4s 2h] [Ad]
ATE13: bets 1410
howtown: calls 1410
*** SHOW DOWN ***
ATE13: shows [Qs As] (three of a kind, Aces)
howtown: mucks hand 
ATE13 collected 4990 from pot
*** SUMMARY ***
Total pot 4990 | Rake 0 
Board [Tc Ah 4s 2h Ad]
Seat 1: soft8981 folded before Flop
Seat 2: getatore folded before Flop (didn't bet)
Seat 3: Serg2407 folded before Flop (didn't bet)
Seat 4: Zareta folded before Flop (didn't bet)
Seat 5: NSStefan (button) folded before Flop (didn't bet)
Seat 6: ATE13 (small blind) showed [Qs As] and won (4990) with three of a kind, Aces
Seat 8: howtown (big blind) mucked
Seat 9: qcouest folded before Flop (didn't bet)



PokerStars Hand #157575219152: Tournament #1641817620, $7.50+$7.50+$1.50 USD Hold'em No Limit - Level I (15/30) - 2016/08/21 18:34:14 ET
Table '1641817620 27' 9-max Seat #5 is the button
Seat 1: TheKaisa87 (4770 in chips) 
Seat 2: Stejam (5000 in chips) 
Seat 3: SweetieSpy (6059 in chips) 
Seat 4: Mr_Buckworth (5160 in chips) 
Seat 5: ladymadon107 (4290 in chips) 
Seat 6: 6aDyHtry (4420 in chips) 
Seat 8: MasteDonBull (4995 in chips) 
Seat 9: kyzyldurrr (5366 in chips) 
TheKaisa87: posts the ante 5
Stejam: posts the ante 5
SweetieSpy: posts the ante 5
Mr_Buckworth: posts the ante 5
ladymadon107: posts the ante 5
6aDyHtry: posts the ante 5
MasteDonBull: posts the ante 5
kyzyldurrr: posts the ante 5
6aDyHtry: posts small blind 15
MasteDonBull: posts big blind 30
*** HOLE CARDS ***
kyzyldurrr: folds 
TheKaisa87: folds 
Stejam: folds 
SweetieSpy: folds 
Mr_Buckworth: raises 30 to 60
ladymadon107: calls 60
6aDyHtry: calls 45
MasteDonBull: calls 30
*** FLOP *** [8c Ah Qh]
6aDyHtry: checks 
MasteDonBull: checks 
Mr_Buckworth: bets 150
ladymadon107: calls 150
6aDyHtry: folds 
MasteDonBull: folds 
*** TURN *** [8c Ah Qh] [8s]
Mr_Buckworth: checks 
ladymadon107: bets 90
Mr_Buckworth: calls 90
*** RIVER *** [8c Ah Qh 8s] [Ac]
Mr_Buckworth: checks 
ladymadon107: checks 
*** SHOW DOWN ***
Mr_Buckworth: shows [Td Kc] (two pair, Aces and Eights)
ladymadon107: shows [7h Kh] (two pair, Aces and Eights)
Mr_Buckworth collected 380 from pot
ladymadon107 collected 380 from pot
*** SUMMARY ***
Total pot 760 | Rake 0 
Board [8c Ah Qh 8s Ac]
Seat 1: TheKaisa87 folded before Flop (didn't bet)
Seat 2: Stejam folded before Flop (didn't bet)
Seat 3: SweetieSpy folded before Flop (didn't bet)
Seat 4: Mr_Buckworth showed [Td Kc] and won (380) with two pair, Aces and Eights
Seat 5: ladymadon107 (button) showed [7h Kh] and won (380) with two pair, Aces and Eights
Seat 6: 6aDyHtry (small blind) folded on the Flop
Seat 8: MasteDonBull (big blind) folded on the Flop
Seat 9: kyzyldurrr folded before Flop (didn't bet)



PokerStars Hand #157575219596: Tournament #1641817620, $7.50+$7.50+$1.50 USD Hold'em No Limit - Level I (15/30) - 2016/08/21 18:34:15 ET
Table '1641817620 35' 9-max Seat #5 is the button
Seat 2: Diegodel79 (4965 in chips) 
Seat 3: brunoeffect (4845 in chips) 
Seat 4: PPOrphan (5080 in chips) 
Seat 5: WizardOffAz (4945 in chips) 
Seat 6: brett88987 (4920 in chips) 
Seat 7: IcaLm (4980 in chips) 
Seat 8: ximenesb (4980 in chips) 
Seat 9: Cosacoman (5215 in chips) 
Diegodel79: posts the ante 5
brunoeffect: posts the ante 5
PPOrphan: posts the ante 5
WizardOffAz: posts the ante 5
brett88987: posts the ante 5
IcaLm: posts the ante 5
ximenesb: posts the ante 5
Cosacoman: posts the ante 5
brett88987: posts small blind 15
IcaLm: posts big blind 30
*** HOLE CARDS ***
ximenesb: folds 
Cosacoman: folds 
Diegodel79: folds 
brunoeffect: raises 60 to 90
PPOrphan: folds 
WizardOffAz: calls 90
brett88987: folds 
IcaLm: calls 60
*** FLOP *** [6c 4s 8h]
IcaLm: checks 
brunoeffect: checks 
WizardOffAz: bets 150
IcaLm: calls 150
brunoeffect: folds 
*** TURN *** [6c 4s 8h] [Jd]
IcaLm: checks 
WizardOffAz: checks 
*** RIVER *** [6c 4s 8h Jd] [4d]
IcaLm: checks 
WizardOffAz: checks 
*** SHOW DOWN ***
IcaLm: shows [7s Td] (a pair of Fours)
WizardOffAz: shows [Ah 9h] (a pair of Fours - Ace kicker)
WizardOffAz collected 625 from pot
*** SUMMARY ***
Total pot 625 | Rake 0 
Board [6c 4s 8h Jd 4d]
Seat 2: Diegodel79 folded before Flop (didn't bet)
Seat 3: brunoeffect folded on the Flop
Seat 4: PPOrphan folded before Flop (didn't bet)
Seat 5: WizardOffAz (button) showed [Ah 9h] and won (625) with a pair of Fours
Seat 6: brett88987 (small blind) folded before Flop
Seat 7: IcaLm (big blind) showed [7s Td] and lost with a pair of Fours
Seat 8: ximenesb folded before Flop (didn't bet)
Seat 9: Cosacoman folded before Flop (didn't bet)



PokerStars Hand #157575221535: Tournament #1641817620, $7.50+$7.50+$1.50 USD Hold'em No Limit - Level I (15/30) - 2016/08/21 18:34:18 ET
Table '1641817620 39' 9-max Seat #6 is the button
Seat 1: BuyMeBMW (4980 in chips) 
Seat 2: ahaknh (4508 in chips) 
Seat 3: Crim44 (5452 in chips) 
Seat 4: Neo_gracz (4935 in chips) 
Seat 5: rinxa30 (5000 in chips) 
Seat 6: TxsFrUrMoney (5552 in chips) 
Seat 7: j.williams94 (5130 in chips) 
Seat 8: 88K@la88 (4488 in chips) 
Seat 9: Foggy56 (4830 in chips) 
BuyMeBMW: posts the ante 5
ahaknh: posts the ante 5
Crim44: posts the ante 5
Neo_gracz: posts the ante 5
rinxa30: posts the ante 5
TxsFrUrMoney: posts the ante 5
j.williams94: posts the ante 5
88K@la88: posts the ante 5
Foggy56: posts the ante 5
j.williams94: posts small blind 15
88K@la88: posts big blind 30
*** HOLE CARDS ***
Foggy56: folds 
BuyMeBMW: raises 45 to 75
ahaknh: folds 
Crim44: folds 
Neo_gracz: folds 
rinxa30: folds 
TxsFrUrMoney: folds 
j.williams94: folds 
88K@la88: calls 45
*** FLOP *** [3c 3d Ac]
88K@la88: checks 
BuyMeBMW: bets 92
88K@la88: folds 
Uncalled bet (92) returned to BuyMeBMW
BuyMeBMW collected 210 from pot
BuyMeBMW: doesn't show hand 
*** SUMMARY ***
Total pot 210 | Rake 0 
Board [3c 3d Ac]
Seat 1: BuyMeBMW collected (210)
Seat 2: ahaknh folded before Flop (didn't bet)
Seat 3: Crim44 folded before Flop (didn't bet)
Seat 4: Neo_gracz folded before Flop (didn't bet)
Seat 5: rinxa30 folded before Flop (didn't bet)
Seat 6: TxsFrUrMoney (button) folded before Flop (didn't bet)
Seat 7: j.williams94 (small blind) folded before Flop
Seat 8: 88K@la88 (big blind) folded on the Flop
Seat 9: Foggy56 folded before Flop (didn't bet)



PokerStars Hand #157575222374: Tournament #1641817620, $7.50+$7.50+$1.50 USD Hold'em No Limit - Level I (15/30) - 2016/08/21 18:34:19 ET
Table '1641817620 61' 9-max Seat #7 is the button
Seat 1: talga421 (4288 in chips) 
Seat 2: evgenia19591 (4885 in chips) 
Seat 3: ElliNelly (11322 in chips) 
Seat 4: Adso139 (4990 in chips) 
Seat 5: sasha.yush (4930 in chips) 
Seat 6: houtenboog (4840 in chips) 
Seat 7: setarcos1234 (4930 in chips) 
Seat 8: mcgcork (5050 in chips) 
Seat 9: LocoSanDiego (5000 in chips) 
talga421: posts the ante 5
evgenia19591: posts the ante 5
ElliNelly: posts the ante 5
Adso139: posts the ante 5
sasha.yush: posts the ante 5
houtenboog: posts the ante 5
setarcos1234: posts the ante 5
mcgcork: posts the ante 5
LocoSanDiego: posts the ante 5
mcgcork: posts small blind 15
LocoSanDiego: posts big blind 30
*** HOLE CARDS ***
talga421: folds 
evgenia19591: calls 30
ElliNelly: folds 
Adso139: folds 
sasha.yush: folds 
houtenboog: folds 
setarcos1234: folds 
mcgcork: calls 15
LocoSanDiego has timed out while disconnected
LocoSanDiego: checks 
*** FLOP *** [5c Kh 6h]
mcgcork: checks 
LocoSanDiego is connected 
LocoSanDiego: checks 
evgenia19591: checks 
*** TURN *** [5c Kh 6h] [Td]
mcgcork: checks 
LocoSanDiego: bets 120
evgenia19591: folds 
mcgcork: folds 
Uncalled bet (120) returned to LocoSanDiego
LocoSanDiego collected 135 from pot
*** SUMMARY ***
Total pot 135 | Rake 0 
Board [5c Kh 6h Td]
Seat 1: talga421 folded before Flop (didn't bet)
Seat 2: evgenia19591 folded on the Turn
Seat 3: ElliNelly folded before Flop (didn't bet)
Seat 4: Adso139 folded before Flop (didn't bet)
Seat 5: sasha.yush folded before Flop (didn't bet)
Seat 6: houtenboog folded before Flop (didn't bet)
Seat 7: setarcos1234 (button) folded before Flop (didn't bet)
Seat 8: mcgcork (small blind) folded on the Turn
Seat 9: LocoSanDiego (big blind) collected (135)



PokerStars Hand #157575222906: Tournament #1641817620, $7.50+$7.50+$1.50 USD Hold'em No Limit - Level I (15/30) - 2016/08/21 18:34:20 ET
Table '1641817620 7' 9-max Seat #7 is the button
Seat 1: jad castelo (5070 in chips) 
Seat 2: ricar1749 (4980 in chips) 
Seat 3: Steve G009 (4965 in chips) 
Seat 4: nbmom (4875 in chips) 
Seat 5: bernardijack (5145 in chips) 
Seat 6: POKEMONSTRO (4920 in chips) 
Seat 7: NemeanDanny (5035 in chips) 
Seat 8: Original02 (5335 in chips) 
Seat 9: cjgarceau (4920 in chips) 
jad castelo: posts the ante 5
ricar1749: posts the ante 5
Steve G009: posts the ante 5
nbmom: posts the ante 5
bernardijack: posts the ante 5
POKEMONSTRO: posts the ante 5
NemeanDanny: posts the ante 5
Original02: posts the ante 5
cjgarceau: posts the ante 5
Original02: posts small blind 15
cjgarceau: posts big blind 30
*** HOLE CARDS ***
jad castelo: folds 
ricar1749: folds 
Steve G009: folds 
nbmom: folds 
bernardijack: folds 
POKEMONSTRO: raises 37 to 67
NemeanDanny: folds 
Original02: folds 
cjgarceau: calls 37
*** FLOP *** [Tc 3c Ts]
cjgarceau: checks 
POKEMONSTRO: bets 129
cjgarceau: folds 
Uncalled bet (129) returned to POKEMONSTRO
POKEMONSTRO collected 194 from pot
*** SUMMARY ***
Total pot 194 | Rake 0 
Board [Tc 3c Ts]
Seat 1: jad castelo folded before Flop (didn't bet)
Seat 2: ricar1749 folded before Flop (didn't bet)
Seat 3: Steve G009 folded before Flop (didn't bet)
Seat 4: nbmom folded before Flop (didn't bet)
Seat 5: bernardijack folded before Flop (didn't bet)
Seat 6: POKEMONSTRO collected (194)
Seat 7: NemeanDanny (button) folded before Flop (didn't bet)
Seat 8: Original02 (small blind) folded before Flop
Seat 9: cjgarceau (big blind) folded on the Flop



PokerStars Hand #157575224088: Tournament #1641817620, $7.50+$7.50+$1.50 USD Hold'em No Limit - Level I (15/30) - 2016/08/21 18:34:22 ET
Table '1641817620 47' 9-max Seat #6 is the button
Seat 1: sovikeen (5070 in chips) 
Seat 2: RipperRooo (5355 in chips) 
Seat 3: gtavares10 (4722 in chips) 
Seat 4: FredyROKSTAR (4995 in chips) 
Seat 5: IvnAK (4635 in chips) 
Seat 6: sergiooker (5323 in chips) 
Seat 7: T3chnojunk (4950 in chips) 
Seat 8: bruff3l (5065 in chips) 
Seat 9: ppmaster (4890 in chips) 
sovikeen: posts the ante 5
RipperRooo: posts the ante 5
gtavares10: posts the ante 5
FredyROKSTAR: posts the ante 5
IvnAK: posts the ante 5
sergiooker: posts the ante 5
T3chnojunk: posts the ante 5
bruff3l: posts the ante 5
ppmaster: posts the ante 5
T3chnojunk: posts small blind 15
bruff3l: posts big blind 30
*** HOLE CARDS ***
ppmaster: folds 
sovikeen: folds 
RipperRooo: folds 
gtavares10: raises 60 to 90
FredyROKSTAR: folds 
IvnAK: folds 
sergiooker: folds 
T3chnojunk: folds 
bruff3l: calls 60
*** FLOP *** [9d 7c Tc]
bruff3l: checks 
gtavares10: checks 
*** TURN *** [9d 7c Tc] [4c]
bruff3l: checks 
gtavares10: checks 
*** RIVER *** [9d 7c Tc 4c] [8c]
bruff3l: checks 
gtavares10: checks 
*** SHOW DOWN ***
bruff3l: shows [Kd 4s] (a pair of Fours)
gtavares10: shows [Ah Ad] (a pair of Aces)
gtavares10 collected 240 from pot
*** SUMMARY ***
Total pot 240 | Rake 0 
Board [9d 7c Tc 4c 8c]
Seat 1: sovikeen folded before Flop (didn't bet)
Seat 2: RipperRooo folded before Flop (didn't bet)
Seat 3: gtavares10 showed [Ah Ad] and won (240) with a pair of Aces
Seat 4: FredyROKSTAR folded before Flop (didn't bet)
Seat 5: IvnAK folded before Flop (didn't bet)
Seat 6: sergiooker (button) folded before Flop (didn't bet)
Seat 7: T3chnojunk (small blind) folded before Flop
Seat 8: bruff3l (big blind) showed [Kd 4s] and lost with a pair of Fours
Seat 9: ppmaster folded before Flop (didn't bet)



PokerStars Hand #157575225372: Tournament #1641817620, $7.50+$7.50+$1.50 USD Hold'em No Limit - Level I (15/30) - 2016/08/21 18:34:24 ET
Table '1641817620 49' 9-max Seat #5 is the button
Seat 1: Mi2xa (4985 in chips) 
Seat 2: abig89 (5584 in chips) 
Seat 3: nickviso (4940 in chips) 
Seat 4: Colt Cardz (5000 in chips) 
Seat 5: Can'tStopMee (4280 in chips) 
Seat 6: PaulDaPole (6078 in chips) 
Seat 7: Prebendk (4430 in chips) 
Seat 8: VixenKoala (4985 in chips) 
Seat 9: logos1428 (4723 in chips) 
Mi2xa: posts the ante 5
abig89: posts the ante 5
nickviso: posts the ante 5
Colt Cardz: posts the ante 5
Can'tStopMee: posts the ante 5
PaulDaPole: posts the ante 5
Prebendk: posts the ante 5
VixenKoala: posts the ante 5
logos1428: posts the ante 5
PaulDaPole: posts small blind 15
Prebendk: posts big blind 30
*** HOLE CARDS ***
VixenKoala has timed out
VixenKoala: folds 
VixenKoala is sitting out
logos1428: folds 
Mi2xa: folds 
abig89: folds 
VixenKoala has returned
nickviso: raises 30 to 60
Colt Cardz: folds 
Can'tStopMee: folds 
PaulDaPole: folds 
Prebendk: calls 30
*** FLOP *** [5s 3s 9d]
Prebendk: checks 
nickviso: checks 
*** TURN *** [5s 3s 9d] [2h]
Prebendk: checks 
nickviso: checks 
*** RIVER *** [5s 3s 9d 2h] [Qh]
Prebendk: checks 
nickviso: bets 120
Prebendk: folds 
Uncalled bet (120) returned to nickviso
nickviso collected 180 from pot
*** SUMMARY ***
Total pot 180 | Rake 0 
Board [5s 3s 9d 2h Qh]
Seat 1: Mi2xa folded before Flop (didn't bet)
Seat 2: abig89 folded before Flop (didn't bet)
Seat 3: nickviso collected (180)
Seat 4: Colt Cardz folded before Flop (didn't bet)
Seat 5: Can'tStopMee (button) folded before Flop (didn't bet)
Seat 6: PaulDaPole (small blind) folded before Flop
Seat 7: Prebendk (big blind) folded on the River
Seat 8: VixenKoala folded before Flop (didn't bet)
Seat 9: logos1428 folded before Flop (didn't bet)



PokerStars Hand #157575225495: Tournament #1641817620, $7.50+$7.50+$1.50 USD Hold'em No Limit - Level I (15/30) - 2016/08/21 18:34:24 ET
Table '1641817620 17' 9-max Seat #9 is the button
Seat 1: guitarist68 (4990 in chips) 
Seat 2: Anton163reg (5545 in chips) 
Seat 3: GoldenBeeM (4925 in chips) 
Seat 4: brano9 (5000 in chips) 
Seat 5: happyminh (4600 in chips) 
Seat 6: dekota222 (4925 in chips) 
Seat 7: rooney69 (5310 in chips) 
Seat 8: Cechinator (5000 in chips) 
Seat 9: Samburger514 (5075 in chips) 
guitarist68: posts the ante 5
Anton163reg: posts the ante 5
GoldenBeeM: posts the ante 5
brano9: posts the ante 5
happyminh: posts the ante 5
dekota222: posts the ante 5
rooney69: posts the ante 5
Cechinator: posts the ante 5
Samburger514: posts the ante 5
guitarist68: posts small blind 15
Anton163reg: posts big blind 30
*** HOLE CARDS ***
GoldenBeeM: folds 
brano9: raises 30 to 60
happyminh: raises 210 to 270
dekota222: folds 
rooney69: folds 
Cechinator: calls 270
Samburger514: folds 
guitarist68: folds 
Anton163reg: folds 
brano9: calls 210
*** FLOP *** [Js Ad 8h]
brano9: checks 
happyminh: bets 900
Cechinator: calls 900
brano9: folds 
*** TURN *** [Js Ad 8h] [2c]
happyminh: bets 2700
Cechinator: raises 1125 to 3825 and is all-in
happyminh: calls 725 and is all-in
Uncalled bet (400) returned to Cechinator
*** RIVER *** [Js Ad 8h 2c] [9s]
*** SHOW DOWN ***
happyminh: shows [Ah Kd] (a pair of Aces)
Cechinator: shows [4c Ac] (a pair of Aces - lower kicker)
happyminh collected 9550 from pot
*** SUMMARY ***
Total pot 9550 | Rake 0 
Board [Js Ad 8h 2c 9s]
Seat 1: guitarist68 (small blind) folded before Flop
Seat 2: Anton163reg (big blind) folded before Flop
Seat 3: GoldenBeeM folded before Flop (didn't bet)
Seat 4: brano9 folded on the Flop
Seat 5: happyminh showed [Ah Kd] and won (9550) with a pair of Aces
Seat 6: dekota222 folded before Flop (didn't bet)
Seat 7: rooney69 folded before Flop (didn't bet)
Seat 8: Cechinator showed [4c Ac] and lost with a pair of Aces
Seat 9: Samburger514 (button) folded before Flop (didn't bet)



PokerStars Hand #157575228882: Tournament #1641817620, $7.50+$7.50+$1.50 USD Hold'em No Limit - Level I (15/30) - 2016/08/21 18:34:29 ET
Table '1641817620 19' 9-max Seat #6 is the button
Seat 1: ArskaTheMan (4980 in chips) 
Seat 2: renem24 (10030 in chips) 
Seat 3: Paparazzi507 (5180 in chips) 
Seat 4: amondelo (4460 in chips) 
Seat 5: xapnss (5000 in chips) 
Seat 6: flutzke90 (4935 in chips) 
Seat 7: Konfucy1 (5000 in chips) out of hand (moved from another table into small blind)
Seat 8: le_chefe28 (5505 in chips) 
Seat 9: naumans (4980 in chips) 
ArskaTheMan: posts the ante 5
renem24: posts the ante 5
Paparazzi507: posts the ante 5
amondelo: posts the ante 5
xapnss: posts the ante 5
flutzke90: posts the ante 5
le_chefe28: posts the ante 5
naumans: posts the ante 5
le_chefe28: posts small blind 15
naumans: posts big blind 30
*** HOLE CARDS ***
ArskaTheMan: folds 
renem24: folds 
Paparazzi507: folds 
amondelo: raises 54 to 84
xapnss: folds 
flutzke90: folds 
le_chefe28: folds 
naumans: folds 
Uncalled bet (54) returned to amondelo
amondelo collected 115 from pot
amondelo: doesn't show hand 
*** SUMMARY ***
Total pot 115 | Rake 0 
Seat 1: ArskaTheMan folded before Flop (didn't bet)
Seat 2: renem24 folded before Flop (didn't bet)
Seat 3: Paparazzi507 folded before Flop (didn't bet)
Seat 4: amondelo collected (115)
Seat 5: xapnss folded before Flop (didn't bet)
Seat 6: flutzke90 (button) folded before Flop (didn't bet)
Seat 8: le_chefe28 (small blind) folded before Flop
Seat 9: naumans (big blind) folded before Flop



PokerStars Hand #157575229349: Tournament #1641817620, $7.50+$7.50+$1.50 USD Hold'em No Limit - Level I (15/30) - 2016/08/21 18:34:30 ET
Table '1641817620 31' 9-max Seat #6 is the button
Seat 1: JmanRz (5074 in chips) 
Seat 2: Esp2011 (4697 in chips) 
Seat 3: karanikolass (5059 in chips) 
Seat 4: Famzinha10 (4875 in chips) 
Seat 5: jucielitheco (4815 in chips) 
Seat 6: Ant_md (5575 in chips) 
Seat 7: fkamus (4950 in chips) 
Seat 8: RENA79 (4980 in chips) 
Seat 9: Jack.Siete (4980 in chips) 
JmanRz: posts the ante 5
Esp2011: posts the ante 5
karanikolass: posts the ante 5
Famzinha10: posts the ante 5
jucielitheco: posts the ante 5
Ant_md: posts the ante 5
fkamus: posts the ante 5
RENA79: posts the ante 5
Jack.Siete: posts the ante 5
fkamus: posts small blind 15
RENA79: posts big blind 30
*** HOLE CARDS ***
Jack.Siete: folds 
JmanRz: raises 39 to 69
Esp2011: folds 
karanikolass: folds 
Famzinha10: calls 69
jucielitheco: folds 
Ant_md: folds 
fkamus: raises 171 to 240
RENA79: folds 
JmanRz: folds 
Famzinha10: calls 171
*** FLOP *** [Th 3h 6c]
fkamus: checks 
Famzinha10: bets 120
fkamus: calls 120
*** TURN *** [Th 3h 6c] [5d]
fkamus: checks 
Famzinha10: bets 150
fkamus: calls 150
*** RIVER *** [Th 3h 6c 5d] [4d]
fkamus: checks 
Famzinha10: checks 
*** SHOW DOWN ***
fkamus: shows [Qc Ac] (high card Ace)
Famzinha10: shows [6h Qd] (a pair of Sixes)
Famzinha10 collected 1164 from pot
*** SUMMARY ***
Total pot 1164 | Rake 0 
Board [Th 3h 6c 5d 4d]
Seat 1: JmanRz folded before Flop
Seat 2: Esp2011 folded before Flop (didn't bet)
Seat 3: karanikolass folded before Flop (didn't bet)
Seat 4: Famzinha10 showed [6h Qd] and won (1164) with a pair of Sixes
Seat 5: jucielitheco folded before Flop (didn't bet)
Seat 6: Ant_md (button) folded before Flop (didn't bet)
Seat 7: fkamus (small blind) showed [Qc Ac] and lost with high card Ace
Seat 8: RENA79 (big blind) folded before Flop
Seat 9: Jack.Siete folded before Flop (didn't bet)



PokerStars Hand #157575229351: Tournament #1641817620, $7.50+$7.50+$1.50 USD Hold'em No Limit - Level I (15/30) - 2016/08/21 18:34:30 ET
Table '1641817620 3' 9-max Seat #7 is the button
Seat 1: IwantplayNL (4513 in chips) 
Seat 2: dufino (7141 in chips) 
Seat 3: zIggY-7-rAc3 (5230 in chips) 
Seat 4: gerald0jr (4930 in chips) 
Seat 5: Arkadius1975 (4995 in chips) 
Seat 6: BrunoCastroR (2900 in chips) 
Seat 7: alehirazawa (4930 in chips) 
Seat 8: markosharko (5396 in chips) 
Seat 9: VictorZh14 (4975 in chips) 
IwantplayNL: posts the ante 5
dufino: posts the ante 5
zIggY-7-rAc3: posts the ante 5
gerald0jr: posts the ante 5
Arkadius1975: posts the ante 5
BrunoCastroR: posts the ante 5
alehirazawa: posts the ante 5
markosharko: posts the ante 5
VictorZh14: posts the ante 5
markosharko: posts small blind 15
VictorZh14: posts big blind 30
*** HOLE CARDS ***
IwantplayNL: folds 
dufino: folds 
zIggY-7-rAc3: folds 
gerald0jr: folds 
Arkadius1975: folds 
BrunoCastroR: folds 
alehirazawa: folds 
markosharko: calls 15
VictorZh14: raises 90 to 120
markosharko: folds 
Uncalled bet (90) returned to VictorZh14
VictorZh14 collected 105 from pot
VictorZh14: doesn't show hand 
*** SUMMARY ***
Total pot 105 | Rake 0 
Seat 1: IwantplayNL folded before Flop (didn't bet)
Seat 2: dufino folded before Flop (didn't bet)
Seat 3: zIggY-7-rAc3 folded before Flop (didn't bet)
Seat 4: gerald0jr folded before Flop (didn't bet)
Seat 5: Arkadius1975 folded before Flop (didn't bet)
Seat 6: BrunoCastroR folded before Flop (didn't bet)
Seat 7: alehirazawa (button) folded before Flop (didn't bet)
Seat 8: markosharko (small blind) folded before Flop
Seat 9: VictorZh14 (big blind) collected (105)



PokerStars Hand #157575229801: Tournament #1641817620, $7.50+$7.50+$1.50 USD Hold'em No Limit - Level I (15/30) - 2016/08/21 18:34:30 ET
Table '1641817620 29' 9-max Seat #5 is the button
Seat 1: kidpokerjm89 (4980 in chips) 
Seat 2: niejowicz (4965 in chips) 
Seat 3: Ofbravetight (4935 in chips) 
Seat 4: Ottel (4155 in chips) 
Seat 5: puntoo (4920 in chips) 
Seat 6: Melady77777 (6015 in chips) 
Seat 7: fishfind000 (5070 in chips) 
Seat 8: AcePheres (4980 in chips) 
Seat 9: LAZO30 (4980 in chips) 
kidpokerjm89: posts the ante 5
niejowicz: posts the ante 5
Ofbravetight: posts the ante 5
Ottel: posts the ante 5
puntoo: posts the ante 5
Melady77777: posts the ante 5
fishfind000: posts the ante 5
AcePheres: posts the ante 5
LAZO30: posts the ante 5
Melady77777: posts small blind 15
fishfind000: posts big blind 30
*** HOLE CARDS ***
AcePheres: folds 
niejowicz is disconnected 
LAZO30: raises 30 to 60
kidpokerjm89: folds 
niejowicz has timed out while disconnected
niejowicz: folds 
niejowicz is sitting out
Ofbravetight: folds 
Ottel: folds 
puntoo: calls 60
Melady77777: folds 
fishfind000: folds 
*** FLOP *** [9d 3h 8s]
LAZO30: checks 
puntoo: bets 210
LAZO30: calls 210
*** TURN *** [9d 3h 8s] [Th]
LAZO30: checks 
puntoo: bets 630
LAZO30: folds 
Uncalled bet (630) returned to puntoo
puntoo collected 630 from pot
*** SUMMARY ***
Total pot 630 | Rake 0 
Board [9d 3h 8s Th]
Seat 1: kidpokerjm89 folded before Flop (didn't bet)
Seat 2: niejowicz folded before Flop (didn't bet)
Seat 3: Ofbravetight folded before Flop (didn't bet)
Seat 4: Ottel folded before Flop (didn't bet)
Seat 5: puntoo (button) collected (630)
Seat 6: Melady77777 (small blind) folded before Flop
Seat 7: fishfind000 (big blind) folded before Flop
Seat 8: AcePheres folded before Flop (didn't bet)
Seat 9: LAZO30 folded on the Turn



PokerStars Hand #157575229822: Tournament #1641817620, $7.50+$7.50+$1.50 USD Hold'em No Limit - Level I (15/30) - 2016/08/21 18:34:31 ET
Table '1641817620 51' 9-max Seat #5 is the button
Seat 1: yys000 (4980 in chips) 
Seat 2: paulotury (5535 in chips) 
Seat 3: kozloeric (4868 in chips) 
Seat 4: bastef79 (4846 in chips) 
Seat 5: cusirc (4935 in chips) 
Seat 6: demonas05 (5339 in chips) 
Seat 7: boostyz (4980 in chips) 
Seat 8: Garfild740 (4980 in chips) 
Seat 9: Kalvar1 (4537 in chips) 
yys000: posts the ante 5
paulotury: posts the ante 5
kozloeric: posts the ante 5
bastef79: posts the ante 5
cusirc: posts the ante 5
demonas05: posts the ante 5
boostyz: posts the ante 5
Garfild740: posts the ante 5
Kalvar1: posts the ante 5
demonas05: posts small blind 15
boostyz: posts big blind 30
*** HOLE CARDS ***
Garfild740: folds 
Kalvar1: folds 
yys000: raises 30 to 60
paulotury: folds 
kozloeric: calls 60
bastef79: folds 
cusirc: folds 
demonas05: calls 45
boostyz: calls 30
*** FLOP *** [Jc 8s Kd]
demonas05: checks 
boostyz: checks 
yys000: bets 180
kozloeric: folds 
demonas05: folds 
boostyz: folds 
Uncalled bet (180) returned to yys000
yys000 collected 285 from pot
*** SUMMARY ***
Total pot 285 | Rake 0 
Board [Jc 8s Kd]
Seat 1: yys000 collected (285)
Seat 2: paulotury folded before Flop (didn't bet)
Seat 3: kozloeric folded on the Flop
Seat 4: bastef79 folded before Flop (didn't bet)
Seat 5: cusirc (button) folded before Flop (didn't bet)
Seat 6: demonas05 (small blind) folded on the Flop
Seat 7: boostyz (big blind) folded on the Flop
Seat 8: Garfild740 folded before Flop (didn't bet)
Seat 9: Kalvar1 folded before Flop (didn't bet)



PokerStars Hand #157575230297: Tournament #1641817620, $7.50+$7.50+$1.50 USD Hold'em No Limit - Level I (15/30) - 2016/08/21 18:34:31 ET
Table '1641817620 50' 9-max Seat #6 is the button
Seat 1: Alpentraum (4098 in chips) 
Seat 2: FrEmpireAk (10152 in chips) 
Seat 3: hat_coates (4935 in chips) 
Seat 4: GiCi40 (4995 in chips) 
Seat 5: Herbettigre (4980 in chips) 
Seat 6: saintP20 (1070 in chips) 
Seat 7: Shab26 (4815 in chips) 
Seat 8: thinkfeeldo (4980 in chips) 
Seat 9: ziomekek (4980 in chips) 
Alpentraum: posts the ante 5
FrEmpireAk: posts the ante 5
hat_coates: posts the ante 5
GiCi40: posts the ante 5
Herbettigre: posts the ante 5
saintP20: posts the ante 5
Shab26: posts the ante 5
thinkfeeldo: posts the ante 5
ziomekek: posts the ante 5
Shab26: posts small blind 15
thinkfeeldo: posts big blind 30
*** HOLE CARDS ***
ziomekek: raises 37 to 67
Alpentraum: calls 67
FrEmpireAk: folds 
hat_coates: folds 
GiCi40: folds 
Herbettigre: folds 
saintP20: folds 
Shab26: folds 
thinkfeeldo: calls 37
*** FLOP *** [4h Qs 9h]
thinkfeeldo: checks 
ziomekek: bets 161
Alpentraum: folds 
thinkfeeldo: folds 
Uncalled bet (161) returned to ziomekek
ziomekek collected 261 from pot
ziomekek: doesn't show hand 
*** SUMMARY ***
Total pot 261 | Rake 0 
Board [4h Qs 9h]
Seat 1: Alpentraum folded on the Flop
Seat 2: FrEmpireAk folded before Flop (didn't bet)
Seat 3: hat_coates folded before Flop (didn't bet)
Seat 4: GiCi40 folded before Flop (didn't bet)
Seat 5: Herbettigre folded before Flop (didn't bet)
Seat 6: saintP20 (button) folded before Flop (didn't bet)
Seat 7: Shab26 (small blind) folded before Flop
Seat 8: thinkfeeldo (big blind) folded on the Flop
Seat 9: ziomekek collected (261)



PokerStars Hand #157575230669: Tournament #1641817620, $7.50+$7.50+$1.50 USD Hold'em No Limit - Level I (15/30) - 2016/08/21 18:34:32 ET
Table '1641817620 37' 9-max Seat #7 is the button
Seat 1: Youbetipush1 (4915 in chips) 
Seat 2: SouzaEduardo (4960 in chips) 
Seat 3: Maisteri (7190 in chips) 
Seat 4: qball911 (4870 in chips) 
Seat 5: dell1961 (4845 in chips) 
Seat 6: ColdFire_200 (4885 in chips) 
Seat 7: loachxm (4880 in chips) 
Seat 8: mikke8282 (5200 in chips) 
Youbetipush1: posts the ante 5
SouzaEduardo: posts the ante 5
Maisteri: posts the ante 5
qball911: posts the ante 5
dell1961: posts the ante 5
ColdFire_200: posts the ante 5
loachxm: posts the ante 5
mikke8282: posts the ante 5
mikke8282: posts small blind 15
Youbetipush1: posts big blind 30
*** HOLE CARDS ***
SouzaEduardo: folds 
Maisteri: raises 30 to 60
qball911: folds 
dell1961: folds 
ColdFire_200: folds 
loachxm: folds 
mikke8282: folds 
Youbetipush1: folds 
Uncalled bet (30) returned to Maisteri
Maisteri collected 115 from pot
*** SUMMARY ***
Total pot 115 | Rake 0 
Seat 1: Youbetipush1 (big blind) folded before Flop
Seat 2: SouzaEduardo folded before Flop (didn't bet)
Seat 3: Maisteri collected (115)
Seat 4: qball911 folded before Flop (didn't bet)
Seat 5: dell1961 folded before Flop (didn't bet)
Seat 6: ColdFire_200 folded before Flop (didn't bet)
Seat 7: loachxm (button) folded before Flop (didn't bet)
Seat 8: mikke8282 (small blind) folded before Flop



PokerStars Hand #157575230837: Tournament #1641817620, $7.50+$7.50+$1.50 USD Hold'em No Limit - Level I (15/30) - 2016/08/21 18:34:32 ET
Table '1641817620 11' 9-max Seat #5 is the button
Seat 1: GambleGrill (4980 in chips) 
Seat 2: Dionakabarbi (4965 in chips) 
Seat 3: TriviGn'R (5020 in chips) 
Seat 4: rapo007 (4935 in chips) 
Seat 5: vanilaice88 (4725 in chips) 
Seat 6: buzios38 (5550 in chips) 
Seat 8: luisnrd (4920 in chips) 
Seat 9: kylix42 (4980 in chips) 
GambleGrill: posts the ante 5
Dionakabarbi: posts the ante 5
TriviGn'R: posts the ante 5
rapo007: posts the ante 5
vanilaice88: posts the ante 5
buzios38: posts the ante 5
luisnrd: posts the ante 5
kylix42: posts the ante 5
buzios38: posts small blind 15
luisnrd: posts big blind 30
*** HOLE CARDS ***
kylix42: raises 59 to 89
GambleGrill: folds 
Dionakabarbi has timed out
Dionakabarbi: folds 
Dionakabarbi is sitting out
TriviGn'R: folds 
rapo007: folds 
Dionakabarbi has returned
vanilaice88: folds 
buzios38: folds 
luisnrd: folds 
Uncalled bet (59) returned to kylix42
kylix42 collected 115 from pot
*** SUMMARY ***
Total pot 115 | Rake 0 
Seat 1: GambleGrill folded before Flop (didn't bet)
Seat 2: Dionakabarbi folded before Flop (didn't bet)
Seat 3: TriviGn'R folded before Flop (didn't bet)
Seat 4: rapo007 folded before Flop (didn't bet)
Seat 5: vanilaice88 (button) folded before Flop (didn't bet)
Seat 6: buzios38 (small blind) folded before Flop
Seat 8: luisnrd (big blind) folded before Flop
Seat 9: kylix42 collected (115)



PokerStars Hand #157575230867: Tournament #1641817620, $7.50+$7.50+$1.50 USD Hold'em No Limit - Level I (15/30) - 2016/08/21 18:34:32 ET
Table '1641817620 56' 9-max Seat #4 is the button
Seat 1: PpME_Oe_87 (4985 in chips) 
Seat 2: NrRockeT9 (4730 in chips) 
Seat 3: DontFoldItPL (3875 in chips) 
Seat 4: cla11 (5735 in chips) 
Seat 5: luvlust (4745 in chips) 
Seat 7: rickyrdmy (4985 in chips) 
Seat 8: M.J.466 (5975 in chips) 
Seat 9: Exan13 (4985 in chips) 
PpME_Oe_87: posts the ante 5
NrRockeT9: posts the ante 5
DontFoldItPL: posts the ante 5
cla11: posts the ante 5
luvlust: posts the ante 5
rickyrdmy: posts the ante 5
M.J.466: posts the ante 5
Exan13: posts the ante 5
luvlust: posts small blind 15
rickyrdmy: posts big blind 30
*** HOLE CARDS ***
M.J.466: folds 
Exan13: raises 60 to 90
PpME_Oe_87: folds 
NrRockeT9: calls 90
DontFoldItPL: folds 
cla11: folds 
luvlust: folds 
rickyrdmy: folds 
*** FLOP *** [8d Ah 6c]
Exan13: bets 135
NrRockeT9: folds 
Uncalled bet (135) returned to Exan13
Exan13 collected 265 from pot
Exan13: doesn't show hand 
*** SUMMARY ***
Total pot 265 | Rake 0 
Board [8d Ah 6c]
Seat 1: PpME_Oe_87 folded before Flop (didn't bet)
Seat 2: NrRockeT9 folded on the Flop
Seat 3: DontFoldItPL folded before Flop (didn't bet)
Seat 4: cla11 (button) folded before Flop (didn't bet)
Seat 5: luvlust (small blind) folded before Flop
Seat 7: rickyrdmy (big blind) folded before Flop
Seat 8: M.J.466 folded before Flop (didn't bet)
Seat 9: Exan13 collected (265)



PokerStars Hand #157575231085: Tournament #1641817620, $7.50+$7.50+$1.50 USD Hold'em No Limit - Level I (15/30) - 2016/08/21 18:34:32 ET
Table '1641817620 32' 9-max Seat #7 is the button
Seat 1: RoribeiroS (6588 in chips) 
Seat 2: tomgan (5105 in chips) 
Seat 3: patou99957 (4476 in chips) 
Seat 4: JAhodaZ (4900 in chips) 
Seat 5: bdiddy1313 (5315 in chips) 
Seat 6: 69 hearts 69 (4161 in chips) 
Seat 7: rimis9999 (4930 in chips) 
Seat 8: noah5555 (4645 in chips) 
RoribeiroS: posts the ante 5
tomgan: posts the ante 5
patou99957: posts the ante 5
JAhodaZ: posts the ante 5
bdiddy1313: posts the ante 5
69 hearts 69: posts the ante 5
rimis9999: posts the ante 5
noah5555: posts the ante 5
noah5555: posts small blind 15
RoribeiroS: posts big blind 30
*** HOLE CARDS ***
tomgan: calls 30
patou99957: calls 30
JAhodaZ: raises 120 to 150
bdiddy1313: calls 150
69 hearts 69: folds 
rimis9999: folds 
noah5555: folds 
RoribeiroS: folds 
tomgan: calls 120
patou99957: calls 120
*** FLOP *** [Qs Js Kc]
tomgan: checks 
patou99957: folds 
JAhodaZ: checks 
bdiddy1313: checks 
*** TURN *** [Qs Js Kc] [2c]
tomgan: checks 
JAhodaZ: checks 
bdiddy1313: checks 
*** RIVER *** [Qs Js Kc 2c] [Kh]
tomgan: checks 
JAhodaZ: checks 
bdiddy1313: checks 
*** SHOW DOWN ***
tomgan: shows [As 3s] (a pair of Kings)
JAhodaZ: mucks hand 
bdiddy1313: shows [5s 5h] (two pair, Kings and Fives)
bdiddy1313 collected 685 from pot
*** SUMMARY ***
Total pot 685 | Rake 0 
Board [Qs Js Kc 2c Kh]
Seat 1: RoribeiroS (big blind) folded before Flop
Seat 2: tomgan showed [As 3s] and lost with a pair of Kings
Seat 3: patou99957 folded on the Flop
Seat 4: JAhodaZ mucked
Seat 5: bdiddy1313 showed [5s 5h] and won (685) with two pair, Kings and Fives
Seat 6: 69 hearts 69 folded before Flop (didn't bet)
Seat 7: rimis9999 (button) folded before Flop (didn't bet)
Seat 8: noah5555 (small blind) folded before Flop



PokerStars Hand #157575231257: Tournament #1641817620, $7.50+$7.50+$1.50 USD Hold'em No Limit - Level I (15/30) - 2016/08/21 18:34:33 ET
Table '1641817620 52' 9-max Seat #5 is the button
Seat 1: DoubleBBle (5475 in chips) 
Seat 2: FelipeMarlon (5205 in chips) 
Seat 3: michalis009 (4875 in chips) 
Seat 4: Daviderevan (4935 in chips) 
Seat 5: Armin2188 (4935 in chips) 
Seat 6: HORSEPOKER28 (5115 in chips) 
Seat 8: vladvladutz (4980 in chips) 
Seat 9: leothefirm (4905 in chips) 
DoubleBBle: posts the ante 5
FelipeMarlon: posts the ante 5
michalis009: posts the ante 5
Daviderevan: posts the ante 5
Armin2188: posts the ante 5
HORSEPOKER28: posts the ante 5
vladvladutz: posts the ante 5
leothefirm: posts the ante 5
HORSEPOKER28: posts small blind 15
vladvladutz: posts big blind 30
*** HOLE CARDS ***
leothefirm: folds 
DoubleBBle: folds 
FelipeMarlon: folds 
michalis009: raises 45 to 75
Daviderevan: folds 
Armin2188: folds 
HORSEPOKER28: folds 
vladvladutz: calls 45
*** FLOP *** [5h 2c 9d]
vladvladutz: checks 
michalis009: checks 
*** TURN *** [5h 2c 9d] [Qh]
vladvladutz: checks 
michalis009: bets 102
vladvladutz: calls 102
*** RIVER *** [5h 2c 9d Qh] [3d]
vladvladutz: checks 
michalis009: checks 
*** SHOW DOWN ***
vladvladutz: shows [9s 8c] (a pair of Nines)
michalis009: mucks hand 
vladvladutz collected 409 from pot
*** SUMMARY ***
Total pot 409 | Rake 0 
Board [5h 2c 9d Qh 3d]
Seat 1: DoubleBBle folded before Flop (didn't bet)
Seat 2: FelipeMarlon folded before Flop (didn't bet)
Seat 3: michalis009 mucked
Seat 4: Daviderevan folded before Flop (didn't bet)
Seat 5: Armin2188 (button) folded before Flop (didn't bet)
Seat 6: HORSEPOKER28 (small blind) folded before Flop
Seat 8: vladvladutz (big blind) showed [9s 8c] and won (409) with a pair of Nines
Seat 9: leothefirm folded before Flop (didn't bet)



PokerStars Hand #157575233506: Tournament #1641817620, $7.50+$7.50+$1.50 USD Hold'em No Limit - Level I (15/30) - 2016/08/21 18:34:36 ET
Table '1641817620 9' 9-max Seat #7 is the button
Seat 1: kake40 (4885 in chips) 
Seat 3: portugajr007 (5688 in chips) 
Seat 4: punkhead89 (5522 in chips) 
Seat 5: nO bUsTeD (4720 in chips) 
Seat 6: Greeno93 (5000 in chips) 
Seat 7: Cuzco83 (4885 in chips) 
Seat 8: maurogynppp (4915 in chips) 
Seat 9: N1COLOSO (4795 in chips) 
kake40: posts the ante 5
portugajr007: posts the ante 5
punkhead89: posts the ante 5
nO bUsTeD: posts the ante 5
Greeno93: posts the ante 5
Cuzco83: posts the ante 5
maurogynppp: posts the ante 5
N1COLOSO: posts the ante 5
maurogynppp: posts small blind 15
N1COLOSO: posts big blind 30
*** HOLE CARDS ***
kake40: folds 
portugajr007: raises 30 to 60
punkhead89: folds 
nO bUsTeD: folds 
Greeno93: folds 
Cuzco83: calls 60
maurogynppp: calls 45
N1COLOSO: folds 
*** FLOP *** [8s 7d 4h]
maurogynppp: checks 
portugajr007: checks 
Cuzco83: checks 
*** TURN *** [8s 7d 4h] [2c]
maurogynppp: checks 
portugajr007: checks 
Cuzco83: checks 
*** RIVER *** [8s 7d 4h 2c] [3d]
maurogynppp: checks 
portugajr007: checks 
Cuzco83: bets 155
maurogynppp: folds 
portugajr007: folds 
Uncalled bet (155) returned to Cuzco83
Cuzco83 collected 250 from pot
Cuzco83: doesn't show hand 
*** SUMMARY ***
Total pot 250 | Rake 0 
Board [8s 7d 4h 2c 3d]
Seat 1: kake40 folded before Flop (didn't bet)
Seat 3: portugajr007 folded on the River
Seat 4: punkhead89 folded before Flop (didn't bet)
Seat 5: nO bUsTeD folded before Flop (didn't bet)
Seat 6: Greeno93 folded before Flop (didn't bet)
Seat 7: Cuzco83 (button) collected (250)
Seat 8: maurogynppp (small blind) folded on the River
Seat 9: N1COLOSO (big blind) folded before Flop



PokerStars Hand #157575234086: Tournament #1641817620, $7.50+$7.50+$1.50 USD Hold'em No Limit - Level I (15/30) - 2016/08/21 18:34:37 ET
Table '1641817620 13' 9-max Seat #5 is the button
Seat 1: Mindthis (3233 in chips) 
Seat 2: nicka501 (10267 in chips) 
Seat 3: POG_Q4 (7208 in chips) 
Seat 4: sutherland43 (4940 in chips) 
Seat 5: LarikkadoAA (4940 in chips) 
Seat 6: MicroStaker5 (4463 in chips) 
Seat 7: MrMalaLeche (4980 in chips) 
Seat 8: EdsonPecly (4989 in chips) 
Seat 9: wantuirpoker (4975 in chips) 
Mindthis: posts the ante 5
nicka501: posts the ante 5
POG_Q4: posts the ante 5
sutherland43: posts the ante 5
LarikkadoAA: posts the ante 5
MicroStaker5: posts the ante 5
MrMalaLeche: posts the ante 5
EdsonPecly: posts the ante 5
wantuirpoker: posts the ante 5
MicroStaker5: posts small blind 15
MrMalaLeche: posts big blind 30
*** HOLE CARDS ***
EdsonPecly: folds 
wantuirpoker: raises 60 to 90
Mindthis: folds 
nicka501: calls 90
POG_Q4: folds 
sutherland43: folds 
LarikkadoAA: folds 
MicroStaker5: folds 
MrMalaLeche: folds 
*** FLOP *** [3c 9h Js]
wantuirpoker: bets 126
nicka501: calls 126
*** TURN *** [3c 9h Js] [Kd]
wantuirpoker: checks 
nicka501: bets 261
wantuirpoker: folds 
Uncalled bet (261) returned to nicka501
nicka501 collected 522 from pot
nicka501: doesn't show hand 
*** SUMMARY ***
Total pot 522 | Rake 0 
Board [3c 9h Js Kd]
Seat 1: Mindthis folded before Flop (didn't bet)
Seat 2: nicka501 collected (522)
Seat 3: POG_Q4 folded before Flop (didn't bet)
Seat 4: sutherland43 folded before Flop (didn't bet)
Seat 5: LarikkadoAA (button) folded before Flop (didn't bet)
Seat 6: MicroStaker5 (small blind) folded before Flop
Seat 7: MrMalaLeche (big blind) folded before Flop
Seat 8: EdsonPecly folded before Flop (didn't bet)
Seat 9: wantuirpoker folded on the Turn



PokerStars Hand #157575234168: Tournament #1641817620, $7.50+$7.50+$1.50 USD Hold'em No Limit - Level I (15/30) - 2016/08/21 18:34:37 ET
Table '1641817620 59' 9-max Seat #7 is the button
Seat 1: pitoco2012 (5005 in chips) 
Seat 2: M_ORBIT_M (5165 in chips) 
Seat 3: alemaowe (5015 in chips) 
Seat 4: jan monster (4529 in chips) 
Seat 5: laiyitui (4870 in chips) 
Seat 6: ryo1980 (5000 in chips) 
Seat 7: 88Xin88 (5020 in chips) 
Seat 8: Enio Pinho (5502 in chips) 
Seat 9: Robsn087 (4909 in chips) 
pitoco2012: posts the ante 5
M_ORBIT_M: posts the ante 5
alemaowe: posts the ante 5
jan monster: posts the ante 5
laiyitui: posts the ante 5
ryo1980: posts the ante 5
88Xin88: posts the ante 5
Enio Pinho: posts the ante 5
Robsn087: posts the ante 5
Enio Pinho: posts small blind 15
Robsn087: posts big blind 30
*** HOLE CARDS ***
pitoco2012: folds 
M_ORBIT_M: folds 
alemaowe: folds 
jan monster: folds 
laiyitui: folds 
ryo1980: raises 114 to 144
88Xin88: folds 
Enio Pinho: calls 129
Robsn087: calls 114
*** FLOP *** [3s 9h Kd]
Enio Pinho: checks 
Robsn087: checks 
ryo1980: bets 355
Enio Pinho: calls 355
Robsn087: folds 
*** TURN *** [3s 9h Kd] [6d]
Enio Pinho: checks 
ryo1980: bets 855
Enio Pinho: calls 855
*** RIVER *** [3s 9h Kd 6d] [Qc]
Enio Pinho: checks 
ryo1980: checks 
*** SHOW DOWN ***
Enio Pinho: shows [8d 9d] (a pair of Nines)
ryo1980: shows [As Ac] (a pair of Aces)
ryo1980 collected 2897 from pot
*** SUMMARY ***
Total pot 2897 | Rake 0 
Board [3s 9h Kd 6d Qc]
Seat 1: pitoco2012 folded before Flop (didn't bet)
Seat 2: M_ORBIT_M folded before Flop (didn't bet)
Seat 3: alemaowe folded before Flop (didn't bet)
Seat 4: jan monster folded before Flop (didn't bet)
Seat 5: laiyitui folded before Flop (didn't bet)
Seat 6: ryo1980 showed [As Ac] and won (2897) with a pair of Aces
Seat 7: 88Xin88 (button) folded before Flop (didn't bet)
Seat 8: Enio Pinho (small blind) showed [8d 9d] and lost with a pair of Nines
Seat 9: Robsn087 (big blind) folded on the Flop



PokerStars Hand #157575234463: Tournament #1641817620, $7.50+$7.50+$1.50 USD Hold'em No Limit - Level I (15/30) - 2016/08/21 18:34:38 ET
Table '1641817620 8' 9-max Seat #6 is the button
Seat 1: inkjoh (5360 in chips) 
Seat 2: MarcosCLMO (4562 in chips) 
Seat 3: HundTore (5785 in chips) 
Seat 4: Kamikase1805 (5020 in chips) 
Seat 5: younesch (4598 in chips) 
Seat 6: spinne1109 (4945 in chips) 
Seat 7: pavaopics (4795 in chips) 
Seat 8: FastEdiddy (4975 in chips) 
Seat 9: Pokerofwind (4975 in chips) 
inkjoh: posts the ante 5
MarcosCLMO: posts the ante 5
HundTore: posts the ante 5
Kamikase1805: posts the ante 5
younesch: posts the ante 5
spinne1109: posts the ante 5
pavaopics: posts the ante 5
FastEdiddy: posts the ante 5
Pokerofwind: posts the ante 5
pavaopics: posts small blind 15
FastEdiddy: posts big blind 30
*** HOLE CARDS ***
Pokerofwind: folds 
inkjoh: folds 
MarcosCLMO: folds 
HundTore: folds 
Kamikase1805: folds 
younesch: folds 
spinne1109: folds 
pavaopics: raises 30 to 60
FastEdiddy: folds 
Uncalled bet (30) returned to pavaopics
pavaopics collected 105 from pot
pavaopics: doesn't show hand 
*** SUMMARY ***
Total pot 105 | Rake 0 
Seat 1: inkjoh folded before Flop (didn't bet)
Seat 2: MarcosCLMO folded before Flop (didn't bet)
Seat 3: HundTore folded before Flop (didn't bet)
Seat 4: Kamikase1805 folded before Flop (didn't bet)
Seat 5: younesch folded before Flop (didn't bet)
Seat 6: spinne1109 (button) folded before Flop (didn't bet)
Seat 7: pavaopics (small blind) collected (105)
Seat 8: FastEdiddy (big blind) folded before Flop
Seat 9: Pokerofwind folded before Flop (didn't bet)



PokerStars Hand #157575235573: Tournament #1641817620, $7.50+$7.50+$1.50 USD Hold'em No Limit - Level I (15/30) - 2016/08/21 18:34:40 ET
Table '1641817620 26' 9-max Seat #7 is the button
Seat 1: duplo1182 (4715 in chips) 
Seat 2: Heretic66688 (4960 in chips) 
Seat 3: Axkj (4930 in chips) 
Seat 4: h1per1on (5275 in chips) 
Seat 5: zuzlica (5415 in chips) 
Seat 6: Archibal_17 (4520 in chips) 
Seat 7: GDLW26 (4855 in chips) 
Seat 8: maninshed (5000 in chips) out of hand (moved from another table into small blind)
Seat 9: danius111 (5120 in chips) 
duplo1182: posts the ante 5
Heretic66688: posts the ante 5
Axkj: posts the ante 5
h1per1on: posts the ante 5
zuzlica: posts the ante 5
Archibal_17: posts the ante 5
GDLW26: posts the ante 5
danius111: posts the ante 5
danius111: posts small blind 15
duplo1182: posts big blind 30
*** HOLE CARDS ***
Heretic66688: folds 
Axkj: folds 
h1per1on: folds 
zuzlica: raises 115 to 145
Archibal_17: folds 
GDLW26: folds 
danius111: calls 130
duplo1182: raises 4565 to 4710 and is all-in
zuzlica: calls 4565
danius111: calls 4565
*** FLOP *** [Js Qh 6h]
danius111: checks 
zuzlica: bets 700 and is all-in
danius111: calls 405 and is all-in
Uncalled bet (295) returned to zuzlica
*** TURN *** [Js Qh 6h] [Ad]
*** RIVER *** [Js Qh 6h Ad] [Jc]
*** SHOW DOWN ***
danius111: shows [Ts Th] (two pair, Jacks and Tens)
zuzlica: shows [Qd 7d] (two pair, Queens and Jacks)
zuzlica collected 810 from side pot
duplo1182: shows [8h Ac] (two pair, Aces and Jacks)
duplo1182 collected 14170 from main pot
zuzlica wins $3.75 for eliminating danius111 and their own bounty increases by $3.75 to $11.25
danius111 finished the tournament in 999999989th place
*** SUMMARY ***
Total pot 14980 Main pot 14170. Side pot 810. | Rake 0 
Board [Js Qh 6h Ad Jc]
Seat 1: duplo1182 (big blind) showed [8h Ac] and won (14170) with two pair, Aces and Jacks
Seat 2: Heretic66688 folded before Flop (didn't bet)
Seat 3: Axkj folded before Flop (didn't bet)
Seat 4: h1per1on folded before Flop (didn't bet)
Seat 5: zuzlica showed [Qd 7d] and won (810) with two pair, Queens and Jacks
Seat 6: Archibal_17 folded before Flop (didn't bet)
Seat 7: GDLW26 (button) folded before Flop (didn't bet)
Seat 9: danius111 (small blind) showed [Ts Th] and lost with two pair, Jacks and Tens



PokerStars Hand #157575235866: Tournament #1641817620, $7.50+$7.50+$1.50 USD Hold'em No Limit - Level I (15/30) - 2016/08/21 18:34:40 ET
Table '1641817620 53' 9-max Seat #6 is the button
Seat 1: star729 (5095 in chips) 
Seat 2: cebola77 (5935 in chips) 
Seat 3: Pekkosaurus (4930 in chips) 
Seat 4: -UNREGPRE- (4930 in chips) 
Seat 5: carlostrend (4280 in chips) 
Seat 6: The39player (4930 in chips) 
Seat 7: THE JONES_RJ (5000 in chips) out of hand (moved from another table into small blind)
Seat 8: top@pokker (4945 in chips) 
Seat 9: cruiser5917 (4975 in chips) 
star729: posts the ante 5
cebola77: posts the ante 5
Pekkosaurus: posts the ante 5
-UNREGPRE-: posts the ante 5
carlostrend: posts the ante 5
The39player: posts the ante 5
top@pokker: posts the ante 5
cruiser5917: posts the ante 5
top@pokker: posts small blind 15
cruiser5917: posts big blind 30
*** HOLE CARDS ***
star729: raises 30 to 60
cebola77: folds 
Pekkosaurus: folds 
-UNREGPRE-: folds 
carlostrend: calls 60
The39player: folds 
top@pokker: folds 
cruiser5917: calls 30
*** FLOP *** [2c Jd 3c]
cruiser5917: checks 
star729: checks 
carlostrend: bets 60
cruiser5917: raises 355 to 415
star729: folds 
carlostrend: raises 395 to 810
cruiser5917: calls 395
*** TURN *** [2c Jd 3c] [Ks]
cruiser5917: checks 
carlostrend: bets 927
cruiser5917: calls 927
*** RIVER *** [2c Jd 3c Ks] [6c]
cruiser5917: checks 
carlostrend: bets 2478 and is all-in
cruiser5917: calls 2478
*** SHOW DOWN ***
carlostrend: shows [Jc Tc] (a flush, Jack high)
cruiser5917: shows [9s Jh] (a pair of Jacks)
carlostrend collected 8665 from pot
*** SUMMARY ***
Total pot 8665 | Rake 0 
Board [2c Jd 3c Ks 6c]
Seat 1: star729 folded on the Flop
Seat 2: cebola77 folded before Flop (didn't bet)
Seat 3: Pekkosaurus folded before Flop (didn't bet)
Seat 4: -UNREGPRE- folded before Flop (didn't bet)
Seat 5: carlostrend showed [Jc Tc] and won (8665) with a flush, Jack high
Seat 6: The39player (button) folded before Flop (didn't bet)
Seat 8: top@pokker (small blind) folded before Flop
Seat 9: cruiser5917 (big blind) showed [9s Jh] and lost with a pair of Jacks



PokerStars Hand #157575236070: Tournament #1641817620, $7.50+$7.50+$1.50 USD Hold'em No Limit - Level I (15/30) - 2016/08/21 18:34:40 ET
Table '1641817620 20' 9-max Seat #3 is the button
Seat 1: Showdown pl (4990 in chips) 
Seat 2: tomus_ero (6831 in chips) 
Seat 3: Tiffany8888 (4780 in chips) 
Seat 4: brainpleaser (4288 in chips) 
Seat 5: msantos0123 (4990 in chips) 
Seat 6: TuckYouIn (4660 in chips) 
Seat 7: anniczka (6274 in chips) 
Seat 8: profChaos780 (4468 in chips) 
Seat 9: chezzetcook2 (3719 in chips) 
Showdown pl: posts the ante 5
tomus_ero: posts the ante 5
Tiffany8888: posts the ante 5
brainpleaser: posts the ante 5
msantos0123: posts the ante 5
TuckYouIn: posts the ante 5
anniczka: posts the ante 5
profChaos780: posts the ante 5
chezzetcook2: posts the ante 5
brainpleaser: posts small blind 15
msantos0123: posts big blind 30
*** HOLE CARDS ***
TuckYouIn: folds 
anniczka has timed out while disconnected
anniczka: folds 
anniczka is sitting out
profChaos780: folds 
chezzetcook2: folds 
Showdown pl: raises 37 to 67
tomus_ero: folds 
Tiffany8888: folds 
brainpleaser: calls 52
msantos0123: folds 
*** FLOP *** [Ac 3d 6d]
brainpleaser: bets 210
Showdown pl: calls 210
*** TURN *** [Ac 3d 6d] [Jd]
brainpleaser: bets 210
Showdown pl: calls 210
*** RIVER *** [Ac 3d 6d Jd] [Tc]
brainpleaser: bets 210
Showdown pl: raises 570 to 780
brainpleaser: folds 
Uncalled bet (570) returned to Showdown pl
Showdown pl collected 1469 from pot
Showdown pl: doesn't show hand 
*** SUMMARY ***
Total pot 1469 | Rake 0 
Board [Ac 3d 6d Jd Tc]
Seat 1: Showdown pl collected (1469)
Seat 2: tomus_ero folded before Flop (didn't bet)
Seat 3: Tiffany8888 (button) folded before Flop (didn't bet)
Seat 4: brainpleaser (small blind) folded on the River
Seat 5: msantos0123 (big blind) folded before Flop
Seat 6: TuckYouIn folded before Flop (didn't bet)
Seat 7: anniczka folded before Flop (didn't bet)
Seat 8: profChaos780 folded before Flop (didn't bet)
Seat 9: chezzetcook2 folded before Flop (didn't bet)



PokerStars Hand #157575236560: Tournament #1641817620, $7.50+$7.50+$1.50 USD Hold'em No Limit - Level I (15/30) - 2016/08/21 18:34:41 ET
Table '1641817620 2' 9-max Seat #6 is the button
Seat 1: ChaCha121 (3150 in chips) 
Seat 2: T8yourmoney (4965 in chips) 
Seat 3: mvpalls (4575 in chips) 
Seat 4: Juniorjbm28 (4995 in chips) 
Seat 5: junkshow#1 (4935 in chips) 
Seat 6: Vstoinov (4620 in chips) 
Seat 7: GreenDja (4950 in chips) 
Seat 8: BckDoorFlux (5005 in chips) 
Seat 9: LeaD25 (8020 in chips) 
ChaCha121: posts the ante 5
T8yourmoney: posts the ante 5
mvpalls: posts the ante 5
Juniorjbm28: posts the ante 5
junkshow#1: posts the ante 5
Vstoinov: posts the ante 5
GreenDja: posts the ante 5
BckDoorFlux: posts the ante 5
LeaD25: posts the ante 5
GreenDja: posts small blind 15
BckDoorFlux: posts big blind 30
*** HOLE CARDS ***
LeaD25: folds 
ChaCha121: folds 
T8yourmoney: raises 30 to 60
mvpalls: folds 
Juniorjbm28: folds 
junkshow#1: calls 60
Vstoinov: calls 60
GreenDja: folds 
BckDoorFlux: calls 30
*** FLOP *** [Qh Ac Ah]
BckDoorFlux: checks 
T8yourmoney: checks 
junkshow#1: bets 300
Vstoinov: folds 
BckDoorFlux: folds 
T8yourmoney: calls 300
*** TURN *** [Qh Ac Ah] [4d]
T8yourmoney: checks 
junkshow#1: bets 600
T8yourmoney: calls 600
*** RIVER *** [Qh Ac Ah 4d] [2h]
T8yourmoney: checks 
junkshow#1: checks 
*** SHOW DOWN ***
T8yourmoney: shows [Qs Kd] (two pair, Aces and Queens)
junkshow#1: mucks hand 
T8yourmoney collected 2100 from pot
*** SUMMARY ***
Total pot 2100 | Rake 0 
Board [Qh Ac Ah 4d 2h]
Seat 1: ChaCha121 folded before Flop (didn't bet)
Seat 2: T8yourmoney showed [Qs Kd] and won (2100) with two pair, Aces and Queens
Seat 3: mvpalls folded before Flop (didn't bet)
Seat 4: Juniorjbm28 folded before Flop (didn't bet)
Seat 5: junkshow#1 mucked
Seat 6: Vstoinov (button) folded on the Flop
Seat 7: GreenDja (small blind) folded before Flop
Seat 8: BckDoorFlux (big blind) folded on the Flop
Seat 9: LeaD25 folded before Flop (didn't bet)



PokerStars Hand #157575237368: Tournament #1641817620, $7.50+$7.50+$1.50 USD Hold'em No Limit - Level I (15/30) - 2016/08/21 18:34:42 ET
Table '1641817620 41' 9-max Seat #4 is the button
Seat 1: vettecha (4835 in chips) 
Seat 2: ARAVNOA (4970 in chips) 
Seat 3: FlaxonJin (5330 in chips) 
Seat 4: gigibaston (4940 in chips) 
Seat 5: Jujubh (4599 in chips) 
Seat 6: Matiellão (4985 in chips) 
Seat 7: MayFuNg1979 (5431 in chips) 
Seat 8: relmat (7106 in chips) 
Seat 9: Gwermort (2804 in chips) 
vettecha: posts the ante 5
ARAVNOA: posts the ante 5
FlaxonJin: posts the ante 5
gigibaston: posts the ante 5
Jujubh: posts the ante 5
Matiellão: posts the ante 5
MayFuNg1979: posts the ante 5
relmat: posts the ante 5
Gwermort: posts the ante 5
Jujubh: posts small blind 15
Matiellão: posts big blind 30
*** HOLE CARDS ***
MayFuNg1979: folds 
relmat: folds 
Gwermort: folds 
vettecha: folds 
ARAVNOA: folds 
FlaxonJin: folds 
gigibaston: raises 30 to 60
Jujubh: folds 
Matiellão: calls 30
*** FLOP *** [4d 3c 5d]
Matiellão: checks 
gigibaston: checks 
*** TURN *** [4d 3c 5d] [2s]
Matiellão: bets 120
gigibaston: folds 
Uncalled bet (120) returned to Matiellão
Matiellão collected 180 from pot
*** SUMMARY ***
Total pot 180 | Rake 0 
Board [4d 3c 5d 2s]
Seat 1: vettecha folded before Flop (didn't bet)
Seat 2: ARAVNOA folded before Flop (didn't bet)
Seat 3: FlaxonJin folded before Flop (didn't bet)
Seat 4: gigibaston (button) folded on the Turn
Seat 5: Jujubh (small blind) folded before Flop
Seat 6: Matiellão (big blind) collected (180)
Seat 7: MayFuNg1979 folded before Flop (didn't bet)
Seat 8: relmat folded before Flop (didn't bet)
Seat 9: Gwermort folded before Flop (didn't bet)



PokerStars Hand #157575237415: Tournament #1641817620, $7.50+$7.50+$1.50 USD Hold'em No Limit - Level I (15/30) - 2016/08/21 18:34:42 ET
Table '1641817620 15' 9-max Seat #7 is the button
Seat 1: WRussia (4800 in chips) 
Seat 2: miche1301 (5600 in chips) 
Seat 3: tsolias87 (5020 in chips) 
Seat 4: daveholden4 (4995 in chips) 
Seat 5: mdf92 (4590 in chips) 
Seat 6: aramio29 (5000 in chips) 
Seat 7: Yokiro (4665 in chips) 
Seat 8: Rob.nl (4680 in chips) 
Seat 9: mfalmeidacs (5430 in chips) 
WRussia: posts the ante 5
miche1301: posts the ante 5
tsolias87: posts the ante 5
daveholden4: posts the ante 5
mdf92: posts the ante 5
aramio29: posts the ante 5
Yokiro: posts the ante 5
Rob.nl: posts the ante 5
mfalmeidacs: posts the ante 5
Rob.nl: posts small blind 15
mfalmeidacs: posts big blind 30
*** HOLE CARDS ***
WRussia: folds 
miche1301: folds 
tsolias87: folds 
daveholden4: folds 
mdf92: folds 
aramio29: raises 36 to 66
Yokiro: folds 
Rob.nl: calls 51
mfalmeidacs: calls 36
*** FLOP *** [9c 3s 8s]
Rob.nl: checks 
mfalmeidacs: checks 
aramio29: checks 
*** TURN *** [9c 3s 8s] [8c]
Rob.nl: bets 143
mfalmeidacs: raises 337 to 480
aramio29: folds 
Rob.nl: calls 337
*** RIVER *** [9c 3s 8s 8c] [5h]
Rob.nl: checks 
mfalmeidacs: bets 870
Rob.nl: calls 870
*** SHOW DOWN ***
mfalmeidacs: shows [7d 8d] (three of a kind, Eights)
Rob.nl: mucks hand 
mfalmeidacs collected 2943 from pot
*** SUMMARY ***
Total pot 2943 | Rake 0 
Board [9c 3s 8s 8c 5h]
Seat 1: WRussia folded before Flop (didn't bet)
Seat 2: miche1301 folded before Flop (didn't bet)
Seat 3: tsolias87 folded before Flop (didn't bet)
Seat 4: daveholden4 folded before Flop (didn't bet)
Seat 5: mdf92 folded before Flop (didn't bet)
Seat 6: aramio29 folded on the Turn
Seat 7: Yokiro (button) folded before Flop (didn't bet)
Seat 8: Rob.nl (small blind) mucked
Seat 9: mfalmeidacs (big blind) showed [7d 8d] and won (2943) with three of a kind, Eights



PokerStars Hand #157575238927: Tournament #1641817620, $7.50+$7.50+$1.50 USD Hold'em No Limit - Level I (15/30) - 2016/08/21 18:34:45 ET
Table '1641817620 16' 9-max Seat #9 is the button
Seat 1: crewzer_08 (5000 in chips) out of hand (moved from another table into small blind)
Seat 2: Sergei0384 (5046 in chips) 
Seat 3: paschalisbg (4920 in chips) 
Seat 4: Maisiewin (4824 in chips) 
Seat 5: alemaozl (4920 in chips) 
Seat 6: Luis Reye837 (4990 in chips) 
Seat 7: burton14 (5180 in chips) 
Seat 8: Miky_Man993 (4830 in chips) 
Seat 9: ziboin (5130 in chips) 
Sergei0384: posts the ante 5
paschalisbg: posts the ante 5
Maisiewin: posts the ante 5
alemaozl: posts the ante 5
Luis Reye837: posts the ante 5
burton14: posts the ante 5
Miky_Man993: posts the ante 5
ziboin: posts the ante 5
Sergei0384: posts small blind 15
paschalisbg: posts big blind 30
*** HOLE CARDS ***
Maisiewin: raises 43 to 73
alemaozl: folds 
Luis Reye837: folds 
burton14: folds 
Miky_Man993: folds 
ziboin: calls 73
Sergei0384: folds 
paschalisbg: folds 
*** FLOP *** [5d 7c Ad]
Maisiewin: bets 115
ziboin: folds 
Uncalled bet (115) returned to Maisiewin
Maisiewin collected 231 from pot
Maisiewin: doesn't show hand 
*** SUMMARY ***
Total pot 231 | Rake 0 
Board [5d 7c Ad]
Seat 2: Sergei0384 (small blind) folded before Flop
Seat 3: paschalisbg (big blind) folded before Flop
Seat 4: Maisiewin collected (231)
Seat 5: alemaozl folded before Flop (didn't bet)
Seat 6: Luis Reye837 folded before Flop (didn't bet)
Seat 7: burton14 folded before Flop (didn't bet)
Seat 8: Miky_Man993 folded before Flop (didn't bet)
Seat 9: ziboin (button) folded on the Flop



PokerStars Hand #157575239394: Tournament #1641817620, $7.50+$7.50+$1.50 USD Hold'em No Limit - Level I (15/30) - 2016/08/21 18:34:45 ET
Table '1641817620 30' 9-max Seat #5 is the button
Seat 1: riginvl (4985 in chips) 
Seat 2: flashesflash (4955 in chips) 
Seat 3: Drogbaaaaaaa (4925 in chips) 
Seat 4: staplesking (5000 in chips) 
Seat 5: islidur99 (5875 in chips) 
Seat 6: jeanjrg1 (4955 in chips) 
Seat 7: GazRaz21 (4015 in chips) 
Seat 8: karlson1986 (5340 in chips) 
Seat 9: YNWA UA (4955 in chips) 
riginvl: posts the ante 5
flashesflash: posts the ante 5
Drogbaaaaaaa: posts the ante 5
staplesking: posts the ante 5
islidur99: posts the ante 5
jeanjrg1: posts the ante 5
GazRaz21: posts the ante 5
karlson1986: posts the ante 5
YNWA UA: posts the ante 5
jeanjrg1: posts small blind 15
GazRaz21: posts big blind 30
*** HOLE CARDS ***
karlson1986: folds 
YNWA UA: folds 
riginvl: folds 
flashesflash: folds 
Drogbaaaaaaa: folds 
staplesking: raises 30 to 60
islidur99: raises 210 to 270
jeanjrg1: folds 
GazRaz21: folds 
staplesking: calls 210
*** FLOP *** [6c 4d Jh]
staplesking: checks 
islidur99: bets 330
staplesking: calls 330
*** TURN *** [6c 4d Jh] [4s]
staplesking: checks 
islidur99: bets 630
staplesking: calls 630
*** RIVER *** [6c 4d Jh 4s] [5c]
staplesking: checks 
islidur99: bets 2220
staplesking: calls 2220
*** SHOW DOWN ***
islidur99: shows [4c Ac] (three of a kind, Fours)
staplesking: mucks hand 
islidur99 collected 6990 from pot
*** SUMMARY ***
Total pot 6990 | Rake 0 
Board [6c 4d Jh 4s 5c]
Seat 1: riginvl folded before Flop (didn't bet)
Seat 2: flashesflash folded before Flop (didn't bet)
Seat 3: Drogbaaaaaaa folded before Flop (didn't bet)
Seat 4: staplesking mucked
Seat 5: islidur99 (button) showed [4c Ac] and won (6990) with three of a kind, Fours
Seat 6: jeanjrg1 (small blind) folded before Flop
Seat 7: GazRaz21 (big blind) folded before Flop
Seat 8: karlson1986 folded before Flop (didn't bet)
Seat 9: YNWA UA folded before Flop (didn't bet)



PokerStars Hand #157575239705: Tournament #1641817620, $7.50+$7.50+$1.50 USD Hold'em No Limit - Level I (15/30) - 2016/08/21 18:34:46 ET
Table '1641817620 45' 9-max Seat #4 is the button
Seat 1: rocky 7 (4775 in chips) 
Seat 2: ldf58 (5480 in chips) 
Seat 3: LifFtD (4820 in chips) 
Seat 4: Grasquet (5802 in chips) 
Seat 5: Mr.Bob-su (2233 in chips) 
Seat 6: CHIT4 (4985 in chips) 
Seat 7: R4ID3R12 (4985 in chips) 
Seat 8: mrbandito27 (4895 in chips) 
Seat 9: Andre Ortega (7025 in chips) 
rocky 7: posts the ante 5
ldf58: posts the ante 5
LifFtD: posts the ante 5
Grasquet: posts the ante 5
Mr.Bob-su: posts the ante 5
CHIT4: posts the ante 5
R4ID3R12: posts the ante 5
mrbandito27: posts the ante 5
Andre Ortega: posts the ante 5
Mr.Bob-su: posts small blind 15
CHIT4: posts big blind 30
*** HOLE CARDS ***
R4ID3R12: folds 
mrbandito27: folds 
Andre Ortega: raises 30 to 60
rocky 7: calls 60
ldf58: calls 60
LifFtD: folds 
Grasquet: folds 
Mr.Bob-su: calls 45
CHIT4: folds 
*** FLOP *** [3h 6s 9d]
Mr.Bob-su: checks 
Andre Ortega: checks 
rocky 7: bets 150
ldf58: calls 150
Mr.Bob-su: folds 
Andre Ortega: calls 150
*** TURN *** [3h 6s 9d] [Qc]
Andre Ortega: checks 
rocky 7: bets 420
ldf58: calls 420
Andre Ortega: calls 420
*** RIVER *** [3h 6s 9d Qc] [Ts]
Andre Ortega: checks 
rocky 7: checks 
ldf58: checks 
*** SHOW DOWN ***
Andre Ortega: shows [5h 7h] (high card Queen)
rocky 7: shows [7c 6c] (a pair of Sixes)
ldf58: shows [9h Js] (a pair of Nines)
ldf58 collected 2025 from pot
*** SUMMARY ***
Total pot 2025 | Rake 0 
Board [3h 6s 9d Qc Ts]
Seat 1: rocky 7 showed [7c 6c] and lost with a pair of Sixes
Seat 2: ldf58 showed [9h Js] and won (2025) with a pair of Nines
Seat 3: LifFtD folded before Flop (didn't bet)
Seat 4: Grasquet (button) folded before Flop (didn't bet)
Seat 5: Mr.Bob-su (small blind) folded on the Flop
Seat 6: CHIT4 (big blind) folded before Flop
Seat 7: R4ID3R12 folded before Flop (didn't bet)
Seat 8: mrbandito27 folded before Flop (didn't bet)
Seat 9: Andre Ortega showed [5h 7h] and lost with high card Queen



PokerStars Hand #157575240172: Tournament #1641817620, $7.50+$7.50+$1.50 USD Hold'em No Limit - Level I (15/30) - 2016/08/21 18:34:47 ET
Table '1641817620 24' 9-max Seat #6 is the button
Seat 1: heyyy presto (5560 in chips) 
Seat 2: BOW300 (4885 in chips) 
Seat 3: muskto (4765 in chips) 
Seat 4: jt3x87 (4855 in chips) 
Seat 5: PhaniaX (4709 in chips) 
Seat 6: pisti801 (5331 in chips) 
Seat 7: Pokemongo007 (5000 in chips) out of hand (moved from another table into small blind)
Seat 8: trabey (4805 in chips) 
Seat 9: Quickcard (4945 in chips) 
heyyy presto: posts the ante 5
BOW300: posts the ante 5
muskto: posts the ante 5
jt3x87: posts the ante 5
PhaniaX: posts the ante 5
pisti801: posts the ante 5
trabey: posts the ante 5
Quickcard: posts the ante 5
trabey: posts small blind 15
Quickcard: posts big blind 30
*** HOLE CARDS ***
heyyy presto: folds 
BOW300: raises 90 to 120
muskto: raises 325 to 445
jt3x87: folds 
PhaniaX: folds 
pisti801: folds 
trabey: folds 
Quickcard: calls 415
BOW300: calls 325
*** FLOP *** [6d 8h Tc]
Quickcard: checks 
BOW300: checks 
muskto: bets 695
Quickcard: folds 
BOW300: calls 695
*** TURN *** [6d 8h Tc] [As]
BOW300: checks 
muskto: bets 1390
BOW300: calls 1390
*** RIVER *** [6d 8h Tc As] [7d]
BOW300: checks 
muskto: bets 2230 and is all-in
BOW300: folds 
Uncalled bet (2230) returned to muskto
muskto collected 5560 from pot
muskto: doesn't show hand 
*** SUMMARY ***
Total pot 5560 | Rake 0 
Board [6d 8h Tc As 7d]
Seat 1: heyyy presto folded before Flop (didn't bet)
Seat 2: BOW300 folded on the River
Seat 3: muskto collected (5560)
Seat 4: jt3x87 folded before Flop (didn't bet)
Seat 5: PhaniaX folded before Flop (didn't bet)
Seat 6: pisti801 (button) folded before Flop (didn't bet)
Seat 8: trabey (small blind) folded before Flop
Seat 9: Quickcard (big blind) folded on the Flop



PokerStars Hand #157575240578: Tournament #1641817620, $7.50+$7.50+$1.50 USD Hold'em No Limit - Level I (15/30) - 2016/08/21 18:34:47 ET
Table '1641817620 14' 9-max Seat #4 is the button
Seat 1: japazzz1001 (4985 in chips) 
Seat 2: zigolo77 (5270 in chips) 
Seat 3: $Koha$88 (4880 in chips) 
Seat 4: Ed_brisal (5015 in chips) 
Seat 5: kashlaw (4930 in chips) 
Seat 6: sweetlips6 (4557 in chips) 
Seat 7: zerowiec (5393 in chips) 
Seat 8: tim_pro_405! (4985 in chips) 
Seat 9: bacibaci67 (4985 in chips) 
japazzz1001: posts the ante 5
zigolo77: posts the ante 5
$Koha$88: posts the ante 5
Ed_brisal: posts the ante 5
kashlaw: posts the ante 5
sweetlips6: posts the ante 5
zerowiec: posts the ante 5
tim_pro_405!: posts the ante 5
bacibaci67: posts the ante 5
kashlaw: posts small blind 15
sweetlips6: posts big blind 30
*** HOLE CARDS ***
zerowiec: folds 
tim_pro_405!: folds 
bacibaci67: raises 60 to 90
japazzz1001: folds 
zigolo77: folds 
$Koha$88: folds 
Ed_brisal: folds 
kashlaw: folds 
sweetlips6: folds 
Uncalled bet (60) returned to bacibaci67
bacibaci67 collected 120 from pot
*** SUMMARY ***
Total pot 120 | Rake 0 
Seat 1: japazzz1001 folded before Flop (didn't bet)
Seat 2: zigolo77 folded before Flop (didn't bet)
Seat 3: $Koha$88 folded before Flop (didn't bet)
Seat 4: Ed_brisal (button) folded before Flop (didn't bet)
Seat 5: kashlaw (small blind) folded before Flop
Seat 6: sweetlips6 (big blind) folded before Flop
Seat 7: zerowiec folded before Flop (didn't bet)
Seat 8: tim_pro_405! folded before Flop (didn't bet)
Seat 9: bacibaci67 collected (120)



PokerStars Hand #157575243047: Tournament #1641817620, $7.50+$7.50+$1.50 USD Hold'em No Limit - Level I (15/30) - 2016/08/21 18:34:51 ET
Table '1641817620 40' 9-max Seat #6 is the button
Seat 1: Shiryu100 (4975 in chips) 
Seat 2: nico122527 (4930 in chips) 
Seat 3: ilico (5394 in chips) 
Seat 4: Mr_Giiba (5035 in chips) 
Seat 5: mario342 (5125 in chips) 
Seat 6: MON3Y$HOT (5230 in chips) 
Seat 7: hyratsch (4361 in chips) 
Seat 9: kafu123 (4975 in chips) is sitting out
Shiryu100: posts the ante 5
nico122527: posts the ante 5
ilico: posts the ante 5
Mr_Giiba: posts the ante 5
mario342: posts the ante 5
MON3Y$HOT: posts the ante 5
hyratsch: posts the ante 5
kafu123: posts the ante 5
hyratsch: posts small blind 15
kafu123: posts big blind 30
*** HOLE CARDS ***
Shiryu100: folds 
nico122527: folds 
ilico: folds 
Mr_Giiba: folds 
mario342: folds 
MON3Y$HOT: folds 
hyratsch: calls 15
kafu123: folds 
hyratsch collected 100 from pot
*** SUMMARY ***
Total pot 100 | Rake 0 
Seat 1: Shiryu100 folded before Flop (didn't bet)
Seat 2: nico122527 folded before Flop (didn't bet)
Seat 3: ilico folded before Flop (didn't bet)
Seat 4: Mr_Giiba folded before Flop (didn't bet)
Seat 5: mario342 folded before Flop (didn't bet)
Seat 6: MON3Y$HOT (button) folded before Flop (didn't bet)
Seat 7: hyratsch (small blind) collected (100)
Seat 9: kafu123 (big blind) folded before Flop



PokerStars Hand #157575243081: Tournament #1641817620, $7.50+$7.50+$1.50 USD Hold'em No Limit - Level I (15/30) - 2016/08/21 18:34:51 ET
Table '1641817620 58' 9-max Seat #4 is the button
Seat 1: bld66 (4655 in chips) 
Seat 2: FACEBUHH (7235 in chips) 
Seat 3: CFgabriel (4940 in chips) 
Seat 4: nejirose (4940 in chips) 
Seat 5: pokercr7721 (4955 in chips) 
Seat 7: I_R0B0T_90 (4985 in chips) 
Seat 8: lovebigpairs (2795 in chips) 
Seat 9: binho1806 (5510 in chips) 
bld66: posts the ante 5
FACEBUHH: posts the ante 5
CFgabriel: posts the ante 5
nejirose: posts the ante 5
pokercr7721: posts the ante 5
I_R0B0T_90: posts the ante 5
lovebigpairs: posts the ante 5
binho1806: posts the ante 5
pokercr7721: posts small blind 15
I_R0B0T_90: posts big blind 30
*** HOLE CARDS ***
lovebigpairs: folds 
binho1806: folds 
bld66: folds 
FACEBUHH: calls 30
CFgabriel: folds 
nejirose: folds 
pokercr7721: raises 180 to 210
I_R0B0T_90: folds 
FACEBUHH: folds 
Uncalled bet (180) returned to pokercr7721
pokercr7721 collected 130 from pot
pokercr7721: doesn't show hand 
*** SUMMARY ***
Total pot 130 | Rake 0 
Seat 1: bld66 folded before Flop (didn't bet)
Seat 2: FACEBUHH folded before Flop
Seat 3: CFgabriel folded before Flop (didn't bet)
Seat 4: nejirose (button) folded before Flop (didn't bet)
Seat 5: pokercr7721 (small blind) collected (130)
Seat 7: I_R0B0T_90 (big blind) folded before Flop
Seat 8: lovebigpairs folded before Flop (didn't bet)
Seat 9: binho1806 folded before Flop (didn't bet)



PokerStars Hand #157575244765: Tournament #1641817620, $7.50+$7.50+$1.50 USD Hold'em No Limit - Level I (15/30) - 2016/08/21 18:34:54 ET
Table '1641817620 46' 9-max Seat #5 is the button
Seat 1: Kotakera (4813 in chips) 
Seat 2: estebangocu (4965 in chips) 
Seat 3: butler992 (4875 in chips) 
Seat 4: ZuzanaM (4935 in chips) 
Seat 5: Koeike (4835 in chips) 
Seat 6: JohnJohnnnnn (5000 in chips) out of hand (moved from another table into small blind)
Seat 7: clavito691 (5616 in chips) 
Seat 8: Violetarose (5091 in chips) 
Seat 9: staknchips83 (4890 in chips) 
Kotakera: posts the ante 5
estebangocu: posts the ante 5
butler992: posts the ante 5
ZuzanaM: posts the ante 5
Koeike: posts the ante 5
clavito691: posts the ante 5
Violetarose: posts the ante 5
staknchips83: posts the ante 5
clavito691: posts small blind 15
Violetarose: posts big blind 30
*** HOLE CARDS ***
staknchips83: raises 60 to 90
Kotakera: folds 
estebangocu: calls 90
butler992: folds 
ZuzanaM: folds 
Koeike: folds 
clavito691: folds 
Violetarose: raises 4996 to 5086 and is all-in
staknchips83: calls 4795 and is all-in
estebangocu: folds 
Uncalled bet (201) returned to Violetarose
*** FLOP *** [6d 8h Td]
Kotakera is disconnected 
*** TURN *** [6d 8h Td] [4s]
*** RIVER *** [6d 8h Td 4s] [Th]
*** SHOW DOWN ***
Violetarose: shows [Qd Qs] (two pair, Queens and Tens)
staknchips83: shows [Kh As] (a pair of Tens)
Violetarose collected 9915 from pot
Violetarose wins $3.75 for eliminating staknchips83 and their own bounty increases by $3.75 to $11.25
staknchips83 finished the tournament in 999999986th place
*** SUMMARY ***
Total pot 9915 | Rake 0 
Board [6d 8h Td 4s Th]
Seat 1: Kotakera folded before Flop (didn't bet)
Seat 2: estebangocu folded before Flop
Seat 3: butler992 folded before Flop (didn't bet)
Seat 4: ZuzanaM folded before Flop (didn't bet)
Seat 5: Koeike (button) folded before Flop (didn't bet)
Seat 7: clavito691 (small blind) folded before Flop
Seat 8: Violetarose (big blind) showed [Qd Qs] and won (9915) with two pair, Queens and Tens
Seat 9: staknchips83 showed [Kh As] and lost with a pair of Tens



PokerStars Hand #157575244884: Tournament #1641817620, $7.50+$7.50+$1.50 USD Hold'em No Limit - Level I (15/30) - 2016/08/21 18:34:54 ET
Table '1641817620 12' 9-max Seat #5 is the button
Seat 1: Vlacerda (5119 in chips) 
Seat 2: aiaolinda (4365 in chips) 
Seat 3: faza29 (4886 in chips) 
Seat 4: Gottlieb007 (5145 in chips) 
Seat 5: ALEX-RSN (4920 in chips) 
Seat 6: MANJUS89 (4950 in chips) 
Seat 7: FUR4C40 (5000 in chips) 
Seat 8: CHARRUA1122 (5370 in chips) 
Seat 9: FrankLDrex (5745 in chips) 
Vlacerda: posts the ante 5
aiaolinda: posts the ante 5
faza29: posts the ante 5
Gottlieb007: posts the ante 5
ALEX-RSN: posts the ante 5
MANJUS89: posts the ante 5
FUR4C40: posts the ante 5
CHARRUA1122: posts the ante 5
FrankLDrex: posts the ante 5
MANJUS89: posts small blind 15
FUR4C40: posts big blind 30
*** HOLE CARDS ***
CHARRUA1122: calls 30
FrankLDrex: folds 
Vlacerda: folds 
aiaolinda: folds 
faza29: folds 
Gottlieb007: raises 120 to 150
ALEX-RSN: folds 
MANJUS89: calls 135
FUR4C40: folds 
CHARRUA1122: calls 120
*** FLOP *** [Tc Jh 4h]
MANJUS89: checks 
CHARRUA1122: checks 
Gottlieb007: bets 393
MANJUS89: calls 393
CHARRUA1122: calls 393
*** TURN *** [Tc Jh 4h] [8c]
MANJUS89: checks 
CHARRUA1122: checks 
Gottlieb007: bets 1140
MANJUS89: calls 1140
CHARRUA1122: raises 3682 to 4822 and is all-in
Gottlieb007: folds 
MANJUS89: folds 
Uncalled bet (3682) returned to CHARRUA1122
CHARRUA1122 collected 5124 from pot
*** SUMMARY ***
Total pot 5124 | Rake 0 
Board [Tc Jh 4h 8c]
Seat 1: Vlacerda folded before Flop (didn't bet)
Seat 2: aiaolinda folded before Flop (didn't bet)
Seat 3: faza29 folded before Flop (didn't bet)
Seat 4: Gottlieb007 folded on the Turn
Seat 5: ALEX-RSN (button) folded before Flop (didn't bet)
Seat 6: MANJUS89 (small blind) folded on the Turn
Seat 7: FUR4C40 (big blind) folded before Flop
Seat 8: CHARRUA1122 collected (5124)
Seat 9: FrankLDrex folded before Flop (didn't bet)



PokerStars Hand #157575245534: Tournament #1641817620, $7.50+$7.50+$1.50 USD Hold'em No Limit - Level I (15/30) - 2016/08/21 18:34:55 ET
Table '1641817620 5' 9-max Seat #8 is the button
Seat 1: rirage_87 (5000 in chips) 
Seat 2: jonesfi5sh (6040 in chips) 
Seat 3: PhenomPen1 (4915 in chips) 
Seat 4: GrimJoker77 (4970 in chips) 
Seat 5: Bolfra1 (4825 in chips) 
Seat 6: Javicho9 (4540 in chips) 
Seat 7: pokertepec (5000 in chips) 
Seat 8: sloty27 (4870 in chips) 
Seat 9: chuny dealer (4735 in chips) 
rirage_87: posts the ante 5
jonesfi5sh: posts the ante 5
PhenomPen1: posts the ante 5
GrimJoker77: posts the ante 5
Bolfra1: posts the ante 5
Javicho9: posts the ante 5
pokertepec: posts the ante 5
sloty27: posts the ante 5
chuny dealer: posts the ante 5
chuny dealer: posts small blind 15
rirage_87: posts big blind 30
*** HOLE CARDS ***
jonesfi5sh: folds 
PhenomPen1: raises 45 to 75
GrimJoker77: folds 
Bolfra1: folds 
Javicho9: folds 
pokertepec: folds 
sloty27: folds 
chuny dealer: calls 60
rirage_87: calls 45
*** FLOP *** [7s 7c Qc]
chuny dealer: checks 
rirage_87: checks 
PhenomPen1: bets 121
chuny dealer: folds 
rirage_87: folds 
Uncalled bet (121) returned to PhenomPen1
PhenomPen1 collected 270 from pot
*** SUMMARY ***
Total pot 270 | Rake 0 
Board [7s 7c Qc]
Seat 1: rirage_87 (big blind) folded on the Flop
Seat 2: jonesfi5sh folded before Flop (didn't bet)
Seat 3: PhenomPen1 collected (270)
Seat 4: GrimJoker77 folded before Flop (didn't bet)
Seat 5: Bolfra1 folded before Flop (didn't bet)
Seat 6: Javicho9 folded before Flop (didn't bet)
Seat 7: pokertepec folded before Flop (didn't bet)
Seat 8: sloty27 (button) folded before Flop (didn't bet)
Seat 9: chuny dealer (small blind) folded on the Flop



PokerStars Hand #157575246154: Tournament #1641817620, $7.50+$7.50+$1.50 USD Hold'em No Limit - Level I (15/30) - 2016/08/21 18:34:56 ET
Table '1641817620 44' 9-max Seat #9 is the button
Seat 1: BurrGrylls (4935 in chips) 
Seat 2: moisesgosu (4541 in chips) 
Seat 3: kduwork (5137 in chips) 
Seat 4: starkstud (5100 in chips) 
Seat 5: rbcowboy27 (4985 in chips) 
Seat 6: lesley hu (4920 in chips) is sitting out
Seat 7: ongggg (4893 in chips) 
Seat 8: heynow21 (4934 in chips) 
Seat 9: Pro_Tunis (5670 in chips) 
BurrGrylls: posts the ante 5
moisesgosu: posts the ante 5
kduwork: posts the ante 5
starkstud: posts the ante 5
rbcowboy27: posts the ante 5
lesley hu: posts the ante 5
ongggg: posts the ante 5
heynow21: posts the ante 5
Pro_Tunis: posts the ante 5
BurrGrylls: posts small blind 15
moisesgosu: posts big blind 30
*** HOLE CARDS ***
kduwork: folds 
starkstud: folds 
rbcowboy27: raises 60 to 90
lesley hu: folds 
ongggg: folds 
heynow21: calls 90
Pro_Tunis: folds 
BurrGrylls: calls 75
moisesgosu: folds 
*** FLOP *** [Ts Jc 3s]
BurrGrylls: checks 
rbcowboy27: bets 172
heynow21: calls 172
BurrGrylls: folds 
*** TURN *** [Ts Jc 3s] [Qd]
rbcowboy27: bets 450
heynow21: calls 450
*** RIVER *** [Ts Jc 3s Qd] [2d]
rbcowboy27: bets 1230
heynow21: calls 1230
*** SHOW DOWN ***
rbcowboy27: shows [Jd Jh] (three of a kind, Jacks)
heynow21: mucks hand 
rbcowboy27 collected 4049 from pot
*** SUMMARY ***
Total pot 4049 | Rake 0 
Board [Ts Jc 3s Qd 2d]
Seat 1: BurrGrylls (small blind) folded on the Flop
Seat 2: moisesgosu (big blind) folded before Flop
Seat 3: kduwork folded before Flop (didn't bet)
Seat 4: starkstud folded before Flop (didn't bet)
Seat 5: rbcowboy27 showed [Jd Jh] and won (4049) with three of a kind, Jacks
Seat 6: lesley hu folded before Flop (didn't bet)
Seat 7: ongggg folded before Flop (didn't bet)
Seat 8: heynow21 mucked
Seat 9: Pro_Tunis (button) folded before Flop (didn't bet)



PokerStars Hand #157575247652: Tournament #1641817620, $7.50+$7.50+$1.50 USD Hold'em No Limit - Level I (15/30) - 2016/08/21 18:34:58 ET
Table '1641817620 55' 9-max Seat #6 is the button
Seat 1: M Patoine (4905 in chips) 
Seat 2: HayArro (4885 in chips) 
Seat 3: MaxPips (4870 in chips) 
Seat 4: furia75205 (4930 in chips) 
Seat 5: hoolzky (4840 in chips) 
Seat 6: B.Paulino (4930 in chips) 
Seat 7: xLewie (5350 in chips) 
Seat 9: igara tigara (5155 in chips) 
M Patoine: posts the ante 5
HayArro: posts the ante 5
MaxPips: posts the ante 5
furia75205: posts the ante 5
hoolzky: posts the ante 5
B.Paulino: posts the ante 5
xLewie: posts the ante 5
igara tigara: posts the ante 5
xLewie: posts small blind 15
igara tigara: posts big blind 30
*** HOLE CARDS ***
M Patoine: raises 90 to 120
HayArro: folds 
MaxPips: folds 
furia75205: folds 
hoolzky: folds 
B.Paulino: folds 
xLewie: calls 105
igara tigara: calls 90
*** FLOP *** [Th 5s 9c]
xLewie: checks 
igara tigara: checks 
M Patoine: checks 
*** TURN *** [Th 5s 9c] [Ad]
xLewie: checks 
igara tigara: checks 
M Patoine: checks 
*** RIVER *** [Th 5s 9c Ad] [6c]
xLewie: bets 240
igara tigara: folds 
M Patoine: folds 
Uncalled bet (240) returned to xLewie
xLewie collected 400 from pot
xLewie: doesn't show hand 
*** SUMMARY ***
Total pot 400 | Rake 0 
Board [Th 5s 9c Ad 6c]
Seat 1: M Patoine folded on the River
Seat 2: HayArro folded before Flop (didn't bet)
Seat 3: MaxPips folded before Flop (didn't bet)
Seat 4: furia75205 folded before Flop (didn't bet)
Seat 5: hoolzky folded before Flop (didn't bet)
Seat 6: B.Paulino (button) folded before Flop (didn't bet)
Seat 7: xLewie (small blind) collected (400)
Seat 9: igara tigara (big blind) folded on the River



PokerStars Hand #157575247776: Tournament #1641817620, $7.50+$7.50+$1.50 USD Hold'em No Limit - Level I (15/30) - 2016/08/21 18:34:58 ET
Table '1641817620 7' 9-max Seat #8 is the button
Seat 2: ricar1749 (4975 in chips) 
Seat 3: Steve G009 (4960 in chips) 
Seat 4: nbmom (4870 in chips) 
Seat 5: bernardijack (5140 in chips) 
Seat 6: POKEMONSTRO (5042 in chips) 
Seat 7: NemeanDanny (5030 in chips) 
Seat 8: Original02 (5315 in chips) 
Seat 9: cjgarceau (4848 in chips) 
ricar1749: posts the ante 5
Steve G009: posts the ante 5
nbmom: posts the ante 5
bernardijack: posts the ante 5
POKEMONSTRO: posts the ante 5
NemeanDanny: posts the ante 5
Original02: posts the ante 5
cjgarceau: posts the ante 5
cjgarceau: posts small blind 15
ricar1749: posts big blind 30
*** HOLE CARDS ***
Steve G009: folds 
nbmom: folds 
bernardijack: folds 
POKEMONSTRO: folds 
NemeanDanny: folds 
Original02: folds 
cjgarceau: raises 30 to 60
ricar1749: raises 150 to 210
cjgarceau: calls 150
*** FLOP *** [Kc As Jc]
cjgarceau: checks 
ricar1749: bets 220
cjgarceau: folds 
Uncalled bet (220) returned to ricar1749
ricar1749 collected 460 from pot
ricar1749: doesn't show hand 
*** SUMMARY ***
Total pot 460 | Rake 0 
Board [Kc As Jc]
Seat 2: ricar1749 (big blind) collected (460)
Seat 3: Steve G009 folded before Flop (didn't bet)
Seat 4: nbmom folded before Flop (didn't bet)
Seat 5: bernardijack folded before Flop (didn't bet)
Seat 6: POKEMONSTRO folded before Flop (didn't bet)
Seat 7: NemeanDanny folded before Flop (didn't bet)
Seat 8: Original02 (button) folded before Flop (didn't bet)
Seat 9: cjgarceau (small blind) folded on the Flop



PokerStars Hand #157575248086: Tournament #1641817620, $7.50+$7.50+$1.50 USD Hold'em No Limit - Level I (15/30) - 2016/08/21 18:34:59 ET
Table '1641817620 4' 9-max Seat #4 is the button
Seat 1: coldboy23 (4912 in chips) 
Seat 2: Velho Sábio (4477 in chips) 
Seat 3: manukk2 (5495 in chips) 
Seat 4: slk55amg (4102 in chips) 
Seat 5: sica26 (5302 in chips) 
Seat 7: AleksZy (4985 in chips) 
Seat 8: petersonmach (4985 in chips) 
Seat 9: DagobertQuad (4912 in chips) 
coldboy23: posts the ante 5
Velho Sábio: posts the ante 5
manukk2: posts the ante 5
slk55amg: posts the ante 5
sica26: posts the ante 5
AleksZy: posts the ante 5
petersonmach: posts the ante 5
DagobertQuad: posts the ante 5
sica26: posts small blind 15
AleksZy: posts big blind 30
*** HOLE CARDS ***
petersonmach: folds 
DagobertQuad: folds 
coldboy23: raises 60 to 90
Velho Sábio: folds 
manukk2: folds 
slk55amg: folds 
sica26: folds 
AleksZy: folds 
Uncalled bet (60) returned to coldboy23
coldboy23 collected 115 from pot
coldboy23: doesn't show hand 
*** SUMMARY ***
Total pot 115 | Rake 0 
Seat 1: coldboy23 collected (115)
Seat 2: Velho Sábio folded before Flop (didn't bet)
Seat 3: manukk2 folded before Flop (didn't bet)
Seat 4: slk55amg (button) folded before Flop (didn't bet)
Seat 5: sica26 (small blind) folded before Flop
Seat 7: AleksZy (big blind) folded before Flop
Seat 8: petersonmach folded before Flop (didn't bet)
Seat 9: DagobertQuad folded before Flop (didn't bet)



PokerStars Hand #157575248341: Tournament #1641817620, $7.50+$7.50+$1.50 USD Hold'em No Limit - Level I (15/30) - 2016/08/21 18:34:59 ET
Table '1641817620 34' 9-max Seat #6 is the button
Seat 2: AngelBerley (4615 in chips) 
Seat 3: Zigslick (4930 in chips) 
Seat 4: Snabers (4750 in chips) 
Seat 5: juggaletto (5470 in chips) 
Seat 6: virtus213 (4810 in chips) 
Seat 7: Poher42 (5230 in chips) 
Seat 8: S.FILTH (4975 in chips) 
Seat 9: omar miete (5245 in chips) 
AngelBerley: posts the ante 5
Zigslick: posts the ante 5
Snabers: posts the ante 5
juggaletto: posts the ante 5
virtus213: posts the ante 5
Poher42: posts the ante 5
S.FILTH: posts the ante 5
omar miete: posts the ante 5
Poher42: posts small blind 15
S.FILTH: posts big blind 30
*** HOLE CARDS ***
omar miete: raises 45 to 75
AngelBerley: folds 
Zigslick: folds 
Snabers: folds 
juggaletto: folds 
virtus213: calls 75
Poher42: folds 
S.FILTH: folds 
*** FLOP *** [6d 2s 4h]
omar miete: bets 120
virtus213: folds 
Uncalled bet (120) returned to omar miete
omar miete collected 235 from pot
*** SUMMARY ***
Total pot 235 | Rake 0 
Board [6d 2s 4h]
Seat 2: AngelBerley folded before Flop (didn't bet)
Seat 3: Zigslick folded before Flop (didn't bet)
Seat 4: Snabers folded before Flop (didn't bet)
Seat 5: juggaletto folded before Flop (didn't bet)
Seat 6: virtus213 (button) folded on the Flop
Seat 7: Poher42 (small blind) folded before Flop
Seat 8: S.FILTH (big blind) folded before Flop
Seat 9: omar miete collected (235)



PokerStars Hand #157575249149: Tournament #1641817620, $7.50+$7.50+$1.50 USD Hold'em No Limit - Level I (15/30) - 2016/08/21 18:35:00 ET
Table '1641817620 3' 9-max Seat #8 is the button
Seat 1: IwantplayNL (4508 in chips) 
Seat 2: dufino (7136 in chips) 
Seat 3: zIggY-7-rAc3 (5225 in chips) 
Seat 4: gerald0jr (4925 in chips) 
Seat 5: Arkadius1975 (4990 in chips) 
Seat 6: BrunoCastroR (2895 in chips) 
Seat 7: alehirazawa (4925 in chips) 
Seat 8: markosharko (5361 in chips) 
Seat 9: VictorZh14 (5045 in chips) 
IwantplayNL: posts the ante 5
dufino: posts the ante 5
zIggY-7-rAc3: posts the ante 5
gerald0jr: posts the ante 5
Arkadius1975: posts the ante 5
BrunoCastroR: posts the ante 5
alehirazawa: posts the ante 5
markosharko: posts the ante 5
VictorZh14: posts the ante 5
VictorZh14: posts small blind 15
IwantplayNL: posts big blind 30
*** HOLE CARDS ***
dufino: folds 
zIggY-7-rAc3: folds 
gerald0jr: folds 
Arkadius1975: folds 
BrunoCastroR: raises 60 to 90
alehirazawa: folds 
markosharko: folds 
VictorZh14: folds 
IwantplayNL: calls 60
*** FLOP *** [9h Ts Kd]
IwantplayNL: checks 
BrunoCastroR: bets 120
IwantplayNL: calls 120
*** TURN *** [9h Ts Kd] [7c]
IwantplayNL: checks 
BrunoCastroR: bets 240
IwantplayNL: calls 240
*** RIVER *** [9h Ts Kd 7c] [4s]
IwantplayNL: checks 
BrunoCastroR: checks 
*** SHOW DOWN ***
IwantplayNL: shows [Ks Jh] (a pair of Kings)
BrunoCastroR: mucks hand 
IwantplayNL collected 960 from pot
*** SUMMARY ***
Total pot 960 | Rake 0 
Board [9h Ts Kd 7c 4s]
Seat 1: IwantplayNL (big blind) showed [Ks Jh] and won (960) with a pair of Kings
Seat 2: dufino folded before Flop (didn't bet)
Seat 3: zIggY-7-rAc3 folded before Flop (didn't bet)
Seat 4: gerald0jr folded before Flop (didn't bet)
Seat 5: Arkadius1975 folded before Flop (didn't bet)
Seat 6: BrunoCastroR mucked
Seat 7: alehirazawa folded before Flop (didn't bet)
Seat 8: markosharko (button) folded before Flop (didn't bet)
Seat 9: VictorZh14 (small blind) folded before Flop



PokerStars Hand #157575249793: Tournament #1641817620, $7.50+$7.50+$1.50 USD Hold'em No Limit - Level I (15/30) - 2016/08/21 18:35:01 ET
Table '1641817620 33' 9-max Seat #9 is the button
Seat 1: fungyou (4935 in chips) 
Seat 2: titauhu (4337 in chips) 
Seat 3: gmdef.2001 (4920 in chips) 
Seat 4: natahha_92 (4980 in chips) 
Seat 5: T@keItDown (5005 in chips) 
Seat 6: REPPARTFLOW (5010 in chips) 
Seat 7: dennismitru (5100 in chips) 
Seat 8: Joao Valli (4920 in chips) 
Seat 9: Pablos701 (5798 in chips) 
fungyou: posts the ante 5
titauhu: posts the ante 5
gmdef.2001: posts the ante 5
natahha_92: posts the ante 5
T@keItDown: posts the ante 5
REPPARTFLOW: posts the ante 5
dennismitru: posts the ante 5
Joao Valli: posts the ante 5
Pablos701: posts the ante 5
fungyou: posts small blind 15
titauhu: posts big blind 30
*** HOLE CARDS ***
gmdef.2001: folds 
natahha_92: folds 
T@keItDown: folds 
REPPARTFLOW: folds 
dennismitru: raises 36 to 66
Joao Valli: calls 66
Pablos701: folds 
fungyou: folds 
titauhu: calls 36
*** FLOP *** [8s Tc 3s]
titauhu: bets 129
dennismitru: raises 170 to 299
Joao Valli: folds 
titauhu: calls 170
*** TURN *** [8s Tc 3s] [Ad]
titauhu: bets 120
dennismitru: raises 526 to 646
titauhu: calls 526
*** RIVER *** [8s Tc 3s Ad] [2h]
titauhu: checks 
dennismitru: bets 4084 and is all-in
titauhu: folds 
Uncalled bet (4084) returned to dennismitru
dennismitru collected 2148 from pot
*** SUMMARY ***
Total pot 2148 | Rake 0 
Board [8s Tc 3s Ad 2h]
Seat 1: fungyou (small blind) folded before Flop
Seat 2: titauhu (big blind) folded on the River
Seat 3: gmdef.2001 folded before Flop (didn't bet)
Seat 4: natahha_92 folded before Flop (didn't bet)
Seat 5: T@keItDown folded before Flop (didn't bet)
Seat 6: REPPARTFLOW folded before Flop (didn't bet)
Seat 7: dennismitru collected (2148)
Seat 8: Joao Valli folded on the Flop
Seat 9: Pablos701 (button) folded before Flop (didn't bet)



PokerStars Hand #157575250539: Tournament #1641817620, $7.50+$7.50+$1.50 USD Hold'em No Limit - Level I (15/30) - 2016/08/21 18:35:02 ET
Table '1641817620 22' 9-max Seat #7 is the button
Seat 1: iLvpoon (5000 in chips) 
Seat 2: hanshabraken (4995 in chips) 
Seat 3: CHININ118 (4589 in chips) 
Seat 4: Jaliplay (10100 in chips) 
Seat 5: hewx (10566 in chips) 
Seat 7: ogotop76 (4925 in chips) 
Seat 8: monterreymx (4850 in chips) 
Seat 9: cash4king (5000 in chips) 
iLvpoon: posts the ante 5
hanshabraken: posts the ante 5
CHININ118: posts the ante 5
Jaliplay: posts the ante 5
hewx: posts the ante 5
ogotop76: posts the ante 5
monterreymx: posts the ante 5
cash4king: posts the ante 5
monterreymx: posts small blind 15
cash4king: posts big blind 30
*** HOLE CARDS ***
iLvpoon: folds 
hanshabraken: folds 
CHININ118: folds 
Jaliplay: folds 
hewx: folds 
ogotop76: folds 
monterreymx: raises 60 to 90
cash4king: folds 
Uncalled bet (60) returned to monterreymx
monterreymx collected 100 from pot
*** SUMMARY ***
Total pot 100 | Rake 0 
Seat 1: iLvpoon folded before Flop (didn't bet)
Seat 2: hanshabraken folded before Flop (didn't bet)
Seat 3: CHININ118 folded before Flop (didn't bet)
Seat 4: Jaliplay folded before Flop (didn't bet)
Seat 5: hewx folded before Flop (didn't bet)
Seat 7: ogotop76 (button) folded before Flop (didn't bet)
Seat 8: monterreymx (small blind) collected (100)
Seat 9: cash4king (big blind) folded before Flop



PokerStars Hand #157575250918: Tournament #1641817620, $7.50+$7.50+$1.50 USD Hold'em No Limit - Level I (15/30) - 2016/08/21 18:35:03 ET
Table '1641817620 54' 9-max Seat #6 is the button
Seat 1: nixx77 (4975 in chips) 
Seat 2: FábioC.p.br (4960 in chips) 
Seat 3: pinokkioOo (4930 in chips) 
Seat 4: ALLESC-114 (4930 in chips) 
Seat 5: appache55 (3220 in chips) 
Seat 6: hrabbi87 (4870 in chips) 
Seat 7: GSGFM (5000 in chips) out of hand (moved from another table into small blind)
Seat 8: MiltonMorais (5060 in chips) 
Seat 9: ZeckMaverick (4975 in chips) 
nixx77: posts the ante 5
FábioC.p.br: posts the ante 5
pinokkioOo: posts the ante 5
ALLESC-114: posts the ante 5
appache55: posts the ante 5
hrabbi87: posts the ante 5
MiltonMorais: posts the ante 5
ZeckMaverick: posts the ante 5
MiltonMorais: posts small blind 15
ZeckMaverick: posts big blind 30
*** HOLE CARDS ***
nixx77: raises 60 to 90
FábioC.p.br: folds 
pinokkioOo: calls 90
ALLESC-114: raises 270 to 360
appache55: folds 
hrabbi87: folds 
MiltonMorais: folds 
ZeckMaverick is disconnected 
ZeckMaverick is connected 
ZeckMaverick: folds 
nixx77: calls 270
pinokkioOo: calls 270
*** FLOP *** [7h 7d Qh]
nixx77: bets 582
pinokkioOo: folds 
ALLESC-114: folds 
Uncalled bet (582) returned to nixx77
nixx77 collected 1165 from pot
nixx77: doesn't show hand 
*** SUMMARY ***
Total pot 1165 | Rake 0 
Board [7h 7d Qh]
Seat 1: nixx77 collected (1165)
Seat 2: FábioC.p.br folded before Flop (didn't bet)
Seat 3: pinokkioOo folded on the Flop
Seat 4: ALLESC-114 folded on the Flop
Seat 5: appache55 folded before Flop (didn't bet)
Seat 6: hrabbi87 (button) folded before Flop (didn't bet)
Seat 8: MiltonMorais (small blind) folded before Flop
Seat 9: ZeckMaverick (big blind) folded before Flop



PokerStars Hand #157575252615: Tournament #1641817620, $7.50+$7.50+$1.50 USD Hold'em No Limit - Level I (15/30) - 2016/08/21 18:35:06 ET
Table '1641817620 10' 9-max Seat #7 is the button
Seat 1: VANDECO174 (4970 in chips) 
Seat 2: Be Anger (4715 in chips) 
Seat 3: mickyryan (4925 in chips) 
Seat 4: silveira1879 (5255 in chips) 
Seat 5: AndyLou27 (5315 in chips) 
Seat 6: I M GOIN OFF (4925 in chips) 
Seat 7: Nuazo (4895 in chips) 
Seat 8: damibor (5090 in chips) 
Seat 9: Stokesy05 (4910 in chips) 
VANDECO174: posts the ante 5
Be Anger: posts the ante 5
mickyryan: posts the ante 5
silveira1879: posts the ante 5
AndyLou27: posts the ante 5
I M GOIN OFF: posts the ante 5
Nuazo: posts the ante 5
damibor: posts the ante 5
Stokesy05: posts the ante 5
damibor: posts small blind 15
Stokesy05: posts big blind 30
*** HOLE CARDS ***
VANDECO174: folds 
Be Anger: folds 
mickyryan: folds 
silveira1879: folds 
AndyLou27: calls 30
I M GOIN OFF: folds 
Nuazo: folds 
damibor: calls 15
Stokesy05: checks 
*** FLOP *** [4d 4h 5s]
damibor: checks 
Stokesy05: checks 
AndyLou27: checks 
*** TURN *** [4d 4h 5s] [9h]
damibor: bets 60
Stokesy05: folds 
AndyLou27: calls 60
*** RIVER *** [4d 4h 5s 9h] [Js]
damibor: checks 
AndyLou27: checks 
*** SHOW DOWN ***
damibor: shows [6s 9d] (two pair, Nines and Fours)
AndyLou27: shows [9s 8h] (two pair, Nines and Fours)
damibor collected 128 from pot
AndyLou27 collected 127 from pot
*** SUMMARY ***
Total pot 255 | Rake 0 
Board [4d 4h 5s 9h Js]
Seat 1: VANDECO174 folded before Flop (didn't bet)
Seat 2: Be Anger folded before Flop (didn't bet)
Seat 3: mickyryan folded before Flop (didn't bet)
Seat 4: silveira1879 folded before Flop (didn't bet)
Seat 5: AndyLou27 showed [9s 8h] and won (127) with two pair, Nines and Fours
Seat 6: I M GOIN OFF folded before Flop (didn't bet)
Seat 7: Nuazo (button) folded before Flop (didn't bet)
Seat 8: damibor (small blind) showed [6s 9d] and won (128) with two pair, Nines and Fours
Seat 9: Stokesy05 (big blind) folded on the Turn



PokerStars Hand #157575252662: Tournament #1641817620, $7.50+$7.50+$1.50 USD Hold'em No Limit - Level I (15/30) - 2016/08/21 18:35:06 ET
Table '1641817620 28' 9-max Seat #4 is the button
Seat 1: kidprodigy44 (4985 in chips) 
Seat 2: jamaika high (3745 in chips) 
Seat 3: cairob (4940 in chips) 
Seat 4: NIKOLACG (1598 in chips) 
Seat 5: neckbr4ke (4835 in chips) 
Seat 6: Quaysie (4985 in chips) 
Seat 7: d3ment0r (8110 in chips) 
Seat 8: papan9_p$ (6817 in chips) 
Seat 9: benjicleo (4985 in chips) 
kidprodigy44: posts the ante 5
jamaika high: posts the ante 5
cairob: posts the ante 5
NIKOLACG: posts the ante 5
neckbr4ke: posts the ante 5
Quaysie: posts the ante 5
d3ment0r: posts the ante 5
papan9_p$: posts the ante 5
benjicleo: posts the ante 5
neckbr4ke: posts small blind 15
Quaysie: posts big blind 30
*** HOLE CARDS ***
d3ment0r: raises 90 to 120
papan9_p$: calls 120
benjicleo: folds 
kidprodigy44: folds 
jamaika high: calls 120
cairob: folds 
NIKOLACG: folds 
neckbr4ke: calls 105
Quaysie: calls 90
*** FLOP *** [5d Js Qs]
neckbr4ke: checks 
Quaysie: checks 
d3ment0r: checks 
papan9_p$: checks 
jamaika high: checks 
*** TURN *** [5d Js Qs] [9c]
neckbr4ke: bets 397
Quaysie: calls 397
d3ment0r: folds 
papan9_p$: folds 
jamaika high: calls 397
*** RIVER *** [5d Js Qs 9c] [Kh]
neckbr4ke: checks 
Quaysie: bets 4463 and is all-in
jamaika high: calls 3223 and is all-in
neckbr4ke: folds 
Uncalled bet (1240) returned to Quaysie
*** SHOW DOWN ***
Quaysie: shows [Tc Ad] (a straight, Ten to Ace)
jamaika high: shows [5c Th] (a straight, Nine to King)
Quaysie collected 8282 from pot
Quaysie wins $3.75 for eliminating jamaika high and their own bounty increases by $3.75 to $11.25
jamaika high finished the tournament in 999999984th place
*** SUMMARY ***
Total pot 8282 | Rake 0 
Board [5d Js Qs 9c Kh]
Seat 1: kidprodigy44 folded before Flop (didn't bet)
Seat 2: jamaika high showed [5c Th] and lost with a straight, Nine to King
Seat 3: cairob folded before Flop (didn't bet)
Seat 4: NIKOLACG (button) folded before Flop (didn't bet)
Seat 5: neckbr4ke (small blind) folded on the River
Seat 6: Quaysie (big blind) showed [Tc Ad] and won (8282) with a straight, Ten to Ace
Seat 7: d3ment0r folded on the Turn
Seat 8: papan9_p$ folded on the Turn
Seat 9: benjicleo folded before Flop (didn't bet)



PokerStars Hand #157575253184: Tournament #1641817620, $7.50+$7.50+$1.50 USD Hold'em No Limit - Level I (15/30) - 2016/08/21 18:35:07 ET
Table '1641817620 37' 9-max Seat #8 is the button
Seat 1: Youbetipush1 (4880 in chips) 
Seat 2: SouzaEduardo (4955 in chips) 
Seat 3: Maisteri (7270 in chips) 
Seat 4: qball911 (4865 in chips) 
Seat 5: dell1961 (4840 in chips) 
Seat 6: ColdFire_200 (4880 in chips) 
Seat 7: loachxm (4875 in chips) 
Seat 8: mikke8282 (5180 in chips) 
Seat 9: CHIQUIDEALER (5000 in chips) out of hand (moved from another table into small blind)
Youbetipush1: posts the ante 5
SouzaEduardo: posts the ante 5
Maisteri: posts the ante 5
qball911: posts the ante 5
dell1961: posts the ante 5
ColdFire_200: posts the ante 5
loachxm: posts the ante 5
mikke8282: posts the ante 5
Youbetipush1: posts small blind 15
SouzaEduardo: posts big blind 30
*** HOLE CARDS ***
Maisteri: folds 
qball911: folds 
dell1961: folds 
ColdFire_200: folds 
loachxm: folds 
mikke8282: raises 48 to 78
Youbetipush1: folds 
SouzaEduardo: folds 
Uncalled bet (48) returned to mikke8282
mikke8282 collected 115 from pot
mikke8282: doesn't show hand 
*** SUMMARY ***
Total pot 115 | Rake 0 
Seat 1: Youbetipush1 (small blind) folded before Flop
Seat 2: SouzaEduardo (big blind) folded before Flop
Seat 3: Maisteri folded before Flop (didn't bet)
Seat 4: qball911 folded before Flop (didn't bet)
Seat 5: dell1961 folded before Flop (didn't bet)
Seat 6: ColdFire_200 folded before Flop (didn't bet)
Seat 7: loachxm folded before Flop (didn't bet)
Seat 8: mikke8282 (button) collected (115)



PokerStars Hand #157575253253: Tournament #1641817620, $7.50+$7.50+$1.50 USD Hold'em No Limit - Level I (15/30) - 2016/08/21 18:35:07 ET
Table '1641817620 39' 9-max Seat #7 is the button
Seat 1: BuyMeBMW (5110 in chips) 
Seat 2: ahaknh (4503 in chips) 
Seat 3: Crim44 (5447 in chips) 
Seat 4: Neo_gracz (4930 in chips) 
Seat 5: rinxa30 (4995 in chips) 
Seat 6: TxsFrUrMoney (5547 in chips) 
Seat 7: j.williams94 (5110 in chips) 
Seat 8: 88K@la88 (4408 in chips) 
Seat 9: Foggy56 (4825 in chips) 
BuyMeBMW: posts the ante 5
ahaknh: posts the ante 5
Crim44: posts the ante 5
Neo_gracz: posts the ante 5
rinxa30: posts the ante 5
TxsFrUrMoney: posts the ante 5
j.williams94: posts the ante 5
88K@la88: posts the ante 5
Foggy56: posts the ante 5
88K@la88: posts small blind 15
Foggy56: posts big blind 30
*** HOLE CARDS ***
BuyMeBMW: raises 45 to 75
ahaknh: folds 
Crim44: folds 
Neo_gracz: folds 
rinxa30: folds 
TxsFrUrMoney: calls 75
j.williams94: folds 
88K@la88: folds 
Foggy56: calls 45
*** FLOP *** [Ac 4c 2s]
Foggy56: checks 
BuyMeBMW: checks 
TxsFrUrMoney: bets 114
Foggy56: calls 114
BuyMeBMW: folds 
*** TURN *** [Ac 4c 2s] [4d]
Foggy56: checks 
TxsFrUrMoney: checks 
*** RIVER *** [Ac 4c 2s 4d] [7d]
Foggy56: checks 
TxsFrUrMoney: checks 
*** SHOW DOWN ***
Foggy56: shows [2h Ks] (two pair, Fours and Deuces)
TxsFrUrMoney: shows [5c 5d] (two pair, Fives and Fours)
TxsFrUrMoney collected 513 from pot
*** SUMMARY ***
Total pot 513 | Rake 0 
Board [Ac 4c 2s 4d 7d]
Seat 1: BuyMeBMW folded on the Flop
Seat 2: ahaknh folded before Flop (didn't bet)
Seat 3: Crim44 folded before Flop (didn't bet)
Seat 4: Neo_gracz folded before Flop (didn't bet)
Seat 5: rinxa30 folded before Flop (didn't bet)
Seat 6: TxsFrUrMoney showed [5c 5d] and won (513) with two pair, Fives and Fours
Seat 7: j.williams94 (button) folded before Flop (didn't bet)
Seat 8: 88K@la88 (small blind) folded before Flop
Seat 9: Foggy56 (big blind) showed [2h Ks] and lost with two pair, Fours and Deuces



PokerStars Hand #157575253998: Tournament #1641817620, $7.50+$7.50+$1.50 USD Hold'em No Limit - Level I (15/30) - 2016/08/21 18:35:08 ET
Table '1641817620 38' 9-max Seat #5 is the button
Seat 1: chechako#8 (4995 in chips) 
Seat 2: kristofxm8 (5685 in chips) 
Seat 3: persephoney (4895 in chips) 
Seat 4: Folladorwin (5000 in chips) 
Seat 5: jager1987 (4835 in chips) 
Seat 6: Dr.Durrrq (5090 in chips) 
Seat 7: Myschkin_Lev (4955 in chips) 
Seat 8: Bon_Choueur (4685 in chips) 
Seat 9: dtb1978 (4865 in chips) 
chechako#8: posts the ante 5
kristofxm8: posts the ante 5
persephoney: posts the ante 5
Folladorwin: posts the ante 5
jager1987: posts the ante 5
Dr.Durrrq: posts the ante 5
Myschkin_Lev: posts the ante 5
Bon_Choueur: posts the ante 5
dtb1978: posts the ante 5
Dr.Durrrq: posts small blind 15
Myschkin_Lev: posts big blind 30
*** HOLE CARDS ***
Bon_Choueur: folds 
dtb1978: folds 
chechako#8: folds 
kristofxm8: raises 30 to 60
persephoney: folds 
Folladorwin: folds 
jager1987: folds 
Dr.Durrrq: folds 
Myschkin_Lev: folds 
Uncalled bet (30) returned to kristofxm8
kristofxm8 collected 120 from pot
kristofxm8: doesn't show hand 
*** SUMMARY ***
Total pot 120 | Rake 0 
Seat 1: chechako#8 folded before Flop (didn't bet)
Seat 2: kristofxm8 collected (120)
Seat 3: persephoney folded before Flop (didn't bet)
Seat 4: Folladorwin folded before Flop (didn't bet)
Seat 5: jager1987 (button) folded before Flop (didn't bet)
Seat 6: Dr.Durrrq (small blind) folded before Flop
Seat 7: Myschkin_Lev (big blind) folded before Flop
Seat 8: Bon_Choueur folded before Flop (didn't bet)
Seat 9: dtb1978 folded before Flop (didn't bet)



PokerStars Hand #157575254461: Tournament #1641817620, $7.50+$7.50+$1.50 USD Hold'em No Limit - Level I (15/30) - 2016/08/21 18:35:09 ET
Table '1641817620 43' 9-max Seat #6 is the button
Seat 1: VeniG95 (10244 in chips) 
Seat 2: alanyamil (65 in chips) 
Seat 3: Raulop (4765 in chips) 
Seat 4: SoulSlaye166 (4990 in chips) 
Seat 5: DimaRu777 (5200 in chips) 
Seat 6: Taima (4736 in chips) 
Seat 7: Caville88 (4945 in chips) 
Seat 8: BetoFolhaCMC (4975 in chips) 
Seat 9: cajool (5080 in chips) 
VeniG95: posts the ante 5
alanyamil: posts the ante 5
Raulop: posts the ante 5
SoulSlaye166: posts the ante 5
DimaRu777: posts the ante 5
Taima: posts the ante 5
Caville88: posts the ante 5
BetoFolhaCMC: posts the ante 5
cajool: posts the ante 5
Caville88: posts small blind 15
BetoFolhaCMC: posts big blind 30
*** HOLE CARDS ***
cajool: calls 30
VeniG95: folds 
alanyamil: folds 
Raulop: folds 
SoulSlaye166: folds 
DimaRu777: folds 
Taima: calls 30
Caville88: calls 15
BetoFolhaCMC: checks 
*** FLOP *** [9h Ac 6s]
Caville88: checks 
BetoFolhaCMC: checks 
cajool: checks 
Taima: bets 90
Caville88: calls 90
BetoFolhaCMC: folds 
cajool: folds 
*** TURN *** [9h Ac 6s] [7h]
Caville88: checks 
Taima: bets 180
Caville88: calls 180
*** RIVER *** [9h Ac 6s 7h] [Kd]
Caville88: checks 
Taima: checks 
*** SHOW DOWN ***
Caville88: shows [5h 6h] (a pair of Sixes)
Taima: shows [5c Ah] (a pair of Aces)
Taima collected 705 from pot
*** SUMMARY ***
Total pot 705 | Rake 0 
Board [9h Ac 6s 7h Kd]
Seat 1: VeniG95 folded before Flop (didn't bet)
Seat 2: alanyamil folded before Flop (didn't bet)
Seat 3: Raulop folded before Flop (didn't bet)
Seat 4: SoulSlaye166 folded before Flop (didn't bet)
Seat 5: DimaRu777 folded before Flop (didn't bet)
Seat 6: Taima (button) showed [5c Ah] and won (705) with a pair of Aces
Seat 7: Caville88 (small blind) showed [5h 6h] and lost with a pair of Sixes
Seat 8: BetoFolhaCMC (big blind) folded on the Flop
Seat 9: cajool folded on the Flop



PokerStars Hand #157575254512: Tournament #1641817620, $7.50+$7.50+$1.50 USD Hold'em No Limit - Level I (15/30) - 2016/08/21 18:35:09 ET
Table '1641817620 57' 9-max Seat #5 is the button
Seat 1: pedroh2010 (10175 in chips) 
Seat 2: PANOYRGIAS73 (6495 in chips) 
Seat 3: ovekas (5115 in chips) 
Seat 4: ALWAYSBRAVES (4935 in chips) 
Seat 5: BaDBeaT_AK85 (4935 in chips) 
Seat 6: kachumban (4875 in chips) 
Seat 7: ZodiakGB (4980 in chips) 
Seat 8: MeortheMrs (3510 in chips) 
Seat 9: andreiuc (4980 in chips) 
pedroh2010: posts the ante 5
PANOYRGIAS73: posts the ante 5
ovekas: posts the ante 5
ALWAYSBRAVES: posts the ante 5
BaDBeaT_AK85: posts the ante 5
kachumban: posts the ante 5
ZodiakGB: posts the ante 5
MeortheMrs: posts the ante 5
andreiuc: posts the ante 5
kachumban: posts small blind 15
ZodiakGB: posts big blind 30
*** HOLE CARDS ***
MeortheMrs: folds 
andreiuc: folds 
pedroh2010: folds 
PANOYRGIAS73: raises 120 to 150
ovekas: folds 
ALWAYSBRAVES: folds 
BaDBeaT_AK85: folds 
kachumban: folds 
ZodiakGB: folds 
Uncalled bet (120) returned to PANOYRGIAS73
PANOYRGIAS73 collected 120 from pot
PANOYRGIAS73: doesn't show hand 
*** SUMMARY ***
Total pot 120 | Rake 0 
Seat 1: pedroh2010 folded before Flop (didn't bet)
Seat 2: PANOYRGIAS73 collected (120)
Seat 3: ovekas folded before Flop (didn't bet)
Seat 4: ALWAYSBRAVES folded before Flop (didn't bet)
Seat 5: BaDBeaT_AK85 (button) folded before Flop (didn't bet)
Seat 6: kachumban (small blind) folded before Flop
Seat 7: ZodiakGB (big blind) folded before Flop
Seat 8: MeortheMrs folded before Flop (didn't bet)
Seat 9: andreiuc folded before Flop (didn't bet)



PokerStars Hand #157575254677: Tournament #1641817620, $7.50+$7.50+$1.50 USD Hold'em No Limit - Level I (15/30) - 2016/08/21 18:35:09 ET
Table '1641817620 35' 9-max Seat #6 is the button
Seat 1: CPTRip69 (5000 in chips) 
Seat 2: Diegodel79 (4960 in chips) 
Seat 3: brunoeffect (4750 in chips) 
Seat 4: PPOrphan (5075 in chips) 
Seat 5: WizardOffAz (5325 in chips) 
Seat 6: brett88987 (4900 in chips) 
Seat 7: IcaLm (4735 in chips) 
Seat 8: ximenesb (4975 in chips) 
Seat 9: Cosacoman (5210 in chips) 
CPTRip69: posts the ante 5
Diegodel79: posts the ante 5
brunoeffect: posts the ante 5
PPOrphan: posts the ante 5
WizardOffAz: posts the ante 5
brett88987: posts the ante 5
IcaLm: posts the ante 5
ximenesb: posts the ante 5
Cosacoman: posts the ante 5
IcaLm: posts small blind 15
ximenesb: posts big blind 30
*** HOLE CARDS ***
Cosacoman: folds 
CPTRip69: calls 30
Diegodel79: raises 4925 to 4955 and is all-in
brunoeffect: folds 
PPOrphan: folds 
WizardOffAz: folds 
brett88987: folds 
IcaLm: folds 
ximenesb: folds 
CPTRip69: folds 
Uncalled bet (4925) returned to Diegodel79
Diegodel79 collected 150 from pot
Diegodel79: doesn't show hand 
*** SUMMARY ***
Total pot 150 | Rake 0 
Seat 1: CPTRip69 folded before Flop
Seat 2: Diegodel79 collected (150)
Seat 3: brunoeffect folded before Flop (didn't bet)
Seat 4: PPOrphan folded before Flop (didn't bet)
Seat 5: WizardOffAz folded before Flop (didn't bet)
Seat 6: brett88987 (button) folded before Flop (didn't bet)
Seat 7: IcaLm (small blind) folded before Flop
Seat 8: ximenesb (big blind) folded before Flop
Seat 9: Cosacoman folded before Flop (didn't bet)



PokerStars Hand #157575254979: Tournament #1641817620, $7.50+$7.50+$1.50 USD Hold'em No Limit - Level I (15/30) - 2016/08/21 18:35:10 ET
Table '1641817620 16' 9-max Seat #2 is the button
Seat 1: crewzer_08 (5000 in chips) 
Seat 2: Sergei0384 (5026 in chips) 
Seat 3: paschalisbg (4885 in chips) 
Seat 4: Maisiewin (4977 in chips) 
Seat 5: alemaozl (4915 in chips) 
Seat 6: Luis Reye837 (4985 in chips) 
Seat 7: burton14 (5175 in chips) 
Seat 8: Miky_Man993 (4825 in chips) 
Seat 9: ziboin (5052 in chips) 
crewzer_08: posts the ante 5
Sergei0384: posts the ante 5
paschalisbg: posts the ante 5
Maisiewin: posts the ante 5
alemaozl: posts the ante 5
Luis Reye837: posts the ante 5
burton14: posts the ante 5
Miky_Man993: posts the ante 5
ziboin: posts the ante 5
paschalisbg: posts small blind 15
Maisiewin: posts big blind 30
*** HOLE CARDS ***
alemaozl: folds 
Luis Reye837: folds 
burton14: folds 
Miky_Man993: raises 37 to 67
ziboin: folds 
crewzer_08: calls 67
Sergei0384: folds 
paschalisbg: calls 52
Maisiewin: calls 37
*** FLOP *** [Kc Qc Kh]
paschalisbg: checks 
Maisiewin: checks 
Miky_Man993: checks 
crewzer_08: bets 120
paschalisbg: raises 300 to 420
Maisiewin: folds 
Miky_Man993: folds 
crewzer_08: folds 
Uncalled bet (300) returned to paschalisbg
paschalisbg collected 553 from pot
paschalisbg: doesn't show hand 
*** SUMMARY ***
Total pot 553 | Rake 0 
Board [Kc Qc Kh]
Seat 1: crewzer_08 folded on the Flop
Seat 2: Sergei0384 (button) folded before Flop (didn't bet)
Seat 3: paschalisbg (small blind) collected (553)
Seat 4: Maisiewin (big blind) folded on the Flop
Seat 5: alemaozl folded before Flop (didn't bet)
Seat 6: Luis Reye837 folded before Flop (didn't bet)
Seat 7: burton14 folded before Flop (didn't bet)
Seat 8: Miky_Man993 folded on the Flop
Seat 9: ziboin folded before Flop (didn't bet)



PokerStars Hand #157575255319: Tournament #1641817620, $7.50+$7.50+$1.50 USD Hold'em No Limit - Level I (15/30) - 2016/08/21 18:35:10 ET
Table '1641817620 36' 9-max Seat #6 is the button
Seat 1: craiger1976 (4980 in chips) 
Seat 2: Winston4ever (4795 in chips) 
Seat 3: sarxa (4935 in chips) 
Seat 4: rakeshguru (5145 in chips) 
Seat 5: blufface88 (4125 in chips) 
Seat 6: xanja (4935 in chips) 
Seat 7: jadrankokec (4950 in chips) 
Seat 8: ruben marley (4980 in chips) 
Seat 9: wowbizz2 (6160 in chips) 
craiger1976: posts the ante 5
Winston4ever: posts the ante 5
sarxa: posts the ante 5
rakeshguru: posts the ante 5
blufface88: posts the ante 5
xanja: posts the ante 5
jadrankokec: posts the ante 5
ruben marley: posts the ante 5
wowbizz2: posts the ante 5
jadrankokec: posts small blind 15
ruben marley: posts big blind 30
*** HOLE CARDS ***
wowbizz2: folds 
craiger1976: folds 
Winston4ever: calls 30
sarxa: folds 
rakeshguru: folds 
blufface88: raises 90 to 120
xanja: calls 120
jadrankokec: raises 465 to 585
ruben marley: folds 
Winston4ever: folds 
blufface88: folds 
xanja: folds 
Uncalled bet (465) returned to jadrankokec
jadrankokec collected 465 from pot
*** SUMMARY ***
Total pot 465 | Rake 0 
Seat 1: craiger1976 folded before Flop (didn't bet)
Seat 2: Winston4ever folded before Flop
Seat 3: sarxa folded before Flop (didn't bet)
Seat 4: rakeshguru folded before Flop (didn't bet)
Seat 5: blufface88 folded before Flop
Seat 6: xanja (button) folded before Flop
Seat 7: jadrankokec (small blind) collected (465)
Seat 8: ruben marley (big blind) folded before Flop
Seat 9: wowbizz2 folded before Flop (didn't bet)



PokerStars Hand #157575255524: Tournament #1641817620, $7.50+$7.50+$1.50 USD Hold'em No Limit - Level I (15/30) - 2016/08/21 18:35:10 ET
Table '1641817620 21' 9-max Seat #6 is the button
Seat 1: apaixtos1 (5515 in chips) 
Seat 2: ukr_durrrr (4840 in chips) 
Seat 3: ultgamb (4930 in chips) 
Seat 4: fishin1981 (4885 in chips) 
Seat 5: jeroma123 (4615 in chips) 
Seat 6: olleggi (5020 in chips) 
Seat 7: pokerlazik (4945 in chips) 
Seat 8: pokerist2692 (4806 in chips) 
Seat 9: Ferrazz (5444 in chips) 
apaixtos1: posts the ante 5
ukr_durrrr: posts the ante 5
ultgamb: posts the ante 5
fishin1981: posts the ante 5
jeroma123: posts the ante 5
olleggi: posts the ante 5
pokerlazik: posts the ante 5
pokerist2692: posts the ante 5
Ferrazz: posts the ante 5
pokerlazik: posts small blind 15
pokerist2692: posts big blind 30
*** HOLE CARDS ***
Ferrazz: folds 
apaixtos1: calls 30
ukr_durrrr: folds 
ultgamb: folds 
fishin1981: calls 30
jeroma123: raises 60 to 90
olleggi: folds 
pokerlazik: folds 
pokerist2692: folds 
apaixtos1: calls 60
fishin1981: calls 60
*** FLOP *** [2d Ad Kc]
apaixtos1: checks 
fishin1981: checks 
jeroma123: bets 90
apaixtos1: folds 
fishin1981: folds 
Uncalled bet (90) returned to jeroma123
jeroma123 collected 360 from pot
jeroma123: doesn't show hand 
*** SUMMARY ***
Total pot 360 | Rake 0 
Board [2d Ad Kc]
Seat 1: apaixtos1 folded on the Flop
Seat 2: ukr_durrrr folded before Flop (didn't bet)
Seat 3: ultgamb folded before Flop (didn't bet)
Seat 4: fishin1981 folded on the Flop
Seat 5: jeroma123 collected (360)
Seat 6: olleggi (button) folded before Flop (didn't bet)
Seat 7: pokerlazik (small blind) folded before Flop
Seat 8: pokerist2692 (big blind) folded before Flop
Seat 9: Ferrazz folded before Flop (didn't bet)



PokerStars Hand #157575255607: Tournament #1641817620, $7.50+$7.50+$1.50 USD Hold'em No Limit - Level I (15/30) - 2016/08/21 18:35:11 ET
Table '1641817620 8' 9-max Seat #7 is the button
Seat 1: inkjoh (5355 in chips) 
Seat 2: MarcosCLMO (4557 in chips) 
Seat 3: HundTore (5780 in chips) 
Seat 4: Kamikase1805 (5015 in chips) 
Seat 5: younesch (4593 in chips) 
Seat 6: spinne1109 (4940 in chips) 
Seat 7: pavaopics (4865 in chips) 
Seat 8: FastEdiddy (4940 in chips) 
Seat 9: Pokerofwind (4970 in chips) 
inkjoh: posts the ante 5
MarcosCLMO: posts the ante 5
HundTore: posts the ante 5
Kamikase1805: posts the ante 5
younesch: posts the ante 5
spinne1109: posts the ante 5
pavaopics: posts the ante 5
FastEdiddy: posts the ante 5
Pokerofwind: posts the ante 5
FastEdiddy: posts small blind 15
Pokerofwind: posts big blind 30
*** HOLE CARDS ***
inkjoh: folds 
MarcosCLMO: folds 
HundTore: folds 
Kamikase1805: folds 
younesch: folds 
spinne1109: raises 90 to 120
pavaopics: raises 150 to 270
FastEdiddy: folds 
Pokerofwind: folds 
spinne1109: calls 150
*** FLOP *** [Qs 9s 6s]
spinne1109: checks 
pavaopics: bets 330
spinne1109: calls 330
*** TURN *** [Qs 9s 6s] [Ad]
spinne1109: checks 
pavaopics: checks 
*** RIVER *** [Qs 9s 6s Ad] [5s]
spinne1109: bets 330
pavaopics: raises 600 to 930
spinne1109: folds 
Uncalled bet (600) returned to pavaopics
pavaopics collected 1950 from pot
pavaopics: doesn't show hand 
*** SUMMARY ***
Total pot 1950 | Rake 0 
Board [Qs 9s 6s Ad 5s]
Seat 1: inkjoh folded before Flop (didn't bet)
Seat 2: MarcosCLMO folded before Flop (didn't bet)
Seat 3: HundTore folded before Flop (didn't bet)
Seat 4: Kamikase1805 folded before Flop (didn't bet)
Seat 5: younesch folded before Flop (didn't bet)
Seat 6: spinne1109 folded on the River
Seat 7: pavaopics (button) collected (1950)
Seat 8: FastEdiddy (small blind) folded before Flop
Seat 9: Pokerofwind (big blind) folded before Flop



PokerStars Hand #157575256691: Tournament #1641817620, $7.50+$7.50+$1.50 USD Hold'em No Limit - Level I (15/30) - 2016/08/21 18:35:12 ET
Table '1641817620 25' 9-max Seat #9 is the button
Seat 1: MoW3R (4935 in chips) 
Seat 2: pirus157 (5545 in chips) 
Seat 3: MaxBracht (4800 in chips) 
Seat 4: Rex Nelson (4765 in chips) 
Seat 5: ArKip (4920 in chips) 
Seat 6: REALACID (4990 in chips) 
Seat 7: AAnaKKonda (5250 in chips) 
Seat 8: Mad Dionysus (5010 in chips) 
Seat 9: IwillCall3 (4800 in chips) 
MoW3R: posts the ante 5
pirus157: posts the ante 5
MaxBracht: posts the ante 5
Rex Nelson: posts the ante 5
ArKip: posts the ante 5
REALACID: posts the ante 5
AAnaKKonda: posts the ante 5
Mad Dionysus: posts the ante 5
IwillCall3: posts the ante 5
MoW3R: posts small blind 15
pirus157: posts big blind 30
*** HOLE CARDS ***
MaxBracht: folds 
Rex Nelson: folds 
ArKip: folds 
REALACID: raises 36 to 66
AAnaKKonda: folds 
Mad Dionysus: folds 
IwillCall3: raises 36 to 102
MoW3R: calls 87
pirus157: folds 
REALACID: calls 36
*** FLOP *** [Qd 8c 4h]
MoW3R: checks 
REALACID: checks 
IwillCall3: bets 190
MoW3R: folds 
REALACID: calls 190
*** TURN *** [Qd 8c 4h] [6d]
REALACID: checks 
IwillCall3: checks 
*** RIVER *** [Qd 8c 4h 6d] [7h]
REALACID: checks 
IwillCall3: bets 380
REALACID: folds 
Uncalled bet (380) returned to IwillCall3
IwillCall3 collected 761 from pot
IwillCall3: doesn't show hand 
*** SUMMARY ***
Total pot 761 | Rake 0 
Board [Qd 8c 4h 6d 7h]
Seat 1: MoW3R (small blind) folded on the Flop
Seat 2: pirus157 (big blind) folded before Flop
Seat 3: MaxBracht folded before Flop (didn't bet)
Seat 4: Rex Nelson folded before Flop (didn't bet)
Seat 5: ArKip folded before Flop (didn't bet)
Seat 6: REALACID folded on the River
Seat 7: AAnaKKonda folded before Flop (didn't bet)
Seat 8: Mad Dionysus folded before Flop (didn't bet)
Seat 9: IwillCall3 (button) collected (761)



PokerStars Hand #157575257306: Tournament #1641817620, $7.50+$7.50+$1.50 USD Hold'em No Limit - Level I (15/30) - 2016/08/21 18:35:13 ET
Table '1641817620 1' 9-max Seat #1 is the button
Seat 1: mattyonuts (4813 in chips) 
Seat 2: topaipi (6233 in chips) 
Seat 3: MAMOHT_T (4925 in chips) 
Seat 4: ManMaPayé (4985 in chips) 
Seat 5: LADIEFJ (5226 in chips) 
Seat 6: TheGuerreiro (4703 in chips) 
Seat 7: spiderhami (4995 in chips) 
Seat 8: K. Ichinose (4959 in chips) 
Seat 9: jonespkr (5000 in chips) 
mattyonuts: posts the ante 5
topaipi: posts the ante 5
MAMOHT_T: posts the ante 5
ManMaPayé: posts the ante 5
LADIEFJ: posts the ante 5
TheGuerreiro: posts the ante 5
spiderhami: posts the ante 5
K. Ichinose: posts the ante 5
jonespkr: posts the ante 5
topaipi: posts small blind 15
MAMOHT_T: posts big blind 30
*** HOLE CARDS ***
ManMaPayé: folds 
LADIEFJ: folds 
TheGuerreiro: folds 
spiderhami: folds 
K. Ichinose: folds 
jonespkr: folds 
mattyonuts: folds 
topaipi: raises 60 to 90
MAMOHT_T: folds 
Uncalled bet (60) returned to topaipi
topaipi collected 105 from pot
topaipi: doesn't show hand 
*** SUMMARY ***
Total pot 105 | Rake 0 
Seat 1: mattyonuts (button) folded before Flop (didn't bet)
Seat 2: topaipi (small blind) collected (105)
Seat 3: MAMOHT_T (big blind) folded before Flop
Seat 4: ManMaPayé folded before Flop (didn't bet)
Seat 5: LADIEFJ folded before Flop (didn't bet)
Seat 6: TheGuerreiro folded before Flop (didn't bet)
Seat 7: spiderhami folded before Flop (didn't bet)
Seat 8: K. Ichinose folded before Flop (didn't bet)
Seat 9: jonespkr folded before Flop (didn't bet)



PokerStars Hand #157575257801: Tournament #1641817620, $7.50+$7.50+$1.50 USD Hold'em No Limit - Level I (15/30) - 2016/08/21 18:35:14 ET
Table '1641817620 60' 9-max Seat #4 is the button
Seat 1: C0rpsbal (4985 in chips) 
Seat 2: LuckyRin (4970 in chips) 
Seat 3: Mattzy1 (7771 in chips) 
Seat 4: loco2202 (4880 in chips) 
Seat 5: Malzer19 (5000 in chips) out of hand (moved from another table into small blind)
Seat 6: sexyhands (4155 in chips) 
Seat 7: vodao1 (3625 in chips) 
Seat 8: TarDinaCash (4910 in chips) 
Seat 9: Eibsee08 (4985 in chips) 
C0rpsbal: posts the ante 5
LuckyRin: posts the ante 5
Mattzy1: posts the ante 5
loco2202: posts the ante 5
sexyhands: posts the ante 5
vodao1: posts the ante 5
TarDinaCash: posts the ante 5
Eibsee08: posts the ante 5
sexyhands: posts small blind 15
vodao1: posts big blind 30
*** HOLE CARDS ***
vodao1 said, "nice fisch"
TarDinaCash: folds 
Eibsee08: raises 60 to 90
C0rpsbal: folds 
LuckyRin: raises 265 to 355
Mattzy1: folds 
loco2202: folds 
sexyhands: folds 
vodao1: folds 
Eibsee08: folds 
Uncalled bet (265) returned to LuckyRin
LuckyRin collected 265 from pot
LuckyRin: doesn't show hand 
*** SUMMARY ***
Total pot 265 | Rake 0 
Seat 1: C0rpsbal folded before Flop (didn't bet)
Seat 2: LuckyRin collected (265)
Seat 3: Mattzy1 folded before Flop (didn't bet)
Seat 4: loco2202 (button) folded before Flop (didn't bet)
Seat 6: sexyhands (small blind) folded before Flop
Seat 7: vodao1 (big blind) folded before Flop
Seat 8: TarDinaCash folded before Flop (didn't bet)
Seat 9: Eibsee08 folded before Flop



PokerStars Hand #157575258721: Tournament #1641817620, $7.50+$7.50+$1.50 USD Hold'em No Limit - Level I (15/30) - 2016/08/21 18:35:15 ET
Table '1641817620 50' 9-max Seat #7 is the button
Seat 1: Alpentraum (4026 in chips) 
Seat 2: FrEmpireAk (10147 in chips) 
Seat 3: hat_coates (4930 in chips) 
Seat 4: GiCi40 (4990 in chips) 
Seat 5: Herbettigre (4975 in chips) 
Seat 6: saintP20 (1065 in chips) 
Seat 7: Shab26 (4795 in chips) 
Seat 8: thinkfeeldo (4908 in chips) 
Seat 9: ziomekek (5169 in chips) 
Alpentraum: posts the ante 5
FrEmpireAk: posts the ante 5
hat_coates: posts the ante 5
GiCi40: posts the ante 5
Herbettigre: posts the ante 5
saintP20: posts the ante 5
Shab26: posts the ante 5
thinkfeeldo: posts the ante 5
ziomekek: posts the ante 5
thinkfeeldo: posts small blind 15
ziomekek: posts big blind 30
*** HOLE CARDS ***
Alpentraum: raises 30 to 60
FrEmpireAk: folds 
hat_coates: folds 
GiCi40: folds 
Herbettigre: calls 60
saintP20: raises 1000 to 1060 and is all-in
Shab26: folds 
thinkfeeldo: folds 
ziomekek: folds 
Alpentraum: calls 1000
Herbettigre: folds 
*** FLOP *** [5s Qs 3d]
*** TURN *** [5s Qs 3d] [Qc]
*** RIVER *** [5s Qs 3d Qc] [6c]
*** SHOW DOWN ***
Alpentraum: shows [Tc Ah] (a pair of Queens)
saintP20: shows [Kc 9s] (a pair of Queens - lower kicker)
Alpentraum collected 2270 from pot
Alpentraum wins $3.75 for eliminating saintP20 and their own bounty increases by $3.75 to $11.25
saintP20 finished the tournament in 999999985th place
*** SUMMARY ***
Total pot 2270 | Rake 0 
Board [5s Qs 3d Qc 6c]
Seat 1: Alpentraum showed [Tc Ah] and won (2270) with a pair of Queens
Seat 2: FrEmpireAk folded before Flop (didn't bet)
Seat 3: hat_coates folded before Flop (didn't bet)
Seat 4: GiCi40 folded before Flop (didn't bet)
Seat 5: Herbettigre folded before Flop
Seat 6: saintP20 showed [Kc 9s] and lost with a pair of Queens
Seat 7: Shab26 (button) folded before Flop (didn't bet)
Seat 8: thinkfeeldo (small blind) folded before Flop
Seat 9: ziomekek (big blind) folded before Flop



PokerStars Hand #157575258722: Tournament #1641817620, $7.50+$7.50+$1.50 USD Hold'em No Limit - Level I (15/30) - 2016/08/21 18:35:15 ET
Table '1641817620 42' 9-max Seat #5 is the button
Seat 1: killa187187 (4770 in chips) 
Seat 2: lmiotto88 (5205 in chips) 
Seat 3: Piiirat (4935 in chips) 
Seat 4: skjørring (5595 in chips) 
Seat 5: AcabeiDeSair (4935 in chips) 
Seat 6: phathead109 (4965 in chips) 
Seat 7: ThirtyTw0 (5125 in chips) 
Seat 8: FeFeFeFeFEDE (4890 in chips) 
Seat 9: radekvv777 (9580 in chips) 
killa187187: posts the ante 5
lmiotto88: posts the ante 5
Piiirat: posts the ante 5
skjørring: posts the ante 5
AcabeiDeSair: posts the ante 5
phathead109: posts the ante 5
ThirtyTw0: posts the ante 5
FeFeFeFeFEDE: posts the ante 5
radekvv777: posts the ante 5
phathead109: posts small blind 15
ThirtyTw0: posts big blind 30
*** HOLE CARDS ***
FeFeFeFeFEDE: folds 
radekvv777: calls 30
killa187187: folds 
lmiotto88: folds 
Piiirat: folds 
skjørring: calls 30
AcabeiDeSair: folds 
phathead109: folds 
ThirtyTw0: checks 
*** FLOP *** [9c 6s 6d]
ThirtyTw0: checks 
radekvv777: checks 
skjørring: checks 
*** TURN *** [9c 6s 6d] [3s]
ThirtyTw0: checks 
radekvv777: checks 
skjørring: checks 
*** RIVER *** [9c 6s 6d 3s] [Kd]
ThirtyTw0: bets 60
radekvv777: folds 
skjørring: folds 
Uncalled bet (60) returned to ThirtyTw0
ThirtyTw0 collected 150 from pot
ThirtyTw0: doesn't show hand 
*** SUMMARY ***
Total pot 150 | Rake 0 
Board [9c 6s 6d 3s Kd]
Seat 1: killa187187 folded before Flop (didn't bet)
Seat 2: lmiotto88 folded before Flop (didn't bet)
Seat 3: Piiirat folded before Flop (didn't bet)
Seat 4: skjørring folded on the River
Seat 5: AcabeiDeSair (button) folded before Flop (didn't bet)
Seat 6: phathead109 (small blind) folded before Flop
Seat 7: ThirtyTw0 (big blind) collected (150)
Seat 8: FeFeFeFeFEDE folded before Flop (didn't bet)
Seat 9: radekvv777 folded on the River



PokerStars Hand #157575260717: Tournament #1641817620, $7.50+$7.50+$1.50 USD Hold'em No Limit - Level I (15/30) - 2016/08/21 18:35:17 ET
Table '1641817620 18' 9-max Seat #4 is the button
Seat 1: Declan387 (4287 in chips) 
Seat 2: silvina35 (5162 in chips) 
Seat 3: TBP23 (4122 in chips) 
Seat 4: One_Cigar (4940 in chips) 
Seat 5: 111santos (4805 in chips) 
Seat 6: Krauser2589 (5595 in chips) 
Seat 7: shaxmatiist (4985 in chips) 
Seat 8: Lestatdiego (4742 in chips) 
Seat 9: kokandija (6362 in chips) is sitting out
Declan387: posts the ante 5
silvina35: posts the ante 5
TBP23: posts the ante 5
One_Cigar: posts the ante 5
111santos: posts the ante 5
Krauser2589: posts the ante 5
shaxmatiist: posts the ante 5
Lestatdiego: posts the ante 5
kokandija: posts the ante 5
111santos: posts small blind 15
Krauser2589: posts big blind 30
*** HOLE CARDS ***
shaxmatiist: folds 
Lestatdiego: folds 
kokandija: folds 
Declan387: folds 
silvina35: folds 
TBP23: folds 
One_Cigar: folds 
111santos: folds 
Uncalled bet (15) returned to Krauser2589
Krauser2589 collected 75 from pot
*** SUMMARY ***
Total pot 75 | Rake 0 
Seat 1: Declan387 folded before Flop (didn't bet)
Seat 2: silvina35 folded before Flop (didn't bet)
Seat 3: TBP23 folded before Flop (didn't bet)
Seat 4: One_Cigar (button) folded before Flop (didn't bet)
Seat 5: 111santos (small blind) folded before Flop
Seat 6: Krauser2589 (big blind) collected (75)
Seat 7: shaxmatiist folded before Flop (didn't bet)
Seat 8: Lestatdiego folded before Flop (didn't bet)
Seat 9: kokandija folded before Flop (didn't bet)



PokerStars Hand #157575262808: Tournament #1641817620, $7.50+$7.50+$1.50 USD Hold'em No Limit - Level I (15/30) - 2016/08/21 18:35:20 ET
Table '1641817620 19' 9-max Seat #8 is the button
Seat 2: renem24 (10025 in chips) 
Seat 3: Paparazzi507 (5175 in chips) 
Seat 4: amondelo (4540 in chips) 
Seat 5: xapnss (4995 in chips) 
Seat 6: flutzke90 (4930 in chips) 
Seat 7: Konfucy1 (5000 in chips) 
Seat 8: le_chefe28 (5485 in chips) 
Seat 9: naumans (4945 in chips) 
renem24: posts the ante 5
Paparazzi507: posts the ante 5
amondelo: posts the ante 5
xapnss: posts the ante 5
flutzke90: posts the ante 5
Konfucy1: posts the ante 5
le_chefe28: posts the ante 5
naumans: posts the ante 5
naumans: posts small blind 15
renem24: posts big blind 30
*** HOLE CARDS ***
Paparazzi507: raises 47 to 77
amondelo: folds 
xapnss: folds 
flutzke90: folds 
Konfucy1: calls 77
le_chefe28: folds 
naumans: folds 
renem24: folds 
*** FLOP *** [2s Ts 7h]
Paparazzi507: bets 211
Konfucy1: folds 
Uncalled bet (211) returned to Paparazzi507
Paparazzi507 collected 239 from pot
Paparazzi507: doesn't show hand 
*** SUMMARY ***
Total pot 239 | Rake 0 
Board [2s Ts 7h]
Seat 2: renem24 (big blind) folded before Flop
Seat 3: Paparazzi507 collected (239)
Seat 4: amondelo folded before Flop (didn't bet)
Seat 5: xapnss folded before Flop (didn't bet)
Seat 6: flutzke90 folded before Flop (didn't bet)
Seat 7: Konfucy1 folded on the Flop
Seat 8: le_chefe28 (button) folded before Flop (didn't bet)
Seat 9: naumans (small blind) folded before Flop



PokerStars Hand #157575264436: Tournament #1641817620, $7.50+$7.50+$1.50 USD Hold'em No Limit - Level I (15/30) - 2016/08/21 18:35:23 ET
Table '1641817620 17' 9-max Seat #1 is the button
Seat 1: guitarist68 (4970 in chips) 
Seat 2: Anton163reg (5510 in chips) 
Seat 3: GoldenBeeM (4920 in chips) 
Seat 5: happyminh (9550 in chips) 
Seat 6: dekota222 (4920 in chips) 
Seat 7: rooney69 (5305 in chips) 
Seat 8: Cechinator (400 in chips) 
Seat 9: Samburger514 (5070 in chips) 
guitarist68: posts the ante 5
Anton163reg: posts the ante 5
GoldenBeeM: posts the ante 5
happyminh: posts the ante 5
dekota222: posts the ante 5
rooney69: posts the ante 5
Cechinator: posts the ante 5
Samburger514: posts the ante 5
Anton163reg: posts small blind 15
GoldenBeeM: posts big blind 30
*** HOLE CARDS ***
happyminh: calls 30
dekota222: folds 
rooney69: folds 
Cechinator: folds 
Samburger514: folds 
guitarist68: folds 
Anton163reg: calls 15
GoldenBeeM: checks 
*** FLOP *** [4d Tc 8c]
Anton163reg: checks 
GoldenBeeM: checks 
Samburger514 is disconnected 
happyminh: bets 60
Anton163reg: folds 
GoldenBeeM: calls 60
*** TURN *** [4d Tc 8c] [Qc]
GoldenBeeM: checks 
happyminh: bets 120
GoldenBeeM: folds 
Uncalled bet (120) returned to happyminh
happyminh collected 250 from pot
*** SUMMARY ***
Total pot 250 | Rake 0 
Board [4d Tc 8c Qc]
Seat 1: guitarist68 (button) folded before Flop (didn't bet)
Seat 2: Anton163reg (small blind) folded on the Flop
Seat 3: GoldenBeeM (big blind) folded on the Turn
Seat 5: happyminh collected (250)
Seat 6: dekota222 folded before Flop (didn't bet)
Seat 7: rooney69 folded before Flop (didn't bet)
Seat 8: Cechinator folded before Flop (didn't bet)
Seat 9: Samburger514 folded before Flop (didn't bet)



PokerStars Hand #157575266200: Tournament #1641817620, $7.50+$7.50+$1.50 USD Hold'em No Limit - Level I (15/30) - 2016/08/21 18:35:25 ET
Table '1641817620 52' 9-max Seat #6 is the button
Seat 1: DoubleBBle (5470 in chips) 
Seat 2: FelipeMarlon (5200 in chips) 
Seat 3: michalis009 (4693 in chips) 
Seat 4: Daviderevan (4930 in chips) 
Seat 5: Armin2188 (4930 in chips) 
Seat 6: HORSEPOKER28 (5095 in chips) 
Seat 7: tatingo82 (5000 in chips) out of hand (moved from another table into small blind)
Seat 8: vladvladutz (5207 in chips) 
Seat 9: leothefirm (4900 in chips) 
DoubleBBle: posts the ante 5
FelipeMarlon: posts the ante 5
michalis009: posts the ante 5
Daviderevan: posts the ante 5
Armin2188: posts the ante 5
HORSEPOKER28: posts the ante 5
vladvladutz: posts the ante 5
leothefirm: posts the ante 5
vladvladutz: posts small blind 15
leothefirm: posts big blind 30
*** HOLE CARDS ***
DoubleBBle: folds 
FelipeMarlon: folds 
michalis009: folds 
Daviderevan: folds 
Armin2188: folds 
HORSEPOKER28: folds 
vladvladutz: folds 
Uncalled bet (15) returned to leothefirm
leothefirm collected 70 from pot
leothefirm: doesn't show hand 
*** SUMMARY ***
Total pot 70 | Rake 0 
Seat 1: DoubleBBle folded before Flop (didn't bet)
Seat 2: FelipeMarlon folded before Flop (didn't bet)
Seat 3: michalis009 folded before Flop (didn't bet)
Seat 4: Daviderevan folded before Flop (didn't bet)
Seat 5: Armin2188 folded before Flop (didn't bet)
Seat 6: HORSEPOKER28 (button) folded before Flop (didn't bet)
Seat 8: vladvladutz (small blind) folded before Flop
Seat 9: leothefirm (big blind) collected (70)



PokerStars Hand #157575266386: Tournament #1641817620, $7.50+$7.50+$1.50 USD Hold'em No Limit - Level I (15/30) - 2016/08/21 18:35:26 ET
Table '1641817620 11' 9-max Seat #6 is the button
Seat 1: GambleGrill (4975 in chips) 
Seat 2: Dionakabarbi (4960 in chips) 
Seat 3: TriviGn'R (5015 in chips) 
Seat 4: rapo007 (4930 in chips) 
Seat 5: moitzi82 (5000 in chips) 
Seat 6: buzios38 (5530 in chips) 
Seat 7: Galli181 (5000 in chips) out of hand (moved from another table into small blind)
Seat 8: luisnrd (4885 in chips) 
Seat 9: kylix42 (5060 in chips) 
GambleGrill: posts the ante 5
Dionakabarbi: posts the ante 5
TriviGn'R: posts the ante 5
rapo007: posts the ante 5
moitzi82: posts the ante 5
buzios38: posts the ante 5
luisnrd: posts the ante 5
kylix42: posts the ante 5
luisnrd: posts small blind 15
kylix42: posts big blind 30
*** HOLE CARDS ***
GambleGrill: folds 
Dionakabarbi: folds 
TriviGn'R: folds 
rapo007: folds 
moitzi82: raises 45 to 75
buzios38: folds 
luisnrd: folds 
kylix42: folds 
Uncalled bet (45) returned to moitzi82
moitzi82 collected 115 from pot
moitzi82: doesn't show hand 
*** SUMMARY ***
Total pot 115 | Rake 0 
Seat 1: GambleGrill folded before Flop (didn't bet)
Seat 2: Dionakabarbi folded before Flop (didn't bet)
Seat 3: TriviGn'R folded before Flop (didn't bet)
Seat 4: rapo007 folded before Flop (didn't bet)
Seat 5: moitzi82 collected (115)
Seat 6: buzios38 (button) folded before Flop (didn't bet)
Seat 8: luisnrd (small blind) folded before Flop
Seat 9: kylix42 (big blind) folded before Flop



PokerStars Hand #157575267443: Tournament #1641817620, $7.50+$7.50+$1.50 USD Hold'em No Limit - Level I (15/30) - 2016/08/21 18:35:27 ET
Table '1641817620 56' 9-max Seat #5 is the button
Seat 1: PpME_Oe_87 (4980 in chips) 
Seat 2: NrRockeT9 (4635 in chips) 
Seat 3: DontFoldItPL (3870 in chips) 
Seat 4: cla11 (5730 in chips) 
Seat 5: luvlust (4725 in chips) 
Seat 6: vandereecken (5000 in chips) out of hand (moved from another table into small blind)
Seat 7: rickyrdmy (4950 in chips) 
Seat 8: M.J.466 (5970 in chips) 
Seat 9: Exan13 (5155 in chips) 
PpME_Oe_87: posts the ante 5
NrRockeT9: posts the ante 5
DontFoldItPL: posts the ante 5
cla11: posts the ante 5
luvlust: posts the ante 5
rickyrdmy: posts the ante 5
M.J.466: posts the ante 5
Exan13: posts the ante 5
rickyrdmy: posts small blind 15
M.J.466: posts big blind 30
*** HOLE CARDS ***
Exan13: raises 60 to 90
PpME_Oe_87: folds 
NrRockeT9: raises 265 to 355
DontFoldItPL: folds 
cla11: folds 
luvlust: folds 
rickyrdmy: folds 
M.J.466: folds 
Exan13: folds 
Uncalled bet (265) returned to NrRockeT9
NrRockeT9 collected 265 from pot
NrRockeT9: doesn't show hand 
*** SUMMARY ***
Total pot 265 | Rake 0 
Seat 1: PpME_Oe_87 folded before Flop (didn't bet)
Seat 2: NrRockeT9 collected (265)
Seat 3: DontFoldItPL folded before Flop (didn't bet)
Seat 4: cla11 folded before Flop (didn't bet)
Seat 5: luvlust (button) folded before Flop (didn't bet)
Seat 7: rickyrdmy (small blind) folded before Flop
Seat 8: M.J.466 (big blind) folded before Flop
Seat 9: Exan13 folded before Flop



PokerStars Hand #157575267560: Tournament #1641817620, $7.50+$7.50+$1.50 USD Hold'em No Limit - Level I (15/30) - 2016/08/21 18:35:28 ET
Table '1641817620 37' 9-max Seat #1 is the button
Seat 1: Youbetipush1 (4860 in chips) 
Seat 2: SouzaEduardo (4920 in chips) 
Seat 3: Maisteri (7265 in chips) 
Seat 4: qball911 (4860 in chips) 
Seat 5: dell1961 (4835 in chips) 
Seat 6: ColdFire_200 (4875 in chips) 
Seat 7: loachxm (4870 in chips) 
Seat 8: mikke8282 (5260 in chips) 
Seat 9: CHIQUIDEALER (5000 in chips) 
Youbetipush1: posts the ante 5
SouzaEduardo: posts the ante 5
Maisteri: posts the ante 5
qball911: posts the ante 5
dell1961: posts the ante 5
ColdFire_200: posts the ante 5
loachxm: posts the ante 5
mikke8282: posts the ante 5
CHIQUIDEALER: posts the ante 5
SouzaEduardo: posts small blind 15
Maisteri: posts big blind 30
*** HOLE CARDS ***
qball911: folds 
dell1961: folds 
ColdFire_200: raises 36 to 66
loachxm: folds 
mikke8282: calls 66
CHIQUIDEALER: folds 
Youbetipush1: calls 66
SouzaEduardo: folds 
Maisteri: calls 36
*** FLOP *** [Kh Ac 6c]
Maisteri: checks 
ColdFire_200: checks 
mikke8282: checks 
Youbetipush1: checks 
*** TURN *** [Kh Ac 6c] [Th]
Maisteri: checks 
ColdFire_200: checks 
mikke8282: checks 
Youbetipush1: checks 
*** RIVER *** [Kh Ac 6c Th] [2s]
Maisteri: checks 
ColdFire_200: checks 
mikke8282: checks 
Youbetipush1: checks 
*** SHOW DOWN ***
Maisteri: shows [4h 8c] (high card Ace)
ColdFire_200: shows [8d 9d] (high card Ace - King+Ten+Nine kicker)
mikke8282: shows [3c 3h] (a pair of Threes)
Youbetipush1: shows [Jh Js] (a pair of Jacks)
Youbetipush1 collected 324 from pot
*** SUMMARY ***
Total pot 324 | Rake 0 
Board [Kh Ac 6c Th 2s]
Seat 1: Youbetipush1 (button) showed [Jh Js] and won (324) with a pair of Jacks
Seat 2: SouzaEduardo (small blind) folded before Flop
Seat 3: Maisteri (big blind) showed [4h 8c] and lost with high card Ace
Seat 4: qball911 folded before Flop (didn't bet)
Seat 5: dell1961 folded before Flop (didn't bet)
Seat 6: ColdFire_200 showed [8d 9d] and lost with high card Ace
Seat 7: loachxm folded before Flop (didn't bet)
Seat 8: mikke8282 showed [3c 3h] and lost with a pair of Threes
Seat 9: CHIQUIDEALER folded before Flop (didn't bet)



PokerStars Hand #157575269185: Tournament #1641817620, $7.50+$7.50+$1.50 USD Hold'em No Limit - Level I (15/30) - 2016/08/21 18:35:30 ET
Table '1641817620 14' 9-max Seat #5 is the button
Seat 1: japazzz1001 (4980 in chips) 
Seat 2: zigolo77 (5265 in chips) 
Seat 3: $Koha$88 (4875 in chips) 
Seat 4: Ed_brisal (5010 in chips) 
Seat 5: kashlaw (4910 in chips) 
Seat 6: sweetlips6 (4522 in chips) 
Seat 8: tim_pro_405! (4980 in chips) 
Seat 9: bacibaci67 (5070 in chips) 
japazzz1001: posts the ante 5
zigolo77: posts the ante 5
$Koha$88: posts the ante 5
Ed_brisal: posts the ante 5
kashlaw: posts the ante 5
sweetlips6: posts the ante 5
tim_pro_405!: posts the ante 5
bacibaci67: posts the ante 5
sweetlips6: posts small blind 15
tim_pro_405!: posts big blind 30
*** HOLE CARDS ***
bacibaci67: folds 
japazzz1001: calls 30
zigolo77: folds 
$Koha$88: raises 30 to 60
Ed_brisal: calls 60
kashlaw: calls 60
sweetlips6: raises 330 to 390
tim_pro_405!: folds 
japazzz1001: calls 360
$Koha$88: calls 330
Ed_brisal: folds 
kashlaw: calls 330
*** FLOP *** [6d 2c Td]
sweetlips6: checks 
japazzz1001: checks 
$Koha$88: checks 
kashlaw: bets 720
sweetlips6: folds 
japazzz1001: calls 720
$Koha$88: folds 
*** TURN *** [6d 2c Td] [6h]
japazzz1001: checks 
kashlaw: bets 1440
japazzz1001: calls 1440
*** RIVER *** [6d 2c Td 6h] [5d]
japazzz1001: checks 
kashlaw: checks 
*** SHOW DOWN ***
japazzz1001: shows [Th Js] (two pair, Tens and Sixes)
kashlaw: mucks hand 
japazzz1001 collected 6010 from pot
*** SUMMARY ***
Total pot 6010 | Rake 0 
Board [6d 2c Td 6h 5d]
Seat 1: japazzz1001 showed [Th Js] and won (6010) with two pair, Tens and Sixes
Seat 2: zigolo77 folded before Flop (didn't bet)
Seat 3: $Koha$88 folded on the Flop
Seat 4: Ed_brisal folded before Flop
Seat 5: kashlaw (button) mucked
Seat 6: sweetlips6 (small blind) folded on the Flop
Seat 8: tim_pro_405! (big blind) folded before Flop
Seat 9: bacibaci67 folded before Flop (didn't bet)



PokerStars Hand #157575270986: Tournament #1641817620, $7.50+$7.50+$1.50 USD Hold'em No Limit - Level I (15/30) - 2016/08/21 18:35:33 ET
Table '1641817620 40' 9-max Seat #7 is the button
Seat 2: nico122527 (4925 in chips) 
Seat 3: ilico (5389 in chips) 
Seat 4: Mr_Giiba (5030 in chips) 
Seat 5: mario342 (5120 in chips) 
Seat 6: MON3Y$HOT (5225 in chips) 
Seat 7: hyratsch (4426 in chips) 
Seat 8: arthuzinho (5000 in chips) out of hand (moved from another table into small blind)
Seat 9: kafu123 (4940 in chips) is sitting out
nico122527: posts the ante 5
ilico: posts the ante 5
Mr_Giiba: posts the ante 5
mario342: posts the ante 5
MON3Y$HOT: posts the ante 5
hyratsch: posts the ante 5
kafu123: posts the ante 5
kafu123: posts small blind 15
nico122527: posts big blind 30
*** HOLE CARDS ***
ilico: raises 52 to 82
Mr_Giiba: calls 82
mario342: folds 
MON3Y$HOT: folds 
hyratsch: folds 
kafu123: folds 
nico122527: calls 52
*** FLOP *** [Ks 2c 2d]
nico122527: checks 
ilico: bets 153
Mr_Giiba: folds 
nico122527: folds 
Uncalled bet (153) returned to ilico
ilico collected 296 from pot
*** SUMMARY ***
Total pot 296 | Rake 0 
Board [Ks 2c 2d]
Seat 2: nico122527 (big blind) folded on the Flop
Seat 3: ilico collected (296)
Seat 4: Mr_Giiba folded on the Flop
Seat 5: mario342 folded before Flop (didn't bet)
Seat 6: MON3Y$HOT folded before Flop (didn't bet)
Seat 7: hyratsch (button) folded before Flop (didn't bet)
Seat 9: kafu123 (small blind) folded before Flop



PokerStars Hand #157575272527: Tournament #1641817620, $7.50+$7.50+$1.50 USD Hold'em No Limit - Level I (15/30) - 2016/08/21 18:35:35 ET
Table '1641817620 9' 9-max Seat #8 is the button
Seat 2: Splef (5000 in chips) 
Seat 3: portugajr007 (5623 in chips) 
Seat 4: punkhead89 (5517 in chips) 
Seat 5: nO bUsTeD (4715 in chips) 
Seat 6: Greeno93 (4995 in chips) 
Seat 7: Cuzco83 (5070 in chips) 
Seat 8: maurogynppp (4850 in chips) 
Seat 9: N1COLOSO (4760 in chips) 
Splef: posts the ante 5
portugajr007: posts the ante 5
punkhead89: posts the ante 5
nO bUsTeD: posts the ante 5
Greeno93: posts the ante 5
Cuzco83: posts the ante 5
maurogynppp: posts the ante 5
N1COLOSO: posts the ante 5
N1COLOSO: posts small blind 15
Splef: posts big blind 30
*** HOLE CARDS ***
portugajr007: raises 30 to 60
punkhead89: folds 
nO bUsTeD: calls 60
Greeno93: folds 
Cuzco83: folds 
maurogynppp: folds 
N1COLOSO: folds 
Splef is connected 
Splef: calls 30
*** FLOP *** [8s 9d Jd]
Splef: checks 
portugajr007: checks 
nO bUsTeD: checks 
*** TURN *** [8s 9d Jd] [Kh]
Splef: checks 
portugajr007: checks 
nO bUsTeD: checks 
*** RIVER *** [8s 9d Jd Kh] [7c]
Splef: bets 156
portugajr007: folds 
nO bUsTeD: folds 
Uncalled bet (156) returned to Splef
Splef collected 235 from pot
Splef: doesn't show hand 
*** SUMMARY ***
Total pot 235 | Rake 0 
Board [8s 9d Jd Kh 7c]
Seat 2: Splef (big blind) collected (235)
Seat 3: portugajr007 folded on the River
Seat 4: punkhead89 folded before Flop (didn't bet)
Seat 5: nO bUsTeD folded on the River
Seat 6: Greeno93 folded before Flop (didn't bet)
Seat 7: Cuzco83 folded before Flop (didn't bet)
Seat 8: maurogynppp (button) folded before Flop (didn't bet)
Seat 9: N1COLOSO (small blind) folded before Flop



PokerStars Hand #157575273214: Tournament #1641817620, $7.50+$7.50+$1.50 USD Hold'em No Limit - Level I (15/30) - 2016/08/21 18:35:36 ET
Table '1641817620 26' 9-max Seat #1 is the button
Seat 1: duplo1182 (14170 in chips) 
Seat 2: Heretic66688 (4955 in chips) 
Seat 3: Axkj (4925 in chips) 
Seat 4: h1per1on (5270 in chips) 
Seat 5: zuzlica (1105 in chips) 
Seat 6: Archibal_17 (4515 in chips) 
Seat 7: GDLW26 (4850 in chips) 
Seat 8: maninshed (5000 in chips) 
duplo1182: posts the ante 5
Heretic66688: posts the ante 5
Axkj: posts the ante 5
h1per1on: posts the ante 5
zuzlica: posts the ante 5
Archibal_17: posts the ante 5
GDLW26: posts the ante 5
maninshed: posts the ante 5
Heretic66688: posts small blind 15
Axkj: posts big blind 30
*** HOLE CARDS ***
h1per1on: folds 
zuzlica: raises 115 to 145
Archibal_17: folds 
GDLW26: calls 145
maninshed: folds 
duplo1182: folds 
Heretic66688: folds 
Axkj: calls 115
*** FLOP *** [8s 2s 8c]
Axkj: checks 
zuzlica: checks 
GDLW26: bets 318
Axkj: folds 
zuzlica: folds 
Uncalled bet (318) returned to GDLW26
GDLW26 collected 490 from pot
GDLW26: doesn't show hand 
*** SUMMARY ***
Total pot 490 | Rake 0 
Board [8s 2s 8c]
Seat 1: duplo1182 (button) folded before Flop (didn't bet)
Seat 2: Heretic66688 (small blind) folded before Flop
Seat 3: Axkj (big blind) folded on the Flop
Seat 4: h1per1on folded before Flop (didn't bet)
Seat 5: zuzlica folded on the Flop
Seat 6: Archibal_17 folded before Flop (didn't bet)
Seat 7: GDLW26 collected (490)
Seat 8: maninshed folded before Flop (didn't bet)



PokerStars Hand #157575273239: Tournament #1641817620, $7.50+$7.50+$1.50 USD Hold'em No Limit - Level I (15/30) - 2016/08/21 18:35:37 ET
Table '1641817620 22' 9-max Seat #8 is the button
Seat 1: iLvpoon (4995 in chips) 
Seat 2: hanshabraken (4990 in chips) 
Seat 3: CHININ118 (4584 in chips) 
Seat 4: Jaliplay (10095 in chips) 
Seat 5: hewx (10561 in chips) 
Seat 6: DannoPK (5000 in chips) 
Seat 7: ogotop76 (4920 in chips) 
Seat 8: monterreymx (4915 in chips) 
Seat 9: cash4king (4965 in chips) 
iLvpoon: posts the ante 5
hanshabraken: posts the ante 5
CHININ118: posts the ante 5
Jaliplay: posts the ante 5
hewx: posts the ante 5
DannoPK: posts the ante 5
ogotop76: posts the ante 5
monterreymx: posts the ante 5
cash4king: posts the ante 5
cash4king: posts small blind 15
iLvpoon: posts big blind 30
*** HOLE CARDS ***
hanshabraken: folds 
CHININ118: folds 
Jaliplay: folds 
hewx: folds 
DannoPK: raises 45 to 75
ogotop76: folds 
monterreymx: folds 
cash4king: calls 60
iLvpoon: folds 
*** FLOP *** [9d Qd Th]
cash4king: checks 
DannoPK: bets 120
cash4king: folds 
Uncalled bet (120) returned to DannoPK
DannoPK collected 225 from pot
DannoPK: doesn't show hand 
*** SUMMARY ***
Total pot 225 | Rake 0 
Board [9d Qd Th]
Seat 1: iLvpoon (big blind) folded before Flop
Seat 2: hanshabraken folded before Flop (didn't bet)
Seat 3: CHININ118 folded before Flop (didn't bet)
Seat 4: Jaliplay folded before Flop (didn't bet)
Seat 5: hewx folded before Flop (didn't bet)
Seat 6: DannoPK collected (225)
Seat 7: ogotop76 folded before Flop (didn't bet)
Seat 8: monterreymx (button) folded before Flop (didn't bet)
Seat 9: cash4king (small blind) folded on the Flop



PokerStars Hand #157575274013: Tournament #1641817620, $7.50+$7.50+$1.50 USD Hold'em No Limit - Level I (15/30) - 2016/08/21 18:35:38 ET
Table '1641817620 27' 9-max Seat #6 is the button
Seat 1: TheKaisa87 (4765 in chips) 
Seat 2: Stejam (4995 in chips) 
Seat 3: SweetieSpy (6054 in chips) 
Seat 4: Mr_Buckworth (5235 in chips) 
Seat 5: ladymadon107 (4365 in chips) 
Seat 6: 6aDyHtry (4355 in chips) 
Seat 7: pimenikos (5000 in chips) out of hand (moved from another table into small blind)
Seat 8: MasteDonBull (4930 in chips) 
Seat 9: kyzyldurrr (5361 in chips) 
TheKaisa87: posts the ante 5
Stejam: posts the ante 5
SweetieSpy: posts the ante 5
Mr_Buckworth: posts the ante 5
ladymadon107: posts the ante 5
6aDyHtry: posts the ante 5
MasteDonBull: posts the ante 5
kyzyldurrr: posts the ante 5
MasteDonBull: posts small blind 15
kyzyldurrr: posts big blind 30
*** HOLE CARDS ***
TheKaisa87: calls 30
Stejam: calls 30
SweetieSpy: folds 
Mr_Buckworth: calls 30
ladymadon107: folds 
6aDyHtry: folds 
MasteDonBull: calls 15
kyzyldurrr: checks 
*** FLOP *** [As Ad 8c]
MasteDonBull: checks 
kyzyldurrr: checks 
TheKaisa87: bets 60
Stejam: folds 
Mr_Buckworth: calls 60
MasteDonBull: calls 60
kyzyldurrr: folds 
*** TURN *** [As Ad 8c] [6h]
MasteDonBull: checks 
TheKaisa87: bets 90
Mr_Buckworth: raises 270 to 360
MasteDonBull: calls 360
TheKaisa87: folds 
*** RIVER *** [As Ad 8c 6h] [2c]
MasteDonBull: bets 600
Mr_Buckworth: calls 600
*** SHOW DOWN ***
MasteDonBull: shows [6c Ac] (a full house, Aces full of Sixes)
Mr_Buckworth: mucks hand 
MasteDonBull collected 2380 from pot
*** SUMMARY ***
Total pot 2380 | Rake 0 
Board [As Ad 8c 6h 2c]
Seat 1: TheKaisa87 folded on the Turn
Seat 2: Stejam folded on the Flop
Seat 3: SweetieSpy folded before Flop (didn't bet)
Seat 4: Mr_Buckworth mucked
Seat 5: ladymadon107 folded before Flop (didn't bet)
Seat 6: 6aDyHtry (button) folded before Flop (didn't bet)
Seat 8: MasteDonBull (small blind) showed [6c Ac] and won (2380) with a full house, Aces full of Sixes
Seat 9: kyzyldurrr (big blind) folded on the Flop



PokerStars Hand #157575275186: Tournament #1641817620, $7.50+$7.50+$1.50 USD Hold'em No Limit - Level I (15/30) - 2016/08/21 18:35:40 ET
Table '1641817620 13' 9-max Seat #6 is the button
Seat 1: Mindthis (3228 in chips) 
Seat 2: nicka501 (10568 in chips) 
Seat 3: POG_Q4 (7203 in chips) 
Seat 4: sutherland43 (4935 in chips) 
Seat 5: LarikkadoAA (4935 in chips) 
Seat 6: MicroStaker5 (4443 in chips) 
Seat 7: MrMalaLeche (4945 in chips) 
Seat 8: EdsonPecly (4984 in chips) 
Seat 9: wantuirpoker (4754 in chips) 
Mindthis: posts the ante 5
nicka501: posts the ante 5
POG_Q4: posts the ante 5
sutherland43: posts the ante 5
LarikkadoAA: posts the ante 5
MicroStaker5: posts the ante 5
MrMalaLeche: posts the ante 5
EdsonPecly: posts the ante 5
wantuirpoker: posts the ante 5
MrMalaLeche: posts small blind 15
EdsonPecly: posts big blind 30
*** HOLE CARDS ***
wantuirpoker: folds 
Mindthis: folds 
nicka501: calls 30
POG_Q4: folds 
sutherland43: folds 
LarikkadoAA: calls 30
MicroStaker5: folds 
MrMalaLeche: folds 
EdsonPecly: checks 
*** FLOP *** [Ac 5c 3s]
EdsonPecly: checks 
nicka501: checks 
LarikkadoAA: bets 75
EdsonPecly: folds 
nicka501: folds 
Uncalled bet (75) returned to LarikkadoAA
LarikkadoAA collected 150 from pot
*** SUMMARY ***
Total pot 150 | Rake 0 
Board [Ac 5c 3s]
Seat 1: Mindthis folded before Flop (didn't bet)
Seat 2: nicka501 folded on the Flop
Seat 3: POG_Q4 folded before Flop (didn't bet)
Seat 4: sutherland43 folded before Flop (didn't bet)
Seat 5: LarikkadoAA collected (150)
Seat 6: MicroStaker5 (button) folded before Flop (didn't bet)
Seat 7: MrMalaLeche (small blind) folded before Flop
Seat 8: EdsonPecly (big blind) folded on the Flop
Seat 9: wantuirpoker folded before Flop (didn't bet)



PokerStars Hand #157575275967: Tournament #1641817620, $7.50+$7.50+$1.50 USD Hold'em No Limit - Level I (15/30) - 2016/08/21 18:35:41 ET
Table '1641817620 6' 9-max Seat #9 is the button
Seat 1: ASTRAXANSKI (4940 in chips) 
Seat 2: KOT-BEGEMOT6 (4955 in chips) 
Seat 3: agneseagnese (4950 in chips) 
Seat 4: mekkoramarha (4950 in chips) 
Seat 5: KKKistKKK (3809 in chips) 
Seat 6: brown1967 (5005 in chips) 
Seat 7: Balotelli195 (10145 in chips) 
Seat 9: Jelsomino79 (6251 in chips) 
ASTRAXANSKI: posts the ante 5
KOT-BEGEMOT6: posts the ante 5
agneseagnese: posts the ante 5
mekkoramarha: posts the ante 5
KKKistKKK: posts the ante 5
brown1967: posts the ante 5
Balotelli195: posts the ante 5
Jelsomino79: posts the ante 5
ASTRAXANSKI: posts small blind 15
KOT-BEGEMOT6: posts big blind 30
*** HOLE CARDS ***
agneseagnese: calls 30
mekkoramarha: calls 30
KKKistKKK: folds 
brown1967: calls 30
Balotelli195: folds 
Jelsomino79: folds 
ASTRAXANSKI: folds 
KOT-BEGEMOT6: checks 
*** FLOP *** [2s Tc Qc]
KOT-BEGEMOT6: checks 
agneseagnese: checks 
mekkoramarha: checks 
brown1967: checks 
*** TURN *** [2s Tc Qc] [5s]
KOT-BEGEMOT6: checks 
agneseagnese: checks 
mekkoramarha: bets 108
brown1967: folds 
KOT-BEGEMOT6: folds 
agneseagnese: calls 108
*** RIVER *** [2s Tc Qc 5s] [4s]
agneseagnese: checks 
mekkoramarha: checks 
*** SHOW DOWN ***
agneseagnese: shows [2c 2h] (three of a kind, Deuces)
mekkoramarha: mucks hand 
agneseagnese collected 391 from pot
*** SUMMARY ***
Total pot 391 | Rake 0 
Board [2s Tc Qc 5s 4s]
Seat 1: ASTRAXANSKI (small blind) folded before Flop
Seat 2: KOT-BEGEMOT6 (big blind) folded on the Turn
Seat 3: agneseagnese showed [2c 2h] and won (391) with three of a kind, Deuces
Seat 4: mekkoramarha mucked
Seat 5: KKKistKKK folded before Flop (didn't bet)
Seat 6: brown1967 folded on the Turn
Seat 7: Balotelli195 folded before Flop (didn't bet)
Seat 9: Jelsomino79 (button) folded before Flop (didn't bet)



PokerStars Hand #157575276876: Tournament #1641817620, $7.50+$7.50+$1.50 USD Hold'em No Limit - Level I (15/30) - 2016/08/21 18:35:42 ET
Table '1641817620 51' 9-max Seat #6 is the button
Seat 1: yys000 (5200 in chips) 
Seat 2: paulotury (5530 in chips) 
Seat 3: kozloeric (4803 in chips) 
Seat 4: bastef79 (4841 in chips) 
Seat 5: cusirc (4930 in chips) 
Seat 6: demonas05 (5274 in chips) 
Seat 7: boostyz (4915 in chips) 
Seat 8: Garfild740 (4975 in chips) 
Seat 9: Kalvar1 (4532 in chips) 
yys000: posts the ante 5
paulotury: posts the ante 5
kozloeric: posts the ante 5
bastef79: posts the ante 5
cusirc: posts the ante 5
demonas05: posts the ante 5
boostyz: posts the ante 5
Garfild740: posts the ante 5
Kalvar1: posts the ante 5
boostyz: posts small blind 15
Garfild740: posts big blind 30
*** HOLE CARDS ***
Kalvar1: folds 
yys000: folds 
paulotury: folds 
kozloeric: folds 
bastef79: folds 
cusirc: raises 30 to 60
demonas05: calls 60
boostyz: calls 45
Garfild740: raises 285 to 345
cusirc: folds 
demonas05: folds 
boostyz: calls 285
*** FLOP *** [4h 8d 2c]
boostyz: checks 
Garfild740: checks 
*** TURN *** [4h 8d 2c] [4s]
boostyz: checks 
Garfild740: checks 
*** RIVER *** [4h 8d 2c 4s] [Js]
boostyz: checks 
Garfild740: checks 
*** SHOW DOWN ***
boostyz: shows [As Qc] (a pair of Fours)
Garfild740: shows [Ad Qs] (a pair of Fours)
boostyz collected 428 from pot
Garfild740 collected 427 from pot
*** SUMMARY ***
Total pot 855 | Rake 0 
Board [4h 8d 2c 4s Js]
Seat 1: yys000 folded before Flop (didn't bet)
Seat 2: paulotury folded before Flop (didn't bet)
Seat 3: kozloeric folded before Flop (didn't bet)
Seat 4: bastef79 folded before Flop (didn't bet)
Seat 5: cusirc folded before Flop
Seat 6: demonas05 (button) folded before Flop
Seat 7: boostyz (small blind) showed [As Qc] and won (428) with a pair of Fours
Seat 8: Garfild740 (big blind) showed [Ad Qs] and won (427) with a pair of Fours
Seat 9: Kalvar1 folded before Flop (didn't bet)



PokerStars Hand #157575276937: Tournament #1641817620, $7.50+$7.50+$1.50 USD Hold'em No Limit - Level I (15/30) - 2016/08/21 18:35:42 ET
Table '1641817620 5' 9-max Seat #9 is the button
Seat 1: rirage_87 (4920 in chips) 
Seat 2: jonesfi5sh (6035 in chips) 
Seat 3: PhenomPen1 (5105 in chips) 
Seat 4: GrimJoker77 (4965 in chips) 
Seat 5: Bolfra1 (4820 in chips) 
Seat 6: Javicho9 (4535 in chips) 
Seat 7: pokertepec (4995 in chips) 
Seat 8: sloty27 (4865 in chips) 
Seat 9: chuny dealer (4655 in chips) 
rirage_87: posts the ante 5
jonesfi5sh: posts the ante 5
PhenomPen1: posts the ante 5
GrimJoker77: posts the ante 5
Bolfra1: posts the ante 5
Javicho9: posts the ante 5
pokertepec: posts the ante 5
sloty27: posts the ante 5
chuny dealer: posts the ante 5
rirage_87: posts small blind 15
jonesfi5sh: posts big blind 30
*** HOLE CARDS ***
PhenomPen1: folds 
GrimJoker77: folds 
Bolfra1: folds 
Javicho9: folds 
pokertepec: folds 
sloty27: folds 
chuny dealer: raises 45 to 75
rirage_87: calls 60
jonesfi5sh: calls 45
*** FLOP *** [4h 2c Ah]
rirage_87: checks 
jonesfi5sh: checks 
chuny dealer: checks 
*** TURN *** [4h 2c Ah] [4s]
rirage_87: checks 
jonesfi5sh: bets 60
chuny dealer: folds 
rirage_87: calls 60
*** RIVER *** [4h 2c Ah 4s] [5h]
rirage_87: checks 
jonesfi5sh: bets 120
rirage_87: folds 
Uncalled bet (120) returned to jonesfi5sh
jonesfi5sh collected 390 from pot
jonesfi5sh: doesn't show hand 
*** SUMMARY ***
Total pot 390 | Rake 0 
Board [4h 2c Ah 4s 5h]
Seat 1: rirage_87 (small blind) folded on the River
Seat 2: jonesfi5sh (big blind) collected (390)
Seat 3: PhenomPen1 folded before Flop (didn't bet)
Seat 4: GrimJoker77 folded before Flop (didn't bet)
Seat 5: Bolfra1 folded before Flop (didn't bet)
Seat 6: Javicho9 folded before Flop (didn't bet)
Seat 7: pokertepec folded before Flop (didn't bet)
Seat 8: sloty27 folded before Flop (didn't bet)
Seat 9: chuny dealer (button) folded on the Turn



PokerStars Hand #157575277157: Tournament #1641817620, $7.50+$7.50+$1.50 USD Hold'em No Limit - Level I (15/30) - 2016/08/21 18:35:43 ET
Table '1641817620 18' 9-max Seat #5 is the button
Seat 1: Declan387 (4282 in chips) 
Seat 2: silvina35 (5157 in chips) 
Seat 3: TBP23 (4117 in chips) 
Seat 4: One_Cigar (4935 in chips) 
Seat 5: 111santos (4785 in chips) 
Seat 6: Krauser2589 (5650 in chips) 
Seat 7: shaxmatiist (4980 in chips) 
Seat 8: Lestatdiego (4737 in chips) 
Seat 9: kokandija (6357 in chips) is sitting out
Declan387: posts the ante 5
silvina35: posts the ante 5
TBP23: posts the ante 5
One_Cigar: posts the ante 5
111santos: posts the ante 5
Krauser2589: posts the ante 5
shaxmatiist: posts the ante 5
Lestatdiego: posts the ante 5
kokandija: posts the ante 5
Krauser2589: posts small blind 15
shaxmatiist: posts big blind 30
*** HOLE CARDS ***
Lestatdiego: folds 
kokandija: folds 
Declan387: folds 
silvina35: folds 
TBP23: folds 
One_Cigar: folds 
111santos: folds 
Krauser2589: calls 15
shaxmatiist: checks 
*** FLOP *** [7c 8c 9s]
Krauser2589: checks 
shaxmatiist: checks 
*** TURN *** [7c 8c 9s] [4d]
Krauser2589: bets 60
shaxmatiist: folds 
Uncalled bet (60) returned to Krauser2589
Krauser2589 collected 105 from pot
*** SUMMARY ***
Total pot 105 | Rake 0 
Board [7c 8c 9s 4d]
Seat 1: Declan387 folded before Flop (didn't bet)
Seat 2: silvina35 folded before Flop (didn't bet)
Seat 3: TBP23 folded before Flop (didn't bet)
Seat 4: One_Cigar folded before Flop (didn't bet)
Seat 5: 111santos (button) folded before Flop (didn't bet)
Seat 6: Krauser2589 (small blind) collected (105)
Seat 7: shaxmatiist (big blind) folded on the Turn
Seat 8: Lestatdiego folded before Flop (didn't bet)
Seat 9: kokandija folded before Flop (didn't bet)



PokerStars Hand #157575277177: Tournament #1641817620, $7.50+$7.50+$1.50 USD Hold'em No Limit - Level I (15/30) - 2016/08/21 18:35:43 ET
Table '1641817620 23' 9-max Seat #7 is the button
Seat 1: Cepillo (4975 in chips) 
Seat 2: erfan86 (4960 in chips) 
Seat 4: Carlos11497 (4730 in chips) 
Seat 5: MickJagger86 (10065 in chips) 
Seat 6: wolll888 (5000 in chips) 
Seat 7: jradjo21 (4930 in chips) 
Seat 8: andrecosteau (5000 in chips) out of hand (moved from another table into small blind)
Seat 9: -MCASLAN7- (5150 in chips) 
Cepillo: posts the ante 5
erfan86: posts the ante 5
Carlos11497: posts the ante 5
MickJagger86: posts the ante 5
wolll888: posts the ante 5
jradjo21: posts the ante 5
-MCASLAN7-: posts the ante 5
-MCASLAN7-: posts small blind 15
Cepillo: posts big blind 30
*** HOLE CARDS ***
erfan86: raises 60 to 90
Carlos11497: folds 
MickJagger86: folds 
wolll888: folds 
jradjo21: folds 
-MCASLAN7-: folds 
Cepillo: calls 60
*** FLOP *** [9s 3h Qh]
Cepillo: checks 
erfan86: checks 
*** TURN *** [9s 3h Qh] [As]
Cepillo: checks 
erfan86: bets 144
Cepillo: folds 
Uncalled bet (144) returned to erfan86
erfan86 collected 230 from pot
erfan86: doesn't show hand 
*** SUMMARY ***
Total pot 230 | Rake 0 
Board [9s 3h Qh As]
Seat 1: Cepillo (big blind) folded on the Turn
Seat 2: erfan86 collected (230)
Seat 4: Carlos11497 folded before Flop (didn't bet)
Seat 5: MickJagger86 folded before Flop (didn't bet)
Seat 6: wolll888 folded before Flop (didn't bet)
Seat 7: jradjo21 (button) folded before Flop (didn't bet)
Seat 9: -MCASLAN7- (small blind) folded before Flop



PokerStars Hand #157575277516: Tournament #1641817620, $7.50+$7.50+$1.50 USD Hold'em No Limit - Level I (15/30) - 2016/08/21 18:35:43 ET
Table '1641817620 57' 9-max Seat #6 is the button
Seat 1: pedroh2010 (10170 in chips) 
Seat 2: PANOYRGIAS73 (6580 in chips) 
Seat 3: ovekas (5110 in chips) 
Seat 4: ALWAYSBRAVES (4930 in chips) 
Seat 5: BaDBeaT_AK85 (4930 in chips) 
Seat 6: kachumban (4855 in chips) 
Seat 7: ZodiakGB (4945 in chips) 
Seat 8: MeortheMrs (3505 in chips) 
Seat 9: andreiuc (4975 in chips) 
pedroh2010: posts the ante 5
PANOYRGIAS73: posts the ante 5
ovekas: posts the ante 5
ALWAYSBRAVES: posts the ante 5
BaDBeaT_AK85: posts the ante 5
kachumban: posts the ante 5
ZodiakGB: posts the ante 5
MeortheMrs: posts the ante 5
andreiuc: posts the ante 5
ZodiakGB: posts small blind 15
MeortheMrs: posts big blind 30
*** HOLE CARDS ***
andreiuc: raises 60 to 90
pedroh2010: calls 90
PANOYRGIAS73: folds 
ovekas: folds 
ALWAYSBRAVES: folds 
BaDBeaT_AK85: folds 
kachumban: folds 
ZodiakGB: folds 
MeortheMrs: folds 
*** FLOP *** [2h 2s 9c]
andreiuc: bets 120
pedroh2010: folds 
Uncalled bet (120) returned to andreiuc
andreiuc collected 270 from pot
andreiuc: doesn't show hand 
*** SUMMARY ***
Total pot 270 | Rake 0 
Board [2h 2s 9c]
Seat 1: pedroh2010 folded on the Flop
Seat 2: PANOYRGIAS73 folded before Flop (didn't bet)
Seat 3: ovekas folded before Flop (didn't bet)
Seat 4: ALWAYSBRAVES folded before Flop (didn't bet)
Seat 5: BaDBeaT_AK85 folded before Flop (didn't bet)
Seat 6: kachumban (button) folded before Flop (didn't bet)
Seat 7: ZodiakGB (small blind) folded before Flop
Seat 8: MeortheMrs (big blind) folded before Flop
Seat 9: andreiuc collected (270)



PokerStars Hand #157575278197: Tournament #1641817620, $7.50+$7.50+$1.50 USD Hold'em No Limit - Level I (15/30) - 2016/08/21 18:35:44 ET
Table '1641817620 34' 9-max Seat #7 is the button
Seat 1: MartinArg010 (5000 in chips) 
Seat 2: AngelBerley (4610 in chips) 
Seat 3: Zigslick (4925 in chips) 
Seat 4: Snabers (4745 in chips) 
Seat 5: juggaletto (5465 in chips) 
Seat 6: virtus213 (4730 in chips) 
Seat 7: Poher42 (5210 in chips) 
Seat 8: S.FILTH (4940 in chips) 
Seat 9: omar miete (5400 in chips) 
MartinArg010: posts the ante 5
AngelBerley: posts the ante 5
Zigslick: posts the ante 5
Snabers: posts the ante 5
juggaletto: posts the ante 5
virtus213: posts the ante 5
Poher42: posts the ante 5
S.FILTH: posts the ante 5
omar miete: posts the ante 5
S.FILTH: posts small blind 15
omar miete: posts big blind 30
*** HOLE CARDS ***
MartinArg010: raises 32 to 62
AngelBerley: folds 
Zigslick: folds 
Snabers: folds 
juggaletto: folds 
virtus213: folds 
Poher42: folds 
S.FILTH: folds 
omar miete: folds 
Uncalled bet (32) returned to MartinArg010
MartinArg010 collected 120 from pot
MartinArg010: doesn't show hand 
*** SUMMARY ***
Total pot 120 | Rake 0 
Seat 1: MartinArg010 collected (120)
Seat 2: AngelBerley folded before Flop (didn't bet)
Seat 3: Zigslick folded before Flop (didn't bet)
Seat 4: Snabers folded before Flop (didn't bet)
Seat 5: juggaletto folded before Flop (didn't bet)
Seat 6: virtus213 folded before Flop (didn't bet)
Seat 7: Poher42 (button) folded before Flop (didn't bet)
Seat 8: S.FILTH (small blind) folded before Flop
Seat 9: omar miete (big blind) folded before Flop



PokerStars Hand #157575278379: Tournament #1641817620, $7.50+$7.50+$1.50 USD Hold'em No Limit - Level I (15/30) - 2016/08/21 18:35:45 ET
Table '1641817620 49' 9-max Seat #6 is the button
Seat 1: Mi2xa (4980 in chips) 
Seat 2: abig89 (5579 in chips) 
Seat 3: nickviso (5055 in chips) 
Seat 4: Colt Cardz (4995 in chips) 
Seat 5: Can'tStopMee (4275 in chips) 
Seat 6: PaulDaPole (6058 in chips) 
Seat 7: Prebendk (4365 in chips) 
Seat 8: VixenKoala (4980 in chips) 
Seat 9: logos1428 (4718 in chips) 
Mi2xa: posts the ante 5
abig89: posts the ante 5
nickviso: posts the ante 5
Colt Cardz: posts the ante 5
Can'tStopMee: posts the ante 5
PaulDaPole: posts the ante 5
Prebendk: posts the ante 5
VixenKoala: posts the ante 5
logos1428: posts the ante 5
Prebendk: posts small blind 15
VixenKoala: posts big blind 30
*** HOLE CARDS ***
logos1428: calls 30
Mi2xa: folds 
abig89: folds 
nickviso: folds 
Colt Cardz: folds 
Can'tStopMee: folds 
PaulDaPole: folds 
Prebendk: folds 
VixenKoala: checks 
*** FLOP *** [4d 7d 3s]
VixenKoala: checks 
logos1428: bets 120
VixenKoala: calls 120
*** TURN *** [4d 7d 3s] [9c]
VixenKoala: checks 
logos1428: bets 360
VixenKoala: folds 
Uncalled bet (360) returned to logos1428
logos1428 collected 360 from pot
logos1428: doesn't show hand 
*** SUMMARY ***
Total pot 360 | Rake 0 
Board [4d 7d 3s 9c]
Seat 1: Mi2xa folded before Flop (didn't bet)
Seat 2: abig89 folded before Flop (didn't bet)
Seat 3: nickviso folded before Flop (didn't bet)
Seat 4: Colt Cardz folded before Flop (didn't bet)
Seat 5: Can'tStopMee folded before Flop (didn't bet)
Seat 6: PaulDaPole (button) folded before Flop (didn't bet)
Seat 7: Prebendk (small blind) folded before Flop
Seat 8: VixenKoala (big blind) folded on the Turn
Seat 9: logos1428 collected (360)



PokerStars Hand #157575278726: Tournament #1641817620, $7.50+$7.50+$1.50 USD Hold'em No Limit - Level I (15/30) - 2016/08/21 18:35:45 ET
Table '1641817620 4' 9-max Seat #5 is the button
Seat 1: coldboy23 (4992 in chips) 
Seat 2: Velho Sábio (4472 in chips) 
Seat 3: manukk2 (5490 in chips) 
Seat 4: slk55amg (4097 in chips) 
Seat 5: sica26 (5282 in chips) 
Seat 6: tamarak297 (5000 in chips) out of hand (moved from another table into small blind)
Seat 7: AleksZy (4950 in chips) 
Seat 8: petersonmach (4980 in chips) 
Seat 9: DagobertQuad (4907 in chips) 
coldboy23: posts the ante 5
Velho Sábio: posts the ante 5
manukk2: posts the ante 5
slk55amg: posts the ante 5
sica26: posts the ante 5
AleksZy: posts the ante 5
petersonmach: posts the ante 5
DagobertQuad: posts the ante 5
AleksZy: posts small blind 15
petersonmach: posts big blind 30
*** HOLE CARDS ***
DagobertQuad: raises 48 to 78
coldboy23: folds 
Velho Sábio: folds 
manukk2: folds 
slk55amg: folds 
sica26: folds 
AleksZy: calls 63
petersonmach: calls 48
*** FLOP *** [7d 3h 7s]
AleksZy: checks 
petersonmach: checks 
DagobertQuad: bets 145
AleksZy: folds 
petersonmach: folds 
Uncalled bet (145) returned to DagobertQuad
DagobertQuad collected 274 from pot
DagobertQuad: doesn't show hand 
*** SUMMARY ***
Total pot 274 | Rake 0 
Board [7d 3h 7s]
Seat 1: coldboy23 folded before Flop (didn't bet)
Seat 2: Velho Sábio folded before Flop (didn't bet)
Seat 3: manukk2 folded before Flop (didn't bet)
Seat 4: slk55amg folded before Flop (didn't bet)
Seat 5: sica26 (button) folded before Flop (didn't bet)
Seat 7: AleksZy (small blind) folded on the Flop
Seat 8: petersonmach (big blind) folded on the Flop
Seat 9: DagobertQuad collected (274)



PokerStars Hand #157575279261: Tournament #1641817620, $7.50+$7.50+$1.50 USD Hold'em No Limit - Level I (15/30) - 2016/08/21 18:35:46 ET
Table '1641817620 52' 9-max Seat #8 is the button
Seat 1: DoubleBBle (5465 in chips) 
Seat 2: FelipeMarlon (5195 in chips) 
Seat 3: michalis009 (4688 in chips) 
Seat 4: Daviderevan (4925 in chips) 
Seat 5: Armin2188 (4925 in chips) 
Seat 6: HORSEPOKER28 (5090 in chips) 
Seat 7: tatingo82 (5000 in chips) 
Seat 8: vladvladutz (5187 in chips) 
Seat 9: leothefirm (4950 in chips) 
DoubleBBle: posts the ante 5
FelipeMarlon: posts the ante 5
michalis009: posts the ante 5
Daviderevan: posts the ante 5
Armin2188: posts the ante 5
HORSEPOKER28: posts the ante 5
tatingo82: posts the ante 5
vladvladutz: posts the ante 5
leothefirm: posts the ante 5
leothefirm: posts small blind 15
DoubleBBle: posts big blind 30
*** HOLE CARDS ***
FelipeMarlon: folds 
michalis009: raises 45 to 75
Daviderevan: raises 240 to 315
Armin2188: folds 
HORSEPOKER28: folds 
tatingo82: folds 
vladvladutz: folds 
leothefirm: folds 
DoubleBBle: folds 
michalis009: calls 240
*** FLOP *** [Qd Kh 2d]
michalis009: checks 
Daviderevan: checks 
*** TURN *** [Qd Kh 2d] [3h]
michalis009: checks 
Daviderevan: checks 
*** RIVER *** [Qd Kh 2d 3h] [3c]
michalis009: bets 360
Daviderevan: calls 360
*** SHOW DOWN ***
michalis009: shows [6c Kc] (two pair, Kings and Threes)
Daviderevan: mucks hand 
michalis009 collected 1440 from pot
*** SUMMARY ***
Total pot 1440 | Rake 0 
Board [Qd Kh 2d 3h 3c]
Seat 1: DoubleBBle (big blind) folded before Flop
Seat 2: FelipeMarlon folded before Flop (didn't bet)
Seat 3: michalis009 showed [6c Kc] and won (1440) with two pair, Kings and Threes
Seat 4: Daviderevan mucked
Seat 5: Armin2188 folded before Flop (didn't bet)
Seat 6: HORSEPOKER28 folded before Flop (didn't bet)
Seat 7: tatingo82 folded before Flop (didn't bet)
Seat 8: vladvladutz (button) folded before Flop (didn't bet)
Seat 9: leothefirm (small blind) folded before Flop



PokerStars Hand #157575279622: Tournament #1641817620, $7.50+$7.50+$1.50 USD Hold'em No Limit - Level I (15/30) - 2016/08/21 18:35:46 ET
Table '1641817620 29' 9-max Seat #6 is the button
Seat 1: kidpokerjm89 (4975 in chips) 
Seat 2: niejowicz (4960 in chips) is sitting out
Seat 3: Ofbravetight (4930 in chips) 
Seat 4: Ottel (4150 in chips) 
Seat 5: puntoo (5275 in chips) 
Seat 6: Melady77777 (5995 in chips) 
Seat 7: fishfind000 (5035 in chips) 
Seat 8: AcePheres (4975 in chips) 
Seat 9: LAZO30 (4705 in chips) 
kidpokerjm89: posts the ante 5
niejowicz: posts the ante 5
Ofbravetight: posts the ante 5
Ottel: posts the ante 5
puntoo: posts the ante 5
Melady77777: posts the ante 5
fishfind000: posts the ante 5
AcePheres: posts the ante 5
LAZO30: posts the ante 5
fishfind000: posts small blind 15
AcePheres: posts big blind 30
*** HOLE CARDS ***
LAZO30: calls 30
kidpokerjm89: folds 
niejowicz: folds 
Ofbravetight: raises 60 to 90
Ottel: folds 
puntoo: calls 90
Melady77777: folds 
fishfind000: folds 
AcePheres: calls 60
LAZO30: calls 60
*** FLOP *** [As 4h Qs]
AcePheres: checks 
LAZO30: checks 
Ofbravetight: checks 
puntoo: bets 420
AcePheres: folds 
LAZO30: folds 
Ofbravetight: folds 
Uncalled bet (420) returned to puntoo
puntoo collected 420 from pot
*** SUMMARY ***
Total pot 420 | Rake 0 
Board [As 4h Qs]
Seat 1: kidpokerjm89 folded before Flop (didn't bet)
Seat 2: niejowicz folded before Flop (didn't bet)
Seat 3: Ofbravetight folded on the Flop
Seat 4: Ottel folded before Flop (didn't bet)
Seat 5: puntoo collected (420)
Seat 6: Melady77777 (button) folded before Flop (didn't bet)
Seat 7: fishfind000 (small blind) folded before Flop
Seat 8: AcePheres (big blind) folded on the Flop
Seat 9: LAZO30 folded on the Flop



PokerStars Hand #157575279641: Tournament #1641817620, $7.50+$7.50+$1.50 USD Hold'em No Limit - Level I (15/30) - 2016/08/21 18:35:46 ET
Table '1641817620 1' 9-max Seat #2 is the button
Seat 1: mattyonuts (4808 in chips) 
Seat 2: topaipi (6303 in chips) 
Seat 3: MAMOHT_T (4890 in chips) 
Seat 4: ManMaPayé (4980 in chips) 
Seat 5: LADIEFJ (5221 in chips) 
Seat 6: TheGuerreiro (4698 in chips) 
Seat 7: spiderhami (4990 in chips) 
Seat 8: K. Ichinose (4954 in chips) 
Seat 9: jonespkr (4995 in chips) 
mattyonuts: posts the ante 5
topaipi: posts the ante 5
MAMOHT_T: posts the ante 5
ManMaPayé: posts the ante 5
LADIEFJ: posts the ante 5
TheGuerreiro: posts the ante 5
spiderhami: posts the ante 5
K. Ichinose: posts the ante 5
jonespkr: posts the ante 5
MAMOHT_T: posts small blind 15
ManMaPayé: posts big blind 30
*** HOLE CARDS ***
LADIEFJ: folds 
TheGuerreiro: raises 45 to 75
spiderhami: folds 
K. Ichinose: folds 
jonespkr: calls 75
mattyonuts: calls 75
topaipi: folds 
MAMOHT_T: calls 60
ManMaPayé: calls 45
*** FLOP *** [Js 4d As]
MAMOHT_T: checks 
ManMaPayé: checks 
TheGuerreiro: checks 
jonespkr: bets 184
mattyonuts: calls 184
MAMOHT_T: folds 
ManMaPayé: calls 184
TheGuerreiro: calls 184
*** TURN *** [Js 4d As] [4c]
ManMaPayé: checks 
TheGuerreiro: checks 
jonespkr: bets 480
mattyonuts: folds 
ManMaPayé: calls 480
TheGuerreiro: folds 
*** RIVER *** [Js 4d As 4c] [Qh]
ManMaPayé: checks 
jonespkr: bets 931
ManMaPayé: calls 931
*** SHOW DOWN ***
jonespkr: shows [Ad Kh] (two pair, Aces and Fours)
ManMaPayé: mucks hand 
jonespkr collected 3978 from pot
*** SUMMARY ***
Total pot 3978 | Rake 0 
Board [Js 4d As 4c Qh]
Seat 1: mattyonuts folded on the Turn
Seat 2: topaipi (button) folded before Flop (didn't bet)
Seat 3: MAMOHT_T (small blind) folded on the Flop
Seat 4: ManMaPayé (big blind) mucked
Seat 5: LADIEFJ folded before Flop (didn't bet)
Seat 6: TheGuerreiro folded on the Turn
Seat 7: spiderhami folded before Flop (didn't bet)
Seat 8: K. Ichinose folded before Flop (didn't bet)
Seat 9: jonespkr showed [Ad Kh] and won (3978) with two pair, Aces and Fours



PokerStars Hand #157575282072: Tournament #1641817620, $7.50+$7.50+$1.50 USD Hold'em No Limit - Level I (15/30) - 2016/08/21 18:35:50 ET
Table '1641817620 3' 9-max Seat #9 is the button
Seat 1: IwantplayNL (5013 in chips) 
Seat 2: dufino (7131 in chips) 
Seat 3: zIggY-7-rAc3 (5220 in chips) 
Seat 4: gerald0jr (4920 in chips) 
Seat 5: Arkadius1975 (4985 in chips) 
Seat 6: BrunoCastroR (2440 in chips) 
Seat 7: alehirazawa (4920 in chips) 
Seat 8: markosharko (5356 in chips) 
Seat 9: VictorZh14 (5025 in chips) 
IwantplayNL: posts the ante 5
dufino: posts the ante 5
zIggY-7-rAc3: posts the ante 5
gerald0jr: posts the ante 5
Arkadius1975: posts the ante 5
BrunoCastroR: posts the ante 5
alehirazawa: posts the ante 5
markosharko: posts the ante 5
VictorZh14: posts the ante 5
IwantplayNL: posts small blind 15
dufino: posts big blind 30
*** HOLE CARDS ***
zIggY-7-rAc3: folds 
gerald0jr: folds 
Arkadius1975: folds 
BrunoCastroR: folds 
alehirazawa: folds 
markosharko: folds 
VictorZh14: raises 60 to 90
IwantplayNL: calls 75
dufino: folds 
*** FLOP *** [Ks Ah 8h]
IwantplayNL: checks 
VictorZh14: bets 127
IwantplayNL: calls 127
*** TURN *** [Ks Ah 8h] [7s]
IwantplayNL: checks 
VictorZh14: checks 
*** RIVER *** [Ks Ah 8h 7s] [Qc]
IwantplayNL: bets 178
VictorZh14: folds 
Uncalled bet (178) returned to IwantplayNL
IwantplayNL collected 509 from pot
IwantplayNL: doesn't show hand 
*** SUMMARY ***
Total pot 509 | Rake 0 
Board [Ks Ah 8h 7s Qc]
Seat 1: IwantplayNL (small blind) collected (509)
Seat 2: dufino (big blind) folded before Flop
Seat 3: zIggY-7-rAc3 folded before Flop (didn't bet)
Seat 4: gerald0jr folded before Flop (didn't bet)
Seat 5: Arkadius1975 folded before Flop (didn't bet)
Seat 6: BrunoCastroR folded before Flop (didn't bet)
Seat 7: alehirazawa folded before Flop (didn't bet)
Seat 8: markosharko folded before Flop (didn't bet)
Seat 9: VictorZh14 (button) folded on the River



PokerStars Hand #157575282369: Tournament #1641817620, $7.50+$7.50+$1.50 USD Hold'em No Limit - Level I (15/30) - 2016/08/21 18:35:51 ET
Table '1641817620 46' 9-max Seat #7 is the button
Seat 1: Kotakera (4808 in chips) 
Seat 2: estebangocu (4870 in chips) 
Seat 3: butler992 (4870 in chips) 
Seat 4: ZuzanaM (4930 in chips) 
Seat 5: Koeike (4830 in chips) 
Seat 6: JohnJohnnnnn (5000 in chips) 
Seat 7: clavito691 (5596 in chips) 
Seat 8: Violetarose (10116 in chips) 
Kotakera: posts the ante 5
estebangocu: posts the ante 5
butler992: posts the ante 5
ZuzanaM: posts the ante 5
Koeike: posts the ante 5
JohnJohnnnnn: posts the ante 5
clavito691: posts the ante 5
Violetarose: posts the ante 5
Violetarose: posts small blind 15
Kotakera: posts big blind 30
*** HOLE CARDS ***
estebangocu: folds 
butler992: folds 
ZuzanaM: folds 
Koeike: folds 
JohnJohnnnnn: raises 65 to 95
clavito691: raises 145 to 240
Violetarose: folds 
Kotakera: folds 
JohnJohnnnnn: calls 145
*** FLOP *** [9s Jh Js]
JohnJohnnnnn: checks 
clavito691: bets 276
JohnJohnnnnn: folds 
Uncalled bet (276) returned to clavito691
clavito691 collected 565 from pot
*** SUMMARY ***
Total pot 565 | Rake 0 
Board [9s Jh Js]
Seat 1: Kotakera (big blind) folded before Flop
Seat 2: estebangocu folded before Flop (didn't bet)
Seat 3: butler992 folded before Flop (didn't bet)
Seat 4: ZuzanaM folded before Flop (didn't bet)
Seat 5: Koeike folded before Flop (didn't bet)
Seat 6: JohnJohnnnnn folded on the Flop
Seat 7: clavito691 (button) collected (565)
Seat 8: Violetarose (small blind) folded before Flop



PokerStars Hand #157575283258: Tournament #1641817620, $7.50+$7.50+$1.50 USD Hold'em No Limit - Level I (15/30) - 2016/08/21 18:35:52 ET
Table '1641817620 21' 9-max Seat #7 is the button
Seat 1: apaixtos1 (5420 in chips) 
Seat 2: ukr_durrrr (4835 in chips) 
Seat 3: ultgamb (4925 in chips) 
Seat 4: fishin1981 (4790 in chips) 
Seat 5: jeroma123 (4880 in chips) 
Seat 6: olleggi (5015 in chips) 
Seat 7: pokerlazik (4925 in chips) 
Seat 8: pokerist2692 (4771 in chips) 
Seat 9: Ferrazz (5439 in chips) 
apaixtos1: posts the ante 5
ukr_durrrr: posts the ante 5
ultgamb: posts the ante 5
fishin1981: posts the ante 5
jeroma123: posts the ante 5
olleggi: posts the ante 5
pokerlazik: posts the ante 5
pokerist2692: posts the ante 5
Ferrazz: posts the ante 5
pokerist2692: posts small blind 15
Ferrazz: posts big blind 30
*** HOLE CARDS ***
apaixtos1: raises 60 to 90
ukr_durrrr: folds 
ultgamb: folds 
fishin1981: folds 
jeroma123: folds 
olleggi: calls 90
pokerlazik: calls 90
pokerist2692: folds 
Ferrazz: calls 60
*** FLOP *** [Js 4d 3c]
Ferrazz: checks 
apaixtos1: bets 420
olleggi: calls 420
pokerlazik: raises 840 to 1260
Ferrazz: folds 
apaixtos1: raises 4065 to 5325 and is all-in
olleggi: folds 
pokerlazik: calls 3570 and is all-in
Uncalled bet (495) returned to apaixtos1
*** TURN *** [Js 4d 3c] [Qs]
*** RIVER *** [Js 4d 3c Qs] [2d]
*** SHOW DOWN ***
apaixtos1: shows [Jc Ad] (a pair of Jacks)
pokerlazik: shows [Ks Jh] (a pair of Jacks - lower kicker)
apaixtos1 collected 10500 from pot
apaixtos1 wins $3.75 for eliminating pokerlazik and their own bounty increases by $3.75 to $11.25
pokerlazik finished the tournament in 999999983rd place
*** SUMMARY ***
Total pot 10500 | Rake 0 
Board [Js 4d 3c Qs 2d]
Seat 1: apaixtos1 showed [Jc Ad] and won (10500) with a pair of Jacks
Seat 2: ukr_durrrr folded before Flop (didn't bet)
Seat 3: ultgamb folded before Flop (didn't bet)
Seat 4: fishin1981 folded before Flop (didn't bet)
Seat 5: jeroma123 folded before Flop (didn't bet)
Seat 6: olleggi folded on the Flop
Seat 7: pokerlazik (button) showed [Ks Jh] and lost with a pair of Jacks
Seat 8: pokerist2692 (small blind) folded before Flop
Seat 9: Ferrazz (big blind) folded on the Flop



PokerStars Hand #157575283798: Tournament #1641817620, $7.50+$7.50+$1.50 USD Hold'em No Limit - Level I (15/30) - 2016/08/21 18:35:53 ET
Table '1641817620 47' 9-max Seat #7 is the button
Seat 1: sovikeen (5065 in chips) 
Seat 2: RipperRooo (5350 in chips) 
Seat 3: gtavares10 (4867 in chips) 
Seat 4: FredyROKSTAR (4990 in chips) 
Seat 5: IvnAK (4630 in chips) 
Seat 6: sergiooker (5318 in chips) 
Seat 7: T3chnojunk (4930 in chips) 
Seat 8: bruff3l (4970 in chips) 
Seat 9: ppmaster (4885 in chips) 
sovikeen: posts the ante 5
RipperRooo: posts the ante 5
gtavares10: posts the ante 5
FredyROKSTAR: posts the ante 5
IvnAK: posts the ante 5
sergiooker: posts the ante 5
T3chnojunk: posts the ante 5
bruff3l: posts the ante 5
ppmaster: posts the ante 5
bruff3l: posts small blind 15
ppmaster: posts big blind 30
*** HOLE CARDS ***
sovikeen: folds 
RipperRooo: folds 
gtavares10: folds 
FredyROKSTAR: folds 
IvnAK: folds 
sergiooker: raises 49 to 79
T3chnojunk: calls 79
bruff3l: folds 
ppmaster: folds 
*** FLOP *** [2s Qh 6d]
sergiooker: checks 
T3chnojunk: checks 
*** TURN *** [2s Qh 6d] [Td]
sergiooker: bets 150
T3chnojunk: calls 150
*** RIVER *** [2s Qh 6d Td] [9h]
sergiooker: bets 274
T3chnojunk: calls 274
*** SHOW DOWN ***
sergiooker: shows [Kd Th] (a pair of Tens)
T3chnojunk: shows [Qc Ks] (a pair of Queens)
T3chnojunk collected 1096 from pot
*** SUMMARY ***
Total pot 1096 | Rake 0 
Board [2s Qh 6d Td 9h]
Seat 1: sovikeen folded before Flop (didn't bet)
Seat 2: RipperRooo folded before Flop (didn't bet)
Seat 3: gtavares10 folded before Flop (didn't bet)
Seat 4: FredyROKSTAR folded before Flop (didn't bet)
Seat 5: IvnAK folded before Flop (didn't bet)
Seat 6: sergiooker showed [Kd Th] and lost with a pair of Tens
Seat 7: T3chnojunk (button) showed [Qc Ks] and won (1096) with a pair of Queens
Seat 8: bruff3l (small blind) folded before Flop
Seat 9: ppmaster (big blind) folded before Flop



PokerStars Hand #157575284276: Tournament #1641817620, $7.50+$7.50+$1.50 USD Hold'em No Limit - Level I (15/30) - 2016/08/21 18:35:54 ET
Table '1641817620 32' 9-max Seat #8 is the button
Seat 1: RoribeiroS (6553 in chips) 
Seat 2: tomgan (4950 in chips) 
Seat 3: patou99957 (4321 in chips) 
Seat 4: JAhodaZ (4745 in chips) 
Seat 5: bdiddy1313 (5845 in chips) 
Seat 6: 69 hearts 69 (4156 in chips) 
Seat 7: rimis9999 (4925 in chips) 
Seat 8: noah5555 (4625 in chips) 
Seat 9: feoh488 (5000 in chips) out of hand (moved from another table into small blind)
RoribeiroS: posts the ante 5
tomgan: posts the ante 5
patou99957: posts the ante 5
JAhodaZ: posts the ante 5
bdiddy1313: posts the ante 5
69 hearts 69: posts the ante 5
rimis9999: posts the ante 5
noah5555: posts the ante 5
RoribeiroS: posts small blind 15
tomgan: posts big blind 30
*** HOLE CARDS ***
patou99957: folds 
JAhodaZ: raises 120 to 150
bdiddy1313: folds 
69 hearts 69: folds 
rimis9999: folds 
noah5555: folds 
RoribeiroS: folds 
tomgan: calls 120
*** FLOP *** [Tc 9d 7h]
tomgan: checks 
JAhodaZ: bets 180
tomgan: calls 180
*** TURN *** [Tc 9d 7h] [Qs]
tomgan: checks 
JAhodaZ: bets 357
tomgan: calls 357
*** RIVER *** [Tc 9d 7h Qs] [5h]
tomgan: checks 
JAhodaZ: checks 
*** SHOW DOWN ***
tomgan: shows [9c Ah] (a pair of Nines)
JAhodaZ: shows [Jd Ts] (a pair of Tens)
JAhodaZ collected 1429 from pot
*** SUMMARY ***
Total pot 1429 | Rake 0 
Board [Tc 9d 7h Qs 5h]
Seat 1: RoribeiroS (small blind) folded before Flop
Seat 2: tomgan (big blind) showed [9c Ah] and lost with a pair of Nines
Seat 3: patou99957 folded before Flop (didn't bet)
Seat 4: JAhodaZ showed [Jd Ts] and won (1429) with a pair of Tens
Seat 5: bdiddy1313 folded before Flop (didn't bet)
Seat 6: 69 hearts 69 folded before Flop (didn't bet)
Seat 7: rimis9999 folded before Flop (didn't bet)
Seat 8: noah5555 (button) folded before Flop (didn't bet)



PokerStars Hand #157575284362: Tournament #1641817620, $7.50+$7.50+$1.50 USD Hold'em No Limit - Level I (15/30) - 2016/08/21 18:35:54 ET
Table '1641817620 58' 9-max Seat #5 is the button
Seat 1: bld66 (4650 in chips) 
Seat 2: FACEBUHH (7200 in chips) 
Seat 3: CFgabriel (4935 in chips) 
Seat 4: nejirose (4935 in chips) 
Seat 5: pokercr7721 (5050 in chips) 
Seat 6: Douglas Leme (5000 in chips) out of hand (moved from another table into small blind)
Seat 7: I_R0B0T_90 (4950 in chips) 
Seat 8: lovebigpairs (2790 in chips) 
Seat 9: binho1806 (5505 in chips) 
bld66: posts the ante 5
FACEBUHH: posts the ante 5
CFgabriel: posts the ante 5
nejirose: posts the ante 5
pokercr7721: posts the ante 5
I_R0B0T_90: posts the ante 5
lovebigpairs: posts the ante 5
binho1806: posts the ante 5
I_R0B0T_90: posts small blind 15
lovebigpairs: posts big blind 30
*** HOLE CARDS ***
binho1806: folds 
bld66: folds 
FACEBUHH: folds 
CFgabriel: folds 
nejirose: folds 
pokercr7721: folds 
I_R0B0T_90: calls 15
lovebigpairs: checks 
*** FLOP *** [Ks 7h 5h]
I_R0B0T_90: checks 
lovebigpairs: checks 
*** TURN *** [Ks 7h 5h] [7d]
I_R0B0T_90: checks 
lovebigpairs: checks 
*** RIVER *** [Ks 7h 5h 7d] [8d]
I_R0B0T_90: checks 
lovebigpairs: checks 
*** SHOW DOWN ***
I_R0B0T_90: shows [5d 4d] (two pair, Sevens and Fives)
lovebigpairs: mucks hand 
I_R0B0T_90 collected 100 from pot
*** SUMMARY ***
Total pot 100 | Rake 0 
Board [Ks 7h 5h 7d 8d]
Seat 1: bld66 folded before Flop (didn't bet)
Seat 2: FACEBUHH folded before Flop (didn't bet)
Seat 3: CFgabriel folded before Flop (didn't bet)
Seat 4: nejirose folded before Flop (didn't bet)
Seat 5: pokercr7721 (button) folded before Flop (didn't bet)
Seat 7: I_R0B0T_90 (small blind) showed [5d 4d] and won (100) with two pair, Sevens and Fives
Seat 8: lovebigpairs (big blind) mucked
Seat 9: binho1806 folded before Flop (didn't bet)



PokerStars Hand #157575285597: Tournament #1641817620, $7.50+$7.50+$1.50 USD Hold'em No Limit - Level I (15/30) - 2016/08/21 18:35:56 ET
Table '1641817620 24' 9-max Seat #8 is the button
Seat 1: heyyy presto (5555 in chips) 
Seat 2: BOW300 (2350 in chips) 
Seat 3: muskto (7790 in chips) 
Seat 4: jt3x87 (4850 in chips) 
Seat 5: PhaniaX (4704 in chips) 
Seat 6: pisti801 (5326 in chips) 
Seat 7: Pokemongo007 (5000 in chips) 
Seat 8: trabey (4785 in chips) 
Seat 9: Quickcard (4495 in chips) 
heyyy presto: posts the ante 5
BOW300: posts the ante 5
muskto: posts the ante 5
jt3x87: posts the ante 5
PhaniaX: posts the ante 5
pisti801: posts the ante 5
Pokemongo007: posts the ante 5
trabey: posts the ante 5
Quickcard: posts the ante 5
Quickcard: posts small blind 15
heyyy presto: posts big blind 30
*** HOLE CARDS ***
BOW300: raises 51 to 81
muskto: folds 
jt3x87: folds 
PhaniaX: folds 
pisti801: folds 
Pokemongo007: folds 
trabey: folds 
Quickcard: folds 
heyyy presto: folds 
Uncalled bet (51) returned to BOW300
BOW300 collected 120 from pot
BOW300: doesn't show hand 
*** SUMMARY ***
Total pot 120 | Rake 0 
Seat 1: heyyy presto (big blind) folded before Flop
Seat 2: BOW300 collected (120)
Seat 3: muskto folded before Flop (didn't bet)
Seat 4: jt3x87 folded before Flop (didn't bet)
Seat 5: PhaniaX folded before Flop (didn't bet)
Seat 6: pisti801 folded before Flop (didn't bet)
Seat 7: Pokemongo007 folded before Flop (didn't bet)
Seat 8: trabey (button) folded before Flop (didn't bet)
Seat 9: Quickcard (small blind) folded before Flop



PokerStars Hand #157575286883: Tournament #1641817620, $7.50+$7.50+$1.50 USD Hold'em No Limit - Level I (15/30) - 2016/08/21 18:35:58 ET
Table '1641817620 60' 9-max Seat #6 is the button
Seat 1: C0rpsbal (4980 in chips) 
Seat 2: LuckyRin (5140 in chips) 
Seat 3: Mattzy1 (7766 in chips) 
Seat 4: loco2202 (4875 in chips) 
Seat 5: Malzer19 (5000 in chips) 
Seat 6: sexyhands (4135 in chips) 
Seat 7: vodao1 (3590 in chips) 
Seat 9: Eibsee08 (4890 in chips) 
C0rpsbal: posts the ante 5
LuckyRin: posts the ante 5
Mattzy1: posts the ante 5
loco2202: posts the ante 5
Malzer19: posts the ante 5
sexyhands: posts the ante 5
vodao1: posts the ante 5
Eibsee08: posts the ante 5
vodao1: posts small blind 15
Eibsee08: posts big blind 30
*** HOLE CARDS ***
C0rpsbal: folds 
LuckyRin: folds 
Mattzy1: raises 30 to 60
loco2202: folds 
Malzer19: calls 60
sexyhands: folds 
vodao1: folds 
Eibsee08: folds 
*** FLOP *** [Ac 9h 5s]
Mattzy1: bets 120
Malzer19: calls 120
*** TURN *** [Ac 9h 5s] [Jd]
Mattzy1: checks 
Malzer19: bets 90
Mattzy1: raises 330 to 420
Malzer19: raises 330 to 750
Mattzy1: raises 1945 to 2695
Malzer19: raises 1945 to 4640
Mattzy1: raises 1945 to 6585
Malzer19: calls 175 and is all-in
Uncalled bet (1770) returned to Mattzy1
*** RIVER *** [Ac 9h 5s Jd] [Ks]
*** SHOW DOWN ***
Mattzy1: shows [5c Ah] (two pair, Aces and Fives)
Malzer19: shows [Kc Ad] (two pair, Aces and Kings)
Malzer19 collected 10075 from pot
*** SUMMARY ***
Total pot 10075 | Rake 0 
Board [Ac 9h 5s Jd Ks]
Seat 1: C0rpsbal folded before Flop (didn't bet)
Seat 2: LuckyRin folded before Flop (didn't bet)
Seat 3: Mattzy1 showed [5c Ah] and lost with two pair, Aces and Fives
Seat 4: loco2202 folded before Flop (didn't bet)
Seat 5: Malzer19 showed [Kc Ad] and won (10075) with two pair, Aces and Kings
Seat 6: sexyhands (button) folded before Flop (didn't bet)
Seat 7: vodao1 (small blind) folded before Flop
Seat 9: Eibsee08 (big blind) folded before Flop



PokerStars Hand #157575287059: Tournament #1641817620, $7.50+$7.50+$1.50 USD Hold'em No Limit - Level I (15/30) - 2016/08/21 18:35:58 ET
Table '1641817620 50' 9-max Seat #8 is the button
Seat 1: Alpentraum (5231 in chips) 
Seat 2: FrEmpireAk (10142 in chips) 
Seat 3: hat_coates (4925 in chips) 
Seat 4: GiCi40 (4985 in chips) 
Seat 5: Herbettigre (4910 in chips) 
Seat 6: 100%flop (5000 in chips) 
Seat 7: Shab26 (4790 in chips) 
Seat 8: thinkfeeldo (4888 in chips) 
Seat 9: ziomekek (5134 in chips) 
Alpentraum: posts the ante 5
FrEmpireAk: posts the ante 5
hat_coates: posts the ante 5
GiCi40: posts the ante 5
Herbettigre: posts the ante 5
100%flop: posts the ante 5
Shab26: posts the ante 5
thinkfeeldo: posts the ante 5
ziomekek: posts the ante 5
ziomekek: posts small blind 15
Alpentraum: posts big blind 30
*** HOLE CARDS ***
FrEmpireAk: raises 60 to 90
hat_coates: folds 
GiCi40: folds 
Herbettigre: folds 
100%flop: folds 
Shab26: folds 
thinkfeeldo: folds 
ziomekek: folds 
Alpentraum: folds 
Uncalled bet (60) returned to FrEmpireAk
FrEmpireAk collected 120 from pot
*** SUMMARY ***
Total pot 120 | Rake 0 
Seat 1: Alpentraum (big blind) folded before Flop
Seat 2: FrEmpireAk collected (120)
Seat 3: hat_coates folded before Flop (didn't bet)
Seat 4: GiCi40 folded before Flop (didn't bet)
Seat 5: Herbettigre folded before Flop (didn't bet)
Seat 6: 100%flop folded before Flop (didn't bet)
Seat 7: Shab26 folded before Flop (didn't bet)
Seat 8: thinkfeeldo (button) folded before Flop (didn't bet)
Seat 9: ziomekek (small blind) folded before Flop



PokerStars Hand #157575287124: Tournament #1641817620, $7.50+$7.50+$1.50 USD Hold'em No Limit - Level I (15/30) - 2016/08/21 18:35:58 ET
Table '1641817620 45' 9-max Seat #5 is the button
Seat 1: rocky 7 (4140 in chips) 
Seat 2: ldf58 (6870 in chips) 
Seat 3: LifFtD (4815 in chips) 
Seat 4: Grasquet (5797 in chips) 
Seat 5: Mr.Bob-su (2168 in chips) 
Seat 6: CHIT4 (4950 in chips) 
Seat 8: mrbandito27 (4890 in chips) 
Seat 9: Andre Ortega (6390 in chips) 
rocky 7: posts the ante 5
ldf58: posts the ante 5
LifFtD: posts the ante 5
Grasquet: posts the ante 5
Mr.Bob-su: posts the ante 5
CHIT4: posts the ante 5
mrbandito27: posts the ante 5
Andre Ortega: posts the ante 5
CHIT4: posts small blind 15
mrbandito27: posts big blind 30
*** HOLE CARDS ***
Andre Ortega: folds 
rocky 7: folds 
ldf58: calls 30
LifFtD: folds 
Grasquet: raises 150 to 180
Mr.Bob-su: folds 
CHIT4: folds 
mrbandito27: folds 
ldf58: calls 150
*** FLOP *** [7d Td 7c]
ldf58: checks 
Grasquet: bets 289
ldf58: folds 
Uncalled bet (289) returned to Grasquet
Grasquet collected 445 from pot
Grasquet: doesn't show hand 
*** SUMMARY ***
Total pot 445 | Rake 0 
Board [7d Td 7c]
Seat 1: rocky 7 folded before Flop (didn't bet)
Seat 2: ldf58 folded on the Flop
Seat 3: LifFtD folded before Flop (didn't bet)
Seat 4: Grasquet collected (445)
Seat 5: Mr.Bob-su (button) folded before Flop (didn't bet)
Seat 6: CHIT4 (small blind) folded before Flop
Seat 8: mrbandito27 (big blind) folded before Flop
Seat 9: Andre Ortega folded before Flop (didn't bet)



PokerStars Hand #157575287509: Tournament #1641817620, $7.50+$7.50+$1.50 USD Hold'em No Limit - Level I (15/30) - 2016/08/21 18:35:59 ET
Table '1641817620 11' 9-max Seat #8 is the button
Seat 1: GambleGrill (4970 in chips) 
Seat 2: Dionakabarbi (4955 in chips) 
Seat 3: TriviGn'R (5010 in chips) 
Seat 5: moitzi82 (5080 in chips) 
Seat 6: buzios38 (5525 in chips) 
Seat 7: Galli181 (5000 in chips) 
Seat 8: luisnrd (4865 in chips) 
Seat 9: kylix42 (5025 in chips) 
GambleGrill: posts the ante 5
Dionakabarbi: posts the ante 5
TriviGn'R: posts the ante 5
moitzi82: posts the ante 5
buzios38: posts the ante 5
Galli181: posts the ante 5
luisnrd: posts the ante 5
kylix42: posts the ante 5
kylix42: posts small blind 15
GambleGrill: posts big blind 30
*** HOLE CARDS ***
Dionakabarbi: folds 
TriviGn'R: folds 
moitzi82: folds 
buzios38: folds 
Galli181: folds 
luisnrd: folds 
kylix42: folds 
Uncalled bet (15) returned to GambleGrill
GambleGrill collected 70 from pot
GambleGrill: doesn't show hand 
*** SUMMARY ***
Total pot 70 | Rake 0 
Seat 1: GambleGrill (big blind) collected (70)
Seat 2: Dionakabarbi folded before Flop (didn't bet)
Seat 3: TriviGn'R folded before Flop (didn't bet)
Seat 5: moitzi82 folded before Flop (didn't bet)
Seat 6: buzios38 folded before Flop (didn't bet)
Seat 7: Galli181 folded before Flop (didn't bet)
Seat 8: luisnrd (button) folded before Flop (didn't bet)
Seat 9: kylix42 (small blind) folded before Flop



PokerStars Hand #157575289499: Tournament #1641817620, $7.50+$7.50+$1.50 USD Hold'em No Limit - Level I (15/30) - 2016/08/21 18:36:02 ET
Table '1641817620 38' 9-max Seat #6 is the button
Seat 1: chechako#8 (4990 in chips) 
Seat 2: kristofxm8 (5770 in chips) 
Seat 3: persephoney (4890 in chips) 
Seat 4: Folladorwin (4995 in chips) 
Seat 5: jager1987 (4830 in chips) 
Seat 6: Dr.Durrrq (5070 in chips) 
Seat 7: Myschkin_Lev (4920 in chips) 
Seat 8: mick_allin (5000 in chips) 
Seat 9: dtb1978 (4860 in chips) 
chechako#8: posts the ante 5
kristofxm8: posts the ante 5
persephoney: posts the ante 5
Folladorwin: posts the ante 5
jager1987: posts the ante 5
Dr.Durrrq: posts the ante 5
Myschkin_Lev: posts the ante 5
mick_allin: posts the ante 5
dtb1978: posts the ante 5
Myschkin_Lev: posts small blind 15
mick_allin: posts big blind 30
*** HOLE CARDS ***
dtb1978: calls 30
chechako#8: folds 
kristofxm8: calls 30
persephoney: raises 180 to 210
Folladorwin: folds 
jager1987: folds 
Dr.Durrrq: folds 
Myschkin_Lev: folds 
mick_allin: calls 180
dtb1978: calls 180
kristofxm8: calls 180
*** FLOP *** [7c 5h 2d]
mick_allin: checks 
dtb1978: checks 
kristofxm8: checks 
persephoney: bets 315
mick_allin: calls 315
dtb1978: folds 
kristofxm8: calls 315
*** TURN *** [7c 5h 2d] [8s]
mick_allin: checks 
kristofxm8: checks 
persephoney: bets 1568
mick_allin: calls 1568
kristofxm8: calls 1568
*** RIVER *** [7c 5h 2d 8s] [Qh]
mick_allin: checks 
kristofxm8: checks 
persephoney: bets 2792 and is all-in
mick_allin: folds 
kristofxm8: folds 
Uncalled bet (2792) returned to persephoney
persephoney collected 6549 from pot
persephoney: doesn't show hand 
*** SUMMARY ***
Total pot 6549 | Rake 0 
Board [7c 5h 2d 8s Qh]
Seat 1: chechako#8 folded before Flop (didn't bet)
Seat 2: kristofxm8 folded on the River
Seat 3: persephoney collected (6549)
Seat 4: Folladorwin folded before Flop (didn't bet)
Seat 5: jager1987 folded before Flop (didn't bet)
Seat 6: Dr.Durrrq (button) folded before Flop (didn't bet)
Seat 7: Myschkin_Lev (small blind) folded before Flop
Seat 8: mick_allin (big blind) folded on the River
Seat 9: dtb1978 folded on the Flop



PokerStars Hand #157575290261: Tournament #1641817620, $7.50+$7.50+$1.50 USD Hold'em No Limit - Level I (15/30) - 2016/08/21 18:36:03 ET
Table '1641817620 30' 9-max Seat #6 is the button
Seat 1: riginvl (4980 in chips) 
Seat 2: flashesflash (4950 in chips) 
Seat 3: Drogbaaaaaaa (4920 in chips) 
Seat 4: staplesking (1545 in chips) 
Seat 5: islidur99 (9410 in chips) 
Seat 6: jeanjrg1 (4935 in chips) 
Seat 7: GazRaz21 (3980 in chips) 
Seat 8: karlson1986 (5335 in chips) 
Seat 9: YNWA UA (4950 in chips) 
riginvl: posts the ante 5
flashesflash: posts the ante 5
Drogbaaaaaaa: posts the ante 5
staplesking: posts the ante 5
islidur99: posts the ante 5
jeanjrg1: posts the ante 5
GazRaz21: posts the ante 5
karlson1986: posts the ante 5
YNWA UA: posts the ante 5
GazRaz21: posts small blind 15
karlson1986: posts big blind 30
*** HOLE CARDS ***
YNWA UA: folds 
riginvl: folds 
flashesflash: folds 
Drogbaaaaaaa: folds 
staplesking: folds 
islidur99: raises 120 to 150
jeanjrg1: folds 
GazRaz21: folds 
karlson1986: calls 120
*** FLOP *** [4c 5c Ah]
karlson1986: checks 
islidur99: bets 360
karlson1986: calls 360
*** TURN *** [4c 5c Ah] [2h]
karlson1986: checks 
islidur99: bets 1080
karlson1986: calls 1080
*** RIVER *** [4c 5c Ah 2h] [Kd]
karlson1986: checks 
islidur99: checks 
*** SHOW DOWN ***
karlson1986: shows [As Qs] (a pair of Aces)
islidur99: mucks hand 
karlson1986 collected 3240 from pot
*** SUMMARY ***
Total pot 3240 | Rake 0 
Board [4c 5c Ah 2h Kd]
Seat 1: riginvl folded before Flop (didn't bet)
Seat 2: flashesflash folded before Flop (didn't bet)
Seat 3: Drogbaaaaaaa folded before Flop (didn't bet)
Seat 4: staplesking folded before Flop (didn't bet)
Seat 5: islidur99 mucked
Seat 6: jeanjrg1 (button) folded before Flop (didn't bet)
Seat 7: GazRaz21 (small blind) folded before Flop
Seat 8: karlson1986 (big blind) showed [As Qs] and won (3240) with a pair of Aces
Seat 9: YNWA UA folded before Flop (didn't bet)



PokerStars Hand #157575290410: Tournament #1641817620, $7.50+$7.50+$1.50 USD Hold'em No Limit - Level I (15/30) - 2016/08/21 18:36:03 ET
Table '1641817620 19' 9-max Seat #9 is the button
Seat 1: zmey eliseev (5000 in chips) out of hand (moved from another table into small blind)
Seat 2: renem24 (9990 in chips) 
Seat 3: Paparazzi507 (5332 in chips) 
Seat 4: amondelo (4535 in chips) 
Seat 5: xapnss (4990 in chips) 
Seat 6: flutzke90 (4925 in chips) 
Seat 7: Konfucy1 (4918 in chips) 
Seat 8: le_chefe28 (5480 in chips) 
Seat 9: naumans (4925 in chips) 
renem24: posts the ante 5
Paparazzi507: posts the ante 5
amondelo: posts the ante 5
xapnss: posts the ante 5
flutzke90: posts the ante 5
Konfucy1: posts the ante 5
le_chefe28: posts the ante 5
naumans: posts the ante 5
renem24: posts small blind 15
Paparazzi507: posts big blind 30
*** HOLE CARDS ***
amondelo: calls 30
xapnss: calls 30
flutzke90: calls 30
Konfucy1: calls 30
le_chefe28: folds 
naumans: calls 30
renem24: raises 540 to 570
Paparazzi507: folds 
amondelo: folds 
xapnss: folds 
flutzke90: folds 
Konfucy1: folds 
naumans: folds 
Uncalled bet (540) returned to renem24
renem24 collected 250 from pot
renem24: doesn't show hand 
*** SUMMARY ***
Total pot 250 | Rake 0 
Seat 2: renem24 (small blind) collected (250)
Seat 3: Paparazzi507 (big blind) folded before Flop
Seat 4: amondelo folded before Flop
Seat 5: xapnss folded before Flop
Seat 6: flutzke90 folded before Flop
Seat 7: Konfucy1 folded before Flop
Seat 8: le_chefe28 folded before Flop (didn't bet)
Seat 9: naumans (button) folded before Flop



PokerStars Hand #157575291157: Tournament #1641817620, $7.50+$7.50+$1.50 USD Hold'em No Limit - Level I (15/30) - 2016/08/21 18:36:05 ET
Table '1641817620 41' 9-max Seat #5 is the button
Seat 1: vettecha (4830 in chips) 
Seat 2: ARAVNOA (4965 in chips) 
Seat 3: FlaxonJin (5325 in chips) 
Seat 4: gigibaston (4875 in chips) 
Seat 5: Jujubh (4579 in chips) 
Seat 6: Matiellão (5100 in chips) 
Seat 7: MayFuNg1979 (5426 in chips) 
Seat 8: relmat (7101 in chips) 
Seat 9: Gwermort (2799 in chips) 
vettecha: posts the ante 5
ARAVNOA: posts the ante 5
FlaxonJin: posts the ante 5
gigibaston: posts the ante 5
Jujubh: posts the ante 5
Matiellão: posts the ante 5
MayFuNg1979: posts the ante 5
relmat: posts the ante 5
Gwermort: posts the ante 5
Matiellão: posts small blind 15
MayFuNg1979: posts big blind 30
*** HOLE CARDS ***
relmat: folds 
Gwermort: raises 60 to 90
vettecha: calls 90
ARAVNOA: folds 
FlaxonJin: folds 
gigibaston: folds 
Jujubh: folds 
Matiellão: calls 75
MayFuNg1979: folds 
*** FLOP *** [5d Jd 5h]
Matiellão: checks 
Gwermort: bets 180
vettecha: calls 180
Matiellão: calls 180
*** TURN *** [5d Jd 5h] [9d]
Matiellão: checks 
Gwermort: checks 
vettecha: checks 
*** RIVER *** [5d Jd 5h 9d] [8s]
Matiellão: bets 442
Gwermort: calls 442
vettecha: folds 
*** SHOW DOWN ***
Matiellão: shows [5c 3c] (three of a kind, Fives)
Gwermort: mucks hand 
Matiellão collected 1769 from pot
*** SUMMARY ***
Total pot 1769 | Rake 0 
Board [5d Jd 5h 9d 8s]
Seat 1: vettecha folded on the River
Seat 2: ARAVNOA folded before Flop (didn't bet)
Seat 3: FlaxonJin folded before Flop (didn't bet)
Seat 4: gigibaston folded before Flop (didn't bet)
Seat 5: Jujubh (button) folded before Flop (didn't bet)
Seat 6: Matiellão (small blind) showed [5c 3c] and won (1769) with three of a kind, Fives
Seat 7: MayFuNg1979 (big blind) folded before Flop
Seat 8: relmat folded before Flop (didn't bet)
Seat 9: Gwermort mucked



PokerStars Hand #157575291495: Tournament #1641817620, $7.50+$7.50+$1.50 USD Hold'em No Limit - Level I (15/30) - 2016/08/21 18:36:05 ET
Table '1641817620 59' 9-max Seat #8 is the button
Seat 1: pitoco2012 (5000 in chips) 
Seat 2: M_ORBIT_M (5160 in chips) 
Seat 3: alemaowe (5010 in chips) 
Seat 4: jan monster (4524 in chips) 
Seat 5: laiyitui (4865 in chips) 
Seat 6: ryo1980 (6538 in chips) 
Seat 7: 88Xin88 (5015 in chips) 
Seat 8: Enio Pinho (4143 in chips) 
Seat 9: Robsn087 (4760 in chips) 
pitoco2012: posts the ante 5
M_ORBIT_M: posts the ante 5
alemaowe: posts the ante 5
jan monster: posts the ante 5
laiyitui: posts the ante 5
ryo1980: posts the ante 5
88Xin88: posts the ante 5
Enio Pinho: posts the ante 5
Robsn087: posts the ante 5
Robsn087: posts small blind 15
pitoco2012: posts big blind 30
*** HOLE CARDS ***
M_ORBIT_M: folds 
alemaowe: folds 
jan monster: raises 75 to 105
laiyitui: calls 105
ryo1980: folds 
88Xin88: folds 
Enio Pinho: folds 
Robsn087: folds 
pitoco2012: folds 
*** FLOP *** [Jc Js Tc]
jan monster: checks 
laiyitui: bets 198
jan monster: calls 198
*** TURN *** [Jc Js Tc] [Kd]
jan monster: bets 313
laiyitui: folds 
Uncalled bet (313) returned to jan monster
jan monster collected 696 from pot
*** SUMMARY ***
Total pot 696 | Rake 0 
Board [Jc Js Tc Kd]
Seat 1: pitoco2012 (big blind) folded before Flop
Seat 2: M_ORBIT_M folded before Flop (didn't bet)
Seat 3: alemaowe folded before Flop (didn't bet)
Seat 4: jan monster collected (696)
Seat 5: laiyitui folded on the Turn
Seat 6: ryo1980 folded before Flop (didn't bet)
Seat 7: 88Xin88 folded before Flop (didn't bet)
Seat 8: Enio Pinho (button) folded before Flop (didn't bet)
Seat 9: Robsn087 (small blind) folded before Flop



PokerStars Hand #157575291823: Tournament #1641817620, $7.50+$7.50+$1.50 USD Hold'em No Limit - Level I (15/30) - 2016/08/21 18:36:06 ET
Table '1641817620 35' 9-max Seat #7 is the button
Seat 1: CPTRip69 (4965 in chips) 
Seat 2: Diegodel79 (5075 in chips) 
Seat 3: brunoeffect (4745 in chips) 
Seat 4: PPOrphan (5070 in chips) 
Seat 5: WizardOffAz (5320 in chips) 
Seat 6: brett88987 (4895 in chips) 
Seat 7: IcaLm (4715 in chips) 
Seat 8: ximenesb (4940 in chips) 
Seat 9: Cosacoman (5205 in chips) 
CPTRip69: posts the ante 5
Diegodel79: posts the ante 5
brunoeffect: posts the ante 5
PPOrphan: posts the ante 5
WizardOffAz: posts the ante 5
brett88987: posts the ante 5
IcaLm: posts the ante 5
ximenesb: posts the ante 5
Cosacoman: posts the ante 5
ximenesb: posts small blind 15
Cosacoman: posts big blind 30
*** HOLE CARDS ***
CPTRip69: folds 
Diegodel79: folds 
brunoeffect: folds 
PPOrphan: folds 
WizardOffAz: folds 
brett88987: raises 57 to 87
IcaLm: folds 
ximenesb: folds 
Cosacoman: folds 
Uncalled bet (57) returned to brett88987
brett88987 collected 120 from pot
brett88987: doesn't show hand 
*** SUMMARY ***
Total pot 120 | Rake 0 
Seat 1: CPTRip69 folded before Flop (didn't bet)
Seat 2: Diegodel79 folded before Flop (didn't bet)
Seat 3: brunoeffect folded before Flop (didn't bet)
Seat 4: PPOrphan folded before Flop (didn't bet)
Seat 5: WizardOffAz folded before Flop (didn't bet)
Seat 6: brett88987 collected (120)
Seat 7: IcaLm (button) folded before Flop (didn't bet)
Seat 8: ximenesb (small blind) folded before Flop
Seat 9: Cosacoman (big blind) folded before Flop



PokerStars Hand #157575292188: Tournament #1641817620, $7.50+$7.50+$1.50 USD Hold'em No Limit - Level I (15/30) - 2016/08/21 18:36:06 ET
Table '1641817620 36' 9-max Seat #7 is the button
Seat 1: craiger1976 (4975 in chips) 
Seat 2: Winston4ever (4760 in chips) 
Seat 3: sarxa (4930 in chips) 
Seat 4: rakeshguru (5140 in chips) 
Seat 5: blufface88 (4000 in chips) 
Seat 6: xanja (4810 in chips) 
Seat 7: jadrankokec (5290 in chips) 
Seat 8: ruben marley (4945 in chips) 
Seat 9: wowbizz2 (6155 in chips) 
craiger1976: posts the ante 5
Winston4ever: posts the ante 5
sarxa: posts the ante 5
rakeshguru: posts the ante 5
blufface88: posts the ante 5
xanja: posts the ante 5
jadrankokec: posts the ante 5
ruben marley: posts the ante 5
wowbizz2: posts the ante 5
ruben marley: posts small blind 15
wowbizz2: posts big blind 30
*** HOLE CARDS ***
craiger1976: folds 
Winston4ever: folds 
sarxa: raises 60 to 90
rakeshguru: folds 
blufface88: calls 90
xanja: folds 
jadrankokec: folds 
ruben marley: folds 
wowbizz2: calls 60
*** FLOP *** [Ad 2s Kd]
wowbizz2: checks 
sarxa: bets 178
blufface88: raises 242 to 420
wowbizz2: folds 
sarxa: calls 242
*** TURN *** [Ad 2s Kd] [3s]
sarxa: checks 
blufface88: bets 660
sarxa: calls 660
*** RIVER *** [Ad 2s Kd 3s] [2c]
sarxa: checks 
blufface88: checks 
*** SHOW DOWN ***
sarxa: shows [Th Ah] (two pair, Aces and Deuces)
blufface88: mucks hand 
sarxa collected 2490 from pot
*** SUMMARY ***
Total pot 2490 | Rake 0 
Board [Ad 2s Kd 3s 2c]
Seat 1: craiger1976 folded before Flop (didn't bet)
Seat 2: Winston4ever folded before Flop (didn't bet)
Seat 3: sarxa showed [Th Ah] and won (2490) with two pair, Aces and Deuces
Seat 4: rakeshguru folded before Flop (didn't bet)
Seat 5: blufface88 mucked
Seat 6: xanja folded before Flop (didn't bet)
Seat 7: jadrankokec (button) folded before Flop (didn't bet)
Seat 8: ruben marley (small blind) folded before Flop
Seat 9: wowbizz2 (big blind) folded on the Flop



PokerStars Hand #157575292666: Tournament #1641817620, $7.50+$7.50+$1.50 USD Hold'em No Limit - Level I (15/30) - 2016/08/21 18:36:07 ET
Table '1641817620 15' 9-max Seat #8 is the button
Seat 1: WRussia (4795 in chips) 
Seat 2: miche1301 (5595 in chips) 
Seat 3: tsolias87 (5015 in chips) 
Seat 4: daveholden4 (4990 in chips) 
Seat 5: mdf92 (4585 in chips) 
Seat 6: aramio29 (4929 in chips) 
Seat 7: Yokiro (4660 in chips) 
Seat 8: Rob.nl (3259 in chips) 
Seat 9: mfalmeidacs (6952 in chips) 
WRussia: posts the ante 5
miche1301: posts the ante 5
tsolias87: posts the ante 5
daveholden4: posts the ante 5
mdf92: posts the ante 5
aramio29: posts the ante 5
Yokiro: posts the ante 5
Rob.nl: posts the ante 5
mfalmeidacs: posts the ante 5
mfalmeidacs: posts small blind 15
WRussia: posts big blind 30
*** HOLE CARDS ***
miche1301: raises 30 to 60
tsolias87: folds 
daveholden4: folds 
mdf92: calls 60
aramio29: folds 
Yokiro: folds 
Rob.nl: calls 60
mfalmeidacs: folds 
WRussia: calls 30
*** FLOP *** [Jd 7s Ac]
WRussia: checks 
miche1301: bets 90
mdf92: folds 
Rob.nl: calls 90
WRussia: calls 90
*** TURN *** [Jd 7s Ac] [As]
WRussia: checks 
miche1301: checks 
Rob.nl: checks 
*** RIVER *** [Jd 7s Ac As] [Qc]
WRussia: checks 
miche1301: checks 
Rob.nl: checks 
*** SHOW DOWN ***
WRussia: shows [3s 3c] (two pair, Aces and Threes)
miche1301: shows [Jh Kc] (two pair, Aces and Jacks)
Rob.nl: mucks hand 
miche1301 collected 570 from pot
*** SUMMARY ***
Total pot 570 | Rake 0 
Board [Jd 7s Ac As Qc]
Seat 1: WRussia (big blind) showed [3s 3c] and lost with two pair, Aces and Threes
Seat 2: miche1301 showed [Jh Kc] and won (570) with two pair, Aces and Jacks
Seat 3: tsolias87 folded before Flop (didn't bet)
Seat 4: daveholden4 folded before Flop (didn't bet)
Seat 5: mdf92 folded on the Flop
Seat 6: aramio29 folded before Flop (didn't bet)
Seat 7: Yokiro folded before Flop (didn't bet)
Seat 8: Rob.nl (button) mucked
Seat 9: mfalmeidacs (small blind) folded before Flop



PokerStars Hand #157575294223: Tournament #1641817620, $7.50+$7.50+$1.50 USD Hold'em No Limit - Level I (15/30) - 2016/08/21 18:36:09 ET
Table '1641817620 39' 9-max Seat #8 is the button
Seat 1: BuyMeBMW (5030 in chips) 
Seat 2: ahaknh (4498 in chips) 
Seat 3: Crim44 (5442 in chips) 
Seat 4: Neo_gracz (4925 in chips) 
Seat 5: rinxa30 (4990 in chips) 
Seat 6: TxsFrUrMoney (5866 in chips) 
Seat 7: j.williams94 (5105 in chips) 
Seat 8: 88K@la88 (4388 in chips) 
Seat 9: Foggy56 (4631 in chips) 
BuyMeBMW: posts the ante 5
ahaknh: posts the ante 5
Crim44: posts the ante 5
Neo_gracz: posts the ante 5
rinxa30: posts the ante 5
TxsFrUrMoney: posts the ante 5
j.williams94: posts the ante 5
88K@la88: posts the ante 5
Foggy56: posts the ante 5
Foggy56: posts small blind 15
BuyMeBMW: posts big blind 30
*** HOLE CARDS ***
ahaknh: raises 30 to 60
Crim44: folds 
Neo_gracz: folds 
rinxa30: folds 
TxsFrUrMoney: folds 
j.williams94: calls 60
88K@la88: folds 
Foggy56: calls 45
BuyMeBMW: folds 
*** FLOP *** [Ts 7c Td]
Foggy56: checks 
ahaknh: bets 90
j.williams94: calls 90
Foggy56: folds 
*** TURN *** [Ts 7c Td] [8d]
ahaknh: checks 
j.williams94: bets 150
ahaknh: calls 150
*** RIVER *** [Ts 7c Td 8d] [2s]
ahaknh: checks 
j.williams94: checks 
*** SHOW DOWN ***
ahaknh: shows [Jc Jd] (two pair, Jacks and Tens)
j.williams94: mucks hand 
ahaknh collected 735 from pot
*** SUMMARY ***
Total pot 735 | Rake 0 
Board [Ts 7c Td 8d 2s]
Seat 1: BuyMeBMW (big blind) folded before Flop
Seat 2: ahaknh showed [Jc Jd] and won (735) with two pair, Jacks and Tens
Seat 3: Crim44 folded before Flop (didn't bet)
Seat 4: Neo_gracz folded before Flop (didn't bet)
Seat 5: rinxa30 folded before Flop (didn't bet)
Seat 6: TxsFrUrMoney folded before Flop (didn't bet)
Seat 7: j.williams94 mucked
Seat 8: 88K@la88 (button) folded before Flop (didn't bet)
Seat 9: Foggy56 (small blind) folded on the Flop



PokerStars Hand #157575294500: Tournament #1641817620, $7.50+$7.50+$1.50 USD Hold'em No Limit - Level I (15/30) - 2016/08/21 18:36:10 ET
Table '1641817620 43' 9-max Seat #7 is the button
Seat 1: VeniG95 (10239 in chips) 
Seat 2: alanyamil (60 in chips) 
Seat 3: Raulop (4760 in chips) 
Seat 4: SoulSlaye166 (4985 in chips) 
Seat 5: DimaRu777 (5195 in chips) 
Seat 6: Taima (5136 in chips) 
Seat 7: Caville88 (4640 in chips) 
Seat 8: BetoFolhaCMC (4940 in chips) 
Seat 9: cajool (5045 in chips) 
VeniG95: posts the ante 5
alanyamil: posts the ante 5
Raulop: posts the ante 5
SoulSlaye166: posts the ante 5
DimaRu777: posts the ante 5
Taima: posts the ante 5
Caville88: posts the ante 5
BetoFolhaCMC: posts the ante 5
cajool: posts the ante 5
BetoFolhaCMC: posts small blind 15
cajool: posts big blind 30
*** HOLE CARDS ***
VeniG95: raises 90 to 120
alanyamil: calls 55 and is all-in
Raulop: folds 
SoulSlaye166: calls 120
DimaRu777: folds 
Taima: calls 120
Caville88: calls 120
BetoFolhaCMC: folds 
cajool: calls 90
*** FLOP *** [Jd 5c 3d]
cajool: checks 
VeniG95: checks 
SoulSlaye166: checks 
Taima: checks 
Caville88: bets 357
cajool: calls 357
VeniG95: folds 
SoulSlaye166: folds 
Taima: folds 
*** TURN *** [Jd 5c 3d] [7s]
cajool: checks 
Caville88: bets 714
cajool: folds 
Uncalled bet (714) returned to Caville88
*** RIVER *** [Jd 5c 3d 7s] [Th]
*** SHOW DOWN ***
Caville88: shows [8c Jc] (a pair of Jacks)
Caville88 collected 1039 from side pot
alanyamil: shows [4d As] (high card Ace)
Caville88 collected 390 from main pot
Caville88 wins $3.75 for eliminating alanyamil and their own bounty increases by $3.75 to $11.25
alanyamil finished the tournament in 999999981st place
*** SUMMARY ***
Total pot 1429 Main pot 390. Side pot 1039. | Rake 0 
Board [Jd 5c 3d 7s Th]
Seat 1: VeniG95 folded on the Flop
Seat 2: alanyamil showed [4d As] and lost with high card Ace
Seat 3: Raulop folded before Flop (didn't bet)
Seat 4: SoulSlaye166 folded on the Flop
Seat 5: DimaRu777 folded before Flop (didn't bet)
Seat 6: Taima folded on the Flop
Seat 7: Caville88 (button) showed [8c Jc] and won (1429) with a pair of Jacks
Seat 8: BetoFolhaCMC (small blind) folded before Flop
Seat 9: cajool (big blind) folded on the Turn



PokerStars Hand #157575294553: Tournament #1641817620, $7.50+$7.50+$1.50 USD Hold'em No Limit - Level I (15/30) - 2016/08/21 18:36:10 ET
Table '1641817620 55' 9-max Seat #7 is the button
Seat 1: M Patoine (4780 in chips) 
Seat 2: HayArro (4880 in chips) 
Seat 3: MaxPips (4865 in chips) 
Seat 4: furia75205 (4925 in chips) 
Seat 5: hoolzky (4835 in chips) 
Seat 6: B.Paulino (4925 in chips) 
Seat 7: xLewie (5625 in chips) 
Seat 8: parmalat4o (5000 in chips) out of hand (moved from another table into small blind)
Seat 9: igara tigara (5030 in chips) 
M Patoine: posts the ante 5
HayArro: posts the ante 5
MaxPips: posts the ante 5
furia75205: posts the ante 5
hoolzky: posts the ante 5
B.Paulino: posts the ante 5
xLewie: posts the ante 5
igara tigara: posts the ante 5
igara tigara: posts small blind 15
M Patoine: posts big blind 30
*** HOLE CARDS ***
HayArro: raises 30 to 60
MaxPips: folds 
furia75205: folds 
hoolzky: folds 
B.Paulino: folds 
xLewie: folds 
igara tigara: folds 
M Patoine: folds 
Uncalled bet (30) returned to HayArro
HayArro collected 115 from pot
*** SUMMARY ***
Total pot 115 | Rake 0 
Seat 1: M Patoine (big blind) folded before Flop
Seat 2: HayArro collected (115)
Seat 3: MaxPips folded before Flop (didn't bet)
Seat 4: furia75205 folded before Flop (didn't bet)
Seat 5: hoolzky folded before Flop (didn't bet)
Seat 6: B.Paulino folded before Flop (didn't bet)
Seat 7: xLewie (button) folded before Flop (didn't bet)
Seat 9: igara tigara (small blind) folded before Flop



PokerStars Hand #157575294891: Tournament #1641817620, $7.50+$7.50+$1.50 USD Hold'em No Limit - Level I (15/30) - 2016/08/21 18:36:11 ET
Table '1641817620 48' 9-max Seat #6 is the button
Seat 1: soft8981 (4891 in chips) 
Seat 2: getatore (5125 in chips) 
Seat 3: Serg2407 (4840 in chips) 
Seat 4: Zareta (4870 in chips) 
Seat 5: NSStefan (4930 in chips) 
Seat 6: ATE13 (7445 in chips) 
Seat 7: RipNuts (5000 in chips) out of hand (moved from another table into small blind)
Seat 8: howtown (2221 in chips) 
Seat 9: qcouest (5803 in chips) 
soft8981: posts the ante 5
getatore: posts the ante 5
Serg2407: posts the ante 5
Zareta: posts the ante 5
NSStefan: posts the ante 5
ATE13: posts the ante 5
howtown: posts the ante 5
qcouest: posts the ante 5
howtown: posts small blind 15
qcouest: posts big blind 30
*** HOLE CARDS ***
soft8981: folds 
getatore: raises 90 to 120
Serg2407: folds 
Zareta: folds 
NSStefan: folds 
ATE13: folds 
howtown: folds 
qcouest: folds 
Uncalled bet (90) returned to getatore
getatore collected 115 from pot
getatore: doesn't show hand 
*** SUMMARY ***
Total pot 115 | Rake 0 
Seat 1: soft8981 folded before Flop (didn't bet)
Seat 2: getatore collected (115)
Seat 3: Serg2407 folded before Flop (didn't bet)
Seat 4: Zareta folded before Flop (didn't bet)
Seat 5: NSStefan folded before Flop (didn't bet)
Seat 6: ATE13 (button) folded before Flop (didn't bet)
Seat 8: howtown (small blind) folded before Flop
Seat 9: qcouest (big blind) folded before Flop



PokerStars Hand #157575295079: Tournament #1641817620, $7.50+$7.50+$1.50 USD Hold'em No Limit - Level I (15/30) - 2016/08/21 18:36:11 ET
Table '1641817620 16' 9-max Seat #3 is the button
Seat 1: crewzer_08 (4808 in chips) 
Seat 2: Sergei0384 (5021 in chips) 
Seat 3: paschalisbg (5246 in chips) 
Seat 4: Maisiewin (4905 in chips) 
Seat 5: alemaozl (4910 in chips) 
Seat 6: Luis Reye837 (4980 in chips) 
Seat 7: burton14 (5170 in chips) 
Seat 8: Miky_Man993 (4753 in chips) 
Seat 9: ziboin (5047 in chips) 
crewzer_08: posts the ante 5
Sergei0384: posts the ante 5
paschalisbg: posts the ante 5
Maisiewin: posts the ante 5
alemaozl: posts the ante 5
Luis Reye837: posts the ante 5
burton14: posts the ante 5
Miky_Man993: posts the ante 5
ziboin: posts the ante 5
Maisiewin: posts small blind 15
alemaozl: posts big blind 30
*** HOLE CARDS ***
Luis Reye837: folds 
burton14: folds 
Miky_Man993: raises 37 to 67
ziboin: folds 
crewzer_08: calls 67
Sergei0384: folds 
paschalisbg: folds 
Maisiewin: folds 
alemaozl: folds 
*** FLOP *** [8c 7c 7h]
Miky_Man993: checks 
crewzer_08: checks 
*** TURN *** [8c 7c 7h] [7d]
Miky_Man993: bets 105
crewzer_08: calls 105
*** RIVER *** [8c 7c 7h 7d] [3c]
Miky_Man993: bets 285
crewzer_08: raises 1305 to 1590
Miky_Man993: calls 1305
*** SHOW DOWN ***
crewzer_08: shows [7s 5s] (four of a kind, Sevens)
Miky_Man993: mucks hand 
crewzer_08 collected 3614 from pot
*** SUMMARY ***
Total pot 3614 | Rake 0 
Board [8c 7c 7h 7d 3c]
Seat 1: crewzer_08 showed [7s 5s] and won (3614) with four of a kind, Sevens
Seat 2: Sergei0384 folded before Flop (didn't bet)
Seat 3: paschalisbg (button) folded before Flop (didn't bet)
Seat 4: Maisiewin (small blind) folded before Flop
Seat 5: alemaozl (big blind) folded before Flop
Seat 6: Luis Reye837 folded before Flop (didn't bet)
Seat 7: burton14 folded before Flop (didn't bet)
Seat 8: Miky_Man993 mucked
Seat 9: ziboin folded before Flop (didn't bet)



PokerStars Hand #157575295683: Tournament #1641817620, $7.50+$7.50+$1.50 USD Hold'em No Limit - Level I (15/30) - 2016/08/21 18:36:12 ET
Table '1641817620 7' 9-max Seat #9 is the button
Seat 1: Intelis (5000 in chips) out of hand (moved from another table into small blind)
Seat 2: ricar1749 (5220 in chips) 
Seat 3: Steve G009 (4955 in chips) 
Seat 4: nbmom (4865 in chips) 
Seat 5: bernardijack (5135 in chips) 
Seat 6: POKEMONSTRO (5037 in chips) 
Seat 7: NemeanDanny (5025 in chips) 
Seat 8: Original02 (5310 in chips) 
Seat 9: cjgarceau (4633 in chips) 
ricar1749: posts the ante 5
Steve G009: posts the ante 5
nbmom: posts the ante 5
bernardijack: posts the ante 5
POKEMONSTRO: posts the ante 5
NemeanDanny: posts the ante 5
Original02: posts the ante 5
cjgarceau: posts the ante 5
ricar1749: posts small blind 15
Steve G009: posts big blind 30
*** HOLE CARDS ***
nbmom: folds 
bernardijack: calls 30
POKEMONSTRO: folds 
NemeanDanny: folds 
Original02: folds 
cjgarceau: folds 
ricar1749: folds 
Steve G009: checks 
*** FLOP *** [9h Qc 3d]
Steve G009: checks 
bernardijack: checks 
*** TURN *** [9h Qc 3d] [Td]
Steve G009: checks 
bernardijack: bets 115
Steve G009: folds 
Uncalled bet (115) returned to bernardijack
bernardijack collected 115 from pot
bernardijack: doesn't show hand 
*** SUMMARY ***
Total pot 115 | Rake 0 
Board [9h Qc 3d Td]
Seat 2: ricar1749 (small blind) folded before Flop
Seat 3: Steve G009 (big blind) folded on the Turn
Seat 4: nbmom folded before Flop (didn't bet)
Seat 5: bernardijack collected (115)
Seat 6: POKEMONSTRO folded before Flop (didn't bet)
Seat 7: NemeanDanny folded before Flop (didn't bet)
Seat 8: Original02 folded before Flop (didn't bet)
Seat 9: cjgarceau (button) folded before Flop (didn't bet)



PokerStars Hand #157575296841: Tournament #1641817620, $7.50+$7.50+$1.50 USD Hold'em No Limit - Level I (15/30) - 2016/08/21 18:36:14 ET
Table '1641817620 10' 9-max Seat #8 is the button
Seat 2: Be Anger (4710 in chips) 
Seat 3: mickyryan (4920 in chips) 
Seat 4: silveira1879 (5250 in chips) 
Seat 5: AndyLou27 (5347 in chips) 
Seat 6: I M GOIN OFF (4920 in chips) 
Seat 7: Nuazo (4890 in chips) 
Seat 8: damibor (5123 in chips) 
Seat 9: Stokesy05 (4875 in chips) 
Be Anger: posts the ante 5
mickyryan: posts the ante 5
silveira1879: posts the ante 5
AndyLou27: posts the ante 5
I M GOIN OFF: posts the ante 5
Nuazo: posts the ante 5
damibor: posts the ante 5
Stokesy05: posts the ante 5
Stokesy05: posts small blind 15
Be Anger: posts big blind 30
*** HOLE CARDS ***
mickyryan: folds 
silveira1879: folds 
AndyLou27: folds 
I M GOIN OFF: raises 60 to 90
Nuazo: folds 
damibor: folds 
Stokesy05: folds 
Be Anger: calls 60
*** FLOP *** [6d Tc 8s]
Be Anger: checks 
I M GOIN OFF: bets 135
Be Anger: calls 135
*** TURN *** [6d Tc 8s] [2s]
Be Anger: checks 
I M GOIN OFF: checks 
*** RIVER *** [6d Tc 8s 2s] [8d]
Be Anger: bets 252
I M GOIN OFF: folds 
Uncalled bet (252) returned to Be Anger
Be Anger collected 505 from pot
Be Anger: doesn't show hand 
*** SUMMARY ***
Total pot 505 | Rake 0 
Board [6d Tc 8s 2s 8d]
Seat 2: Be Anger (big blind) collected (505)
Seat 3: mickyryan folded before Flop (didn't bet)
Seat 4: silveira1879 folded before Flop (didn't bet)
Seat 5: AndyLou27 folded before Flop (didn't bet)
Seat 6: I M GOIN OFF folded on the River
Seat 7: Nuazo folded before Flop (didn't bet)
Seat 8: damibor (button) folded before Flop (didn't bet)
Seat 9: Stokesy05 (small blind) folded before Flop



PokerStars Hand #157575297830: Tournament #1641817620, $7.50+$7.50+$1.50 USD Hold'em No Limit - Level I (15/30) - 2016/08/21 18:36:15 ET
Table '1641817620 40' 9-max Seat #9 is the button
Seat 1: jokill6stone (5000 in chips) out of hand (moved from another table into small blind)
Seat 2: nico122527 (4838 in chips) 
Seat 4: Mr_Giiba (4943 in chips) 
Seat 5: mario342 (5115 in chips) 
Seat 6: MON3Y$HOT (5220 in chips) 
Seat 7: hyratsch (4421 in chips) 
Seat 8: arthuzinho (5000 in chips) 
Seat 9: kafu123 (4920 in chips) is sitting out
nico122527: posts the ante 5
Mr_Giiba: posts the ante 5
mario342: posts the ante 5
MON3Y$HOT: posts the ante 5
hyratsch: posts the ante 5
arthuzinho: posts the ante 5
kafu123: posts the ante 5
nico122527: posts small blind 15
Mr_Giiba: posts big blind 30
*** HOLE CARDS ***
mario342: folds 
MON3Y$HOT: folds 
hyratsch: folds 
arthuzinho: folds 
kafu123: folds 
nico122527: calls 15
Mr_Giiba: checks 
*** FLOP *** [4d 6c 2h]
nico122527: checks 
Mr_Giiba: bets 60
nico122527: calls 60
*** TURN *** [4d 6c 2h] [Kd]
nico122527: checks 
Mr_Giiba: bets 120
nico122527: folds 
Uncalled bet (120) returned to Mr_Giiba
Mr_Giiba collected 215 from pot
Mr_Giiba: doesn't show hand 
*** SUMMARY ***
Total pot 215 | Rake 0 
Board [4d 6c 2h Kd]
Seat 2: nico122527 (small blind) folded on the Turn
Seat 4: Mr_Giiba (big blind) collected (215)
Seat 5: mario342 folded before Flop (didn't bet)
Seat 6: MON3Y$HOT folded before Flop (didn't bet)
Seat 7: hyratsch folded before Flop (didn't bet)
Seat 8: arthuzinho folded before Flop (didn't bet)
Seat 9: kafu123 (button) folded before Flop (didn't bet)



PokerStars Hand #157575298800: Tournament #1641817620, $7.50+$7.50+$1.50 USD Hold'em No Limit - Level I (15/30) - 2016/08/21 18:36:17 ET
Table '1641817620 61' 9-max Seat #8 is the button
Seat 1: talga421 (4283 in chips) 
Seat 3: ElliNelly (11317 in chips) 
Seat 4: Adso139 (4985 in chips) 
Seat 5: sasha.yush (4925 in chips) 
Seat 6: houtenboog (4835 in chips) 
Seat 7: setarcos1234 (4925 in chips) 
Seat 8: mcgcork (5015 in chips) 
Seat 9: LocoSanDiego (5100 in chips) 
talga421: posts the ante 5
ElliNelly: posts the ante 5
Adso139: posts the ante 5
sasha.yush: posts the ante 5
houtenboog: posts the ante 5
setarcos1234: posts the ante 5
mcgcork: posts the ante 5
LocoSanDiego: posts the ante 5
LocoSanDiego: posts small blind 15
talga421: posts big blind 30
*** HOLE CARDS ***
ElliNelly: folds 
Adso139: raises 90 to 120
sasha.yush: folds 
houtenboog: folds 
setarcos1234: folds 
mcgcork: folds 
LocoSanDiego: folds 
talga421: folds 
Uncalled bet (90) returned to Adso139
Adso139 collected 115 from pot
*** SUMMARY ***
Total pot 115 | Rake 0 
Seat 1: talga421 (big blind) folded before Flop
Seat 3: ElliNelly folded before Flop (didn't bet)
Seat 4: Adso139 collected (115)
Seat 5: sasha.yush folded before Flop (didn't bet)
Seat 6: houtenboog folded before Flop (didn't bet)
Seat 7: setarcos1234 folded before Flop (didn't bet)
Seat 8: mcgcork (button) folded before Flop (didn't bet)
Seat 9: LocoSanDiego (small blind) folded before Flop



PokerStars Hand #157575300466: Tournament #1641817620, $7.50+$7.50+$1.50 USD Hold'em No Limit - Level I (15/30) - 2016/08/21 18:36:19 ET
Table '1641817620 2' 9-max Seat #7 is the button
Seat 1: ChaCha121 (3145 in chips) 
Seat 2: T8yourmoney (6100 in chips) 
Seat 3: mvpalls (4570 in chips) 
Seat 4: Juniorjbm28 (4990 in chips) 
Seat 5: junkshow#1 (3970 in chips) 
Seat 6: Vstoinov (4555 in chips) 
Seat 7: GreenDja (4930 in chips) 
Seat 8: BckDoorFlux (4940 in chips) 
Seat 9: LeaD25 (8015 in chips) 
ChaCha121: posts the ante 5
T8yourmoney: posts the ante 5
mvpalls: posts the ante 5
Juniorjbm28: posts the ante 5
junkshow#1: posts the ante 5
Vstoinov: posts the ante 5
GreenDja: posts the ante 5
BckDoorFlux: posts the ante 5
LeaD25: posts the ante 5
BckDoorFlux: posts small blind 15
LeaD25: posts big blind 30
*** HOLE CARDS ***
ChaCha121: folds 
T8yourmoney: folds 
mvpalls: folds 
Juniorjbm28: folds 
junkshow#1: calls 30
Vstoinov: raises 120 to 150
GreenDja: folds 
BckDoorFlux: folds 
LeaD25: raises 180 to 330
junkshow#1: folds 
Vstoinov: calls 180
*** FLOP *** [9c 7s 6d]
LeaD25: checks 
Vstoinov: checks 
*** TURN *** [9c 7s 6d] [Jc]
LeaD25: checks 
Vstoinov: checks 
*** RIVER *** [9c 7s 6d Jc] [5d]
LeaD25: checks 
Vstoinov: bets 562
LeaD25: calls 562
*** SHOW DOWN ***
Vstoinov: shows [3c Ac] (high card Ace)
LeaD25: shows [As Kd] (high card Ace - King kicker)
LeaD25 collected 1874 from pot
*** SUMMARY ***
Total pot 1874 | Rake 0 
Board [9c 7s 6d Jc 5d]
Seat 1: ChaCha121 folded before Flop (didn't bet)
Seat 2: T8yourmoney folded before Flop (didn't bet)
Seat 3: mvpalls folded before Flop (didn't bet)
Seat 4: Juniorjbm28 folded before Flop (didn't bet)
Seat 5: junkshow#1 folded before Flop
Seat 6: Vstoinov showed [3c Ac] and lost with high card Ace
Seat 7: GreenDja (button) folded before Flop (didn't bet)
Seat 8: BckDoorFlux (small blind) folded before Flop
Seat 9: LeaD25 (big blind) showed [As Kd] and won (1874) with high card Ace



PokerStars Hand #157575302383: Tournament #1641817620, $7.50+$7.50+$1.50 USD Hold'em No Limit - Level I (15/30) - 2016/08/21 18:36:22 ET
Table '1641817620 13' 9-max Seat #7 is the button
Seat 1: Mindthis (3223 in chips) 
Seat 2: nicka501 (10533 in chips) 
Seat 3: POG_Q4 (7198 in chips) 
Seat 4: sutherland43 (4930 in chips) 
Seat 5: LarikkadoAA (5050 in chips) 
Seat 6: MicroStaker5 (4438 in chips) 
Seat 7: MrMalaLeche (4925 in chips) 
Seat 8: EdsonPecly (4949 in chips) 
Seat 9: wantuirpoker (4749 in chips) 
Mindthis: posts the ante 5
nicka501: posts the ante 5
POG_Q4: posts the ante 5
sutherland43: posts the ante 5
LarikkadoAA: posts the ante 5
MicroStaker5: posts the ante 5
MrMalaLeche: posts the ante 5
EdsonPecly: posts the ante 5
wantuirpoker: posts the ante 5
EdsonPecly: posts small blind 15
wantuirpoker: posts big blind 30
*** HOLE CARDS ***
Mindthis: folds 
nicka501: folds 
POG_Q4: folds 
sutherland43: folds 
LarikkadoAA: folds 
MicroStaker5: folds 
MrMalaLeche: folds 
EdsonPecly: folds 
Uncalled bet (15) returned to wantuirpoker
wantuirpoker collected 75 from pot
*** SUMMARY ***
Total pot 75 | Rake 0 
Seat 1: Mindthis folded before Flop (didn't bet)
Seat 2: nicka501 folded before Flop (didn't bet)
Seat 3: POG_Q4 folded before Flop (didn't bet)
Seat 4: sutherland43 folded before Flop (didn't bet)
Seat 5: LarikkadoAA folded before Flop (didn't bet)
Seat 6: MicroStaker5 folded before Flop (didn't bet)
Seat 7: MrMalaLeche (button) folded before Flop (didn't bet)
Seat 8: EdsonPecly (small blind) folded before Flop
Seat 9: wantuirpoker (big blind) collected (75)



PokerStars Hand #157575303151: Tournament #1641817620, $7.50+$7.50+$1.50 USD Hold'em No Limit - Level I (15/30) - 2016/08/21 18:36:24 ET
Table '1641817620 44' 9-max Seat #1 is the button
Seat 1: BurrGrylls (4840 in chips) 
Seat 2: moisesgosu (4506 in chips) 
Seat 3: kduwork (5132 in chips) 
Seat 4: starkstud (5095 in chips) 
Seat 5: rbcowboy27 (7087 in chips) 
Seat 6: lesley hu (4915 in chips) is sitting out
Seat 7: ongggg (4888 in chips) 
Seat 8: heynow21 (2987 in chips) 
Seat 9: Pro_Tunis (5665 in chips) 
BurrGrylls: posts the ante 5
moisesgosu: posts the ante 5
kduwork: posts the ante 5
starkstud: posts the ante 5
rbcowboy27: posts the ante 5
lesley hu: posts the ante 5
ongggg: posts the ante 5
heynow21: posts the ante 5
Pro_Tunis: posts the ante 5
moisesgosu: posts small blind 15
kduwork: posts big blind 30
*** HOLE CARDS ***
starkstud: folds 
rbcowboy27: folds 
lesley hu: folds 
ongggg: folds 
heynow21: folds 
Pro_Tunis: folds 
BurrGrylls: folds 
moisesgosu: raises 30 to 60
kduwork: folds 
Uncalled bet (30) returned to moisesgosu
moisesgosu collected 105 from pot
moisesgosu: doesn't show hand 
*** SUMMARY ***
Total pot 105 | Rake 0 
Seat 1: BurrGrylls (button) folded before Flop (didn't bet)
Seat 2: moisesgosu (small blind) collected (105)
Seat 3: kduwork (big blind) folded before Flop
Seat 4: starkstud folded before Flop (didn't bet)
Seat 5: rbcowboy27 folded before Flop (didn't bet)
Seat 6: lesley hu folded before Flop (didn't bet)
Seat 7: ongggg folded before Flop (didn't bet)
Seat 8: heynow21 folded before Flop (didn't bet)
Seat 9: Pro_Tunis folded before Flop (didn't bet)



PokerStars Hand #157575304790: Tournament #1641817620, $7.50+$7.50+$1.50 USD Hold'em No Limit - Level I (15/30) - 2016/08/21 18:36:26 ET
Table '1641817620 22' 9-max Seat #9 is the button
Seat 1: iLvpoon (4960 in chips) 
Seat 2: hanshabraken (4985 in chips) 
Seat 3: CHININ118 (4579 in chips) 
Seat 4: Jaliplay (10090 in chips) 
Seat 5: hewx (10556 in chips) 
Seat 6: DannoPK (5145 in chips) 
Seat 7: ogotop76 (4915 in chips) 
Seat 8: monterreymx (4910 in chips) 
Seat 9: cash4king (4885 in chips) 
iLvpoon: posts the ante 5
hanshabraken: posts the ante 5
CHININ118: posts the ante 5
Jaliplay: posts the ante 5
hewx: posts the ante 5
DannoPK: posts the ante 5
ogotop76: posts the ante 5
monterreymx: posts the ante 5
cash4king: posts the ante 5
iLvpoon: posts small blind 15
hanshabraken: posts big blind 30
*** HOLE CARDS ***
CHININ118: folds 
Jaliplay: raises 30 to 60
hewx: folds 
DannoPK: folds 
ogotop76: folds 
monterreymx: folds 
cash4king: calls 60
iLvpoon: folds 
hanshabraken: folds 
*** FLOP *** [8d 6d Jh]
Jaliplay: bets 90
cash4king: raises 120 to 210
Jaliplay: calls 120
*** TURN *** [8d 6d Jh] [As]
Jaliplay: bets 120
cash4king: raises 300 to 420
Jaliplay: calls 300
*** RIVER *** [8d 6d Jh As] [Jd]
Jaliplay: checks 
cash4king: bets 660
Jaliplay: folds 
Uncalled bet (660) returned to cash4king
cash4king collected 1470 from pot
cash4king: doesn't show hand 
*** SUMMARY ***
Total pot 1470 | Rake 0 
Board [8d 6d Jh As Jd]
Seat 1: iLvpoon (small blind) folded before Flop
Seat 2: hanshabraken (big blind) folded before Flop
Seat 3: CHININ118 folded before Flop (didn't bet)
Seat 4: Jaliplay folded on the River
Seat 5: hewx folded before Flop (didn't bet)
Seat 6: DannoPK folded before Flop (didn't bet)
Seat 7: ogotop76 folded before Flop (didn't bet)
Seat 8: monterreymx folded before Flop (didn't bet)
Seat 9: cash4king (button) collected (1470)



PokerStars Hand #157575304984: Tournament #1641817620, $7.50+$7.50+$1.50 USD Hold'em No Limit - Level I (15/30) - 2016/08/21 18:36:26 ET
Table '1641817620 33' 9-max Seat #1 is the button
Seat 1: fungyou (4915 in chips) 
Seat 2: titauhu (3321 in chips) 
Seat 3: gmdef.2001 (4915 in chips) 
Seat 4: natahha_92 (4975 in chips) 
Seat 5: T@keItDown (5000 in chips) 
Seat 6: REPPARTFLOW (5005 in chips) 
Seat 7: dennismitru (6232 in chips) 
Seat 8: Joao Valli (4849 in chips) 
Seat 9: Pablos701 (5793 in chips) 
fungyou: posts the ante 5
titauhu: posts the ante 5
gmdef.2001: posts the ante 5
natahha_92: posts the ante 5
T@keItDown: posts the ante 5
REPPARTFLOW: posts the ante 5
dennismitru: posts the ante 5
Joao Valli: posts the ante 5
Pablos701: posts the ante 5
titauhu: posts small blind 15
gmdef.2001: posts big blind 30
*** HOLE CARDS ***
natahha_92: folds 
T@keItDown: folds 
REPPARTFLOW: folds 
dennismitru: folds 
Joao Valli: folds 
Pablos701: folds 
fungyou: folds 
titauhu: calls 15
gmdef.2001: raises 90 to 120
titauhu: calls 90
*** FLOP *** [9h Ts Ad]
titauhu: checks 
gmdef.2001: bets 136
titauhu: folds 
Uncalled bet (136) returned to gmdef.2001
gmdef.2001 collected 285 from pot
gmdef.2001: doesn't show hand 
*** SUMMARY ***
Total pot 285 | Rake 0 
Board [9h Ts Ad]
Seat 1: fungyou (button) folded before Flop (didn't bet)
Seat 2: titauhu (small blind) folded on the Flop
Seat 3: gmdef.2001 (big blind) collected (285)
Seat 4: natahha_92 folded before Flop (didn't bet)
Seat 5: T@keItDown folded before Flop (didn't bet)
Seat 6: REPPARTFLOW folded before Flop (didn't bet)
Seat 7: dennismitru folded before Flop (didn't bet)
Seat 8: Joao Valli folded before Flop (didn't bet)
Seat 9: Pablos701 folded before Flop (didn't bet)



PokerStars Hand #157575305130: Tournament #1641817620, $7.50+$7.50+$1.50 USD Hold'em No Limit - Level I (15/30) - 2016/08/21 18:36:27 ET
Table '1641817620 26' 9-max Seat #2 is the button
Seat 1: duplo1182 (14165 in chips) 
Seat 2: Heretic66688 (4935 in chips) 
Seat 3: Axkj (4775 in chips) 
Seat 4: h1per1on (5265 in chips) 
Seat 5: zuzlica (955 in chips) 
Seat 6: Archibal_17 (4510 in chips) 
Seat 7: GDLW26 (5190 in chips) 
Seat 8: maninshed (4995 in chips) 
Seat 9: BenoneRemi (5000 in chips) 
duplo1182: posts the ante 5
Heretic66688: posts the ante 5
Axkj: posts the ante 5
h1per1on: posts the ante 5
zuzlica: posts the ante 5
Archibal_17: posts the ante 5
GDLW26: posts the ante 5
maninshed: posts the ante 5
BenoneRemi: posts the ante 5
Axkj: posts small blind 15
h1per1on: posts big blind 30
*** HOLE CARDS ***
zuzlica: folds 
Archibal_17: folds 
GDLW26: folds 
maninshed: raises 45 to 75
BenoneRemi: calls 75
duplo1182: folds 
Heretic66688: raises 225 to 300
Axkj: folds 
h1per1on: folds 
maninshed: calls 225
BenoneRemi: calls 225
*** FLOP *** [7c Jh 6s]
maninshed: checks 
BenoneRemi: checks 
Heretic66688: checks 
*** TURN *** [7c Jh 6s] [4c]
maninshed: checks 
BenoneRemi: checks 
Heretic66688: checks 
*** RIVER *** [7c Jh 6s 4c] [Td]
maninshed: checks 
BenoneRemi: bets 630
Heretic66688: folds 
maninshed: folds 
Uncalled bet (630) returned to BenoneRemi
BenoneRemi collected 990 from pot
*** SUMMARY ***
Total pot 990 | Rake 0 
Board [7c Jh 6s 4c Td]
Seat 1: duplo1182 folded before Flop (didn't bet)
Seat 2: Heretic66688 (button) folded on the River
Seat 3: Axkj (small blind) folded before Flop
Seat 4: h1per1on (big blind) folded before Flop
Seat 5: zuzlica folded before Flop (didn't bet)
Seat 6: Archibal_17 folded before Flop (didn't bet)
Seat 7: GDLW26 folded before Flop (didn't bet)
Seat 8: maninshed folded on the River
Seat 9: BenoneRemi collected (990)



PokerStars Hand #157575305211: Tournament #1641817620, $7.50+$7.50+$1.50 USD Hold'em No Limit - Level I (15/30) - 2016/08/21 18:36:27 ET
Table '1641817620 8' 9-max Seat #8 is the button
Seat 1: inkjoh (5350 in chips) 
Seat 2: MarcosCLMO (4552 in chips) 
Seat 3: HundTore (5775 in chips) 
Seat 4: Kamikase1805 (5010 in chips) 
Seat 5: younesch (4588 in chips) 
Seat 6: spinne1109 (4005 in chips) 
Seat 7: pavaopics (5880 in chips) 
Seat 8: FastEdiddy (4920 in chips) 
Seat 9: Pokerofwind (4935 in chips) 
inkjoh: posts the ante 5
MarcosCLMO: posts the ante 5
HundTore: posts the ante 5
Kamikase1805: posts the ante 5
younesch: posts the ante 5
spinne1109: posts the ante 5
pavaopics: posts the ante 5
FastEdiddy: posts the ante 5
Pokerofwind: posts the ante 5
Pokerofwind: posts small blind 15
inkjoh: posts big blind 30
*** HOLE CARDS ***
MarcosCLMO: raises 30 to 60
HundTore: calls 60
Kamikase1805: folds 
younesch: folds 
spinne1109: folds 
pavaopics: raises 30 to 90
FastEdiddy: calls 90
Pokerofwind: folds 
inkjoh: calls 60
MarcosCLMO: raises 120 to 210
HundTore: calls 150
pavaopics: calls 120
FastEdiddy: calls 120
inkjoh: calls 120
*** FLOP *** [Jc Ts Qc]
inkjoh: checks 
MarcosCLMO: bets 555
HundTore: calls 555
pavaopics: folds 
FastEdiddy: folds 
inkjoh: calls 555
*** TURN *** [Jc Ts Qc] [6d]
inkjoh: checks 
MarcosCLMO: bets 1387
HundTore: calls 1387
inkjoh: folds 
*** RIVER *** [Jc Ts Qc 6d] [8c]
MarcosCLMO: bets 2395 and is all-in
HundTore: folds 
Uncalled bet (2395) returned to MarcosCLMO
MarcosCLMO collected 5549 from pot
*** SUMMARY ***
Total pot 5549 | Rake 0 
Board [Jc Ts Qc 6d 8c]
Seat 1: inkjoh (big blind) folded on the Turn
Seat 2: MarcosCLMO collected (5549)
Seat 3: HundTore folded on the River
Seat 4: Kamikase1805 folded before Flop (didn't bet)
Seat 5: younesch folded before Flop (didn't bet)
Seat 6: spinne1109 folded before Flop (didn't bet)
Seat 7: pavaopics folded on the Flop
Seat 8: FastEdiddy (button) folded on the Flop
Seat 9: Pokerofwind (small blind) folded before Flop



PokerStars Hand #157575305230: Tournament #1641817620, $7.50+$7.50+$1.50 USD Hold'em No Limit - Level I (15/30) - 2016/08/21 18:36:27 ET
Table '1641817620 24' 9-max Seat #9 is the button
Seat 1: heyyy presto (5520 in chips) 
Seat 2: BOW300 (2435 in chips) 
Seat 3: muskto (7785 in chips) 
Seat 4: jt3x87 (4845 in chips) 
Seat 5: PhaniaX (4699 in chips) 
Seat 6: pisti801 (5321 in chips) 
Seat 7: Pokemongo007 (4995 in chips) 
Seat 8: trabey (4780 in chips) 
Seat 9: Quickcard (4475 in chips) 
heyyy presto: posts the ante 5
BOW300: posts the ante 5
muskto: posts the ante 5
jt3x87: posts the ante 5
PhaniaX: posts the ante 5
pisti801: posts the ante 5
Pokemongo007: posts the ante 5
trabey: posts the ante 5
Quickcard: posts the ante 5
heyyy presto: posts small blind 15
BOW300: posts big blind 30
*** HOLE CARDS ***
muskto: folds 
jt3x87: raises 60 to 90
PhaniaX: folds 
pisti801: folds 
Pokemongo007: calls 90
trabey: folds 
Quickcard: folds 
heyyy presto: folds 
BOW300: raises 540 to 630
jt3x87: raises 1095 to 1725
Pokemongo007: raises 3265 to 4990 and is all-in
BOW300: calls 1800 and is all-in
jt3x87: calls 3115 and is all-in
Uncalled bet (150) returned to Pokemongo007
*** FLOP *** [8c 7c 5d]
*** TURN *** [8c 7c 5d] [9s]
*** RIVER *** [8c 7c 5d 9s] [5h]
*** SHOW DOWN ***
jt3x87: shows [Qs As] (a pair of Fives)
Pokemongo007: shows [Kh Jh] (a pair of Fives - lower kicker)
jt3x87 collected 4820 from side pot
BOW300: shows [Ac Ad] (two pair, Aces and Fives)
BOW300 collected 7350 from main pot
*** SUMMARY ***
Total pot 12170 Main pot 7350. Side pot 4820. | Rake 0 
Board [8c 7c 5d 9s 5h]
Seat 1: heyyy presto (small blind) folded before Flop
Seat 2: BOW300 (big blind) showed [Ac Ad] and won (7350) with two pair, Aces and Fives
Seat 3: muskto folded before Flop (didn't bet)
Seat 4: jt3x87 showed [Qs As] and won (4820) with a pair of Fives
Seat 5: PhaniaX folded before Flop (didn't bet)
Seat 6: pisti801 folded before Flop (didn't bet)
Seat 7: Pokemongo007 showed [Kh Jh] and lost with a pair of Fives
Seat 8: trabey folded before Flop (didn't bet)
Seat 9: Quickcard (button) folded before Flop (didn't bet)



PokerStars Hand #157575305957: Tournament #1641817620, $7.50+$7.50+$1.50 USD Hold'em No Limit - Level I (15/30) - 2016/08/21 18:36:28 ET
Table '1641817620 34' 9-max Seat #8 is the button
Seat 1: MartinArg010 (5085 in chips) 
Seat 2: AngelBerley (4605 in chips) 
Seat 3: Zigslick (4920 in chips) 
Seat 4: Snabers (4740 in chips) 
Seat 5: juggaletto (5460 in chips) 
Seat 6: virtus213 (4725 in chips) 
Seat 7: Poher42 (5205 in chips) 
Seat 8: S.FILTH (4920 in chips) 
Seat 9: omar miete (5365 in chips) 
MartinArg010: posts the ante 5
AngelBerley: posts the ante 5
Zigslick: posts the ante 5
Snabers: posts the ante 5
juggaletto: posts the ante 5
virtus213: posts the ante 5
Poher42: posts the ante 5
S.FILTH: posts the ante 5
omar miete: posts the ante 5
omar miete: posts small blind 15
MartinArg010: posts big blind 30
*** HOLE CARDS ***
AngelBerley: raises 30 to 60
Zigslick: folds 
Snabers: folds 
juggaletto: raises 210 to 270
virtus213: calls 270
Poher42: folds 
S.FILTH: folds 
omar miete: folds 
MartinArg010: folds 
AngelBerley: calls 210
*** FLOP *** [9d 2c 2d]
AngelBerley: checks 
juggaletto: bets 450
virtus213: folds 
AngelBerley: folds 
Uncalled bet (450) returned to juggaletto
juggaletto collected 900 from pot
juggaletto: doesn't show hand 
*** SUMMARY ***
Total pot 900 | Rake 0 
Board [9d 2c 2d]
Seat 1: MartinArg010 (big blind) folded before Flop
Seat 2: AngelBerley folded on the Flop
Seat 3: Zigslick folded before Flop (didn't bet)
Seat 4: Snabers folded before Flop (didn't bet)
Seat 5: juggaletto collected (900)
Seat 6: virtus213 folded on the Flop
Seat 7: Poher42 folded before Flop (didn't bet)
Seat 8: S.FILTH (button) folded before Flop (didn't bet)
Seat 9: omar miete (small blind) folded before Flop



PokerStars Hand #157575307206: Tournament #1641817620, $7.50+$7.50+$1.50 USD Hold'em No Limit - Level I (15/30) - 2016/08/21 18:36:30 ET
Table '1641817620 51' 9-max Seat #7 is the button
Seat 1: yys000 (5195 in chips) 
Seat 2: paulotury (5525 in chips) 
Seat 3: kozloeric (4798 in chips) 
Seat 4: bastef79 (4836 in chips) 
Seat 5: cusirc (4865 in chips) 
Seat 6: demonas05 (5209 in chips) 
Seat 7: boostyz (4993 in chips) 
Seat 8: Garfild740 (5052 in chips) 
Seat 9: Kalvar1 (4527 in chips) 
yys000: posts the ante 5
paulotury: posts the ante 5
kozloeric: posts the ante 5
bastef79: posts the ante 5
cusirc: posts the ante 5
demonas05: posts the ante 5
boostyz: posts the ante 5
Garfild740: posts the ante 5
Kalvar1: posts the ante 5
Garfild740: posts small blind 15
Kalvar1: posts big blind 30
*** HOLE CARDS ***
yys000: folds 
paulotury: folds 
kozloeric: folds 
bastef79: folds 
cusirc: folds 
demonas05: raises 60 to 90
boostyz: folds 
Garfild740: folds 
Kalvar1: calls 60
*** FLOP *** [3s Qh 4d]
Kalvar1: checks 
demonas05: bets 120
Kalvar1: folds 
Uncalled bet (120) returned to demonas05
demonas05 collected 240 from pot
demonas05: doesn't show hand 
*** SUMMARY ***
Total pot 240 | Rake 0 
Board [3s Qh 4d]
Seat 1: yys000 folded before Flop (didn't bet)
Seat 2: paulotury folded before Flop (didn't bet)
Seat 3: kozloeric folded before Flop (didn't bet)
Seat 4: bastef79 folded before Flop (didn't bet)
Seat 5: cusirc folded before Flop (didn't bet)
Seat 6: demonas05 collected (240)
Seat 7: boostyz (button) folded before Flop (didn't bet)
Seat 8: Garfild740 (small blind) folded before Flop
Seat 9: Kalvar1 (big blind) folded on the Flop



PokerStars Hand #157575307288: Tournament #1641817620, $7.50+$7.50+$1.50 USD Hold'em No Limit - Level I (15/30) - 2016/08/21 18:36:30 ET
Table '1641817620 56' 9-max Seat #7 is the button
Seat 1: PpME_Oe_87 (4975 in chips) 
Seat 2: NrRockeT9 (4805 in chips) 
Seat 3: DontFoldItPL (3865 in chips) 
Seat 4: cla11 (5725 in chips) 
Seat 5: luvlust (4720 in chips) 
Seat 6: vandereecken (5000 in chips) 
Seat 7: rickyrdmy (4930 in chips) 
Seat 8: M.J.466 (5935 in chips) 
Seat 9: Exan13 (5060 in chips) 
PpME_Oe_87: posts the ante 5
NrRockeT9: posts the ante 5
DontFoldItPL: posts the ante 5
cla11: posts the ante 5
luvlust: posts the ante 5
vandereecken: posts the ante 5
rickyrdmy: posts the ante 5
M.J.466: posts the ante 5
Exan13: posts the ante 5
M.J.466: posts small blind 15
Exan13: posts big blind 30
*** HOLE CARDS ***
PpME_Oe_87: raises 36 to 66
NrRockeT9: folds 
DontFoldItPL: folds 
cla11: folds 
luvlust: folds 
vandereecken: folds 
rickyrdmy: calls 66
M.J.466: calls 51
Exan13: folds 
*** FLOP *** [7d 9h 2d]
M.J.466: checks 
PpME_Oe_87: checks 
rickyrdmy: checks 
*** TURN *** [7d 9h 2d] [As]
M.J.466: checks 
PpME_Oe_87: checks 
rickyrdmy: checks 
*** RIVER *** [7d 9h 2d As] [2h]
M.J.466: checks 
PpME_Oe_87: checks 
rickyrdmy: checks 
*** SHOW DOWN ***
M.J.466: shows [6d 5s] (a pair of Deuces)
PpME_Oe_87: shows [8h 8s] (two pair, Eights and Deuces)
rickyrdmy: mucks hand 
PpME_Oe_87 collected 273 from pot
*** SUMMARY ***
Total pot 273 | Rake 0 
Board [7d 9h 2d As 2h]
Seat 1: PpME_Oe_87 showed [8h 8s] and won (273) with two pair, Eights and Deuces
Seat 2: NrRockeT9 folded before Flop (didn't bet)
Seat 3: DontFoldItPL folded before Flop (didn't bet)
Seat 4: cla11 folded before Flop (didn't bet)
Seat 5: luvlust folded before Flop (didn't bet)
Seat 6: vandereecken folded before Flop (didn't bet)
Seat 7: rickyrdmy (button) mucked
Seat 8: M.J.466 (small blind) showed [6d 5s] and lost with a pair of Deuces
Seat 9: Exan13 (big blind) folded before Flop



PokerStars Hand #157575307870: Tournament #1641817620, $7.50+$7.50+$1.50 USD Hold'em No Limit - Level I (15/30) - 2016/08/21 18:36:31 ET
Table '1641817620 53' 9-max Seat #8 is the button
Seat 1: star729 (5030 in chips) 
Seat 2: cebola77 (5930 in chips) 
Seat 3: Pekkosaurus (4925 in chips) 
Seat 4: -UNREGPRE- (4925 in chips) 
Seat 5: carlostrend (8665 in chips) 
Seat 6: The39player (4925 in chips) 
Seat 7: THE JONES_RJ (5000 in chips) 
Seat 8: top@pokker (4925 in chips) 
Seat 9: cruiser5917 (695 in chips) 
star729: posts the ante 5
cebola77: posts the ante 5
Pekkosaurus: posts the ante 5
-UNREGPRE-: posts the ante 5
carlostrend: posts the ante 5
The39player: posts the ante 5
THE JONES_RJ: posts the ante 5
top@pokker: posts the ante 5
cruiser5917: posts the ante 5
cruiser5917: posts small blind 15
star729: posts big blind 30
*** HOLE CARDS ***
cebola77: calls 30
Pekkosaurus: folds 
-UNREGPRE-: folds 
carlostrend: calls 30
The39player: raises 105 to 135
THE JONES_RJ: folds 
top@pokker: folds 
cruiser5917: folds 
star729: calls 105
cebola77: calls 105
carlostrend: calls 105
*** FLOP *** [7h 5c 7s]
star729: checks 
cebola77: checks 
carlostrend: checks 
The39player: bets 285
star729: folds 
cebola77: folds 
carlostrend: folds 
Uncalled bet (285) returned to The39player
The39player collected 600 from pot
The39player: doesn't show hand 
*** SUMMARY ***
Total pot 600 | Rake 0 
Board [7h 5c 7s]
Seat 1: star729 (big blind) folded on the Flop
Seat 2: cebola77 folded on the Flop
Seat 3: Pekkosaurus folded before Flop (didn't bet)
Seat 4: -UNREGPRE- folded before Flop (didn't bet)
Seat 5: carlostrend folded on the Flop
Seat 6: The39player collected (600)
Seat 7: THE JONES_RJ folded before Flop (didn't bet)
Seat 8: top@pokker (button) folded before Flop (didn't bet)
Seat 9: cruiser5917 (small blind) folded before Flop



PokerStars Hand #157575308786: Tournament #1641817620, $7.50+$7.50+$1.50 USD Hold'em No Limit - Level I (15/30) - 2016/08/21 18:36:32 ET
Table '1641817620 57' 9-max Seat #7 is the button
Seat 1: pedroh2010 (10075 in chips) 
Seat 2: PANOYRGIAS73 (6575 in chips) 
Seat 3: ovekas (5105 in chips) 
Seat 4: ALWAYSBRAVES (4925 in chips) 
Seat 5: BaDBeaT_AK85 (4925 in chips) 
Seat 6: kachumban (4850 in chips) 
Seat 7: ZodiakGB (4925 in chips) 
Seat 8: MeortheMrs (3470 in chips) 
Seat 9: andreiuc (5150 in chips) 
pedroh2010: posts the ante 5
PANOYRGIAS73: posts the ante 5
ovekas: posts the ante 5
ALWAYSBRAVES: posts the ante 5
BaDBeaT_AK85: posts the ante 5
kachumban: posts the ante 5
ZodiakGB: posts the ante 5
MeortheMrs: posts the ante 5
andreiuc: posts the ante 5
MeortheMrs: posts small blind 15
andreiuc: posts big blind 30
*** HOLE CARDS ***
pedroh2010: folds 
PANOYRGIAS73: folds 
ovekas: folds 
ALWAYSBRAVES: folds 
BaDBeaT_AK85: folds 
kachumban: folds 
ZodiakGB: raises 90 to 120
MeortheMrs: calls 105
andreiuc: calls 90
*** FLOP *** [Jh Ah 3h]
MeortheMrs: checks 
andreiuc: checks 
ZodiakGB: bets 202
MeortheMrs: folds 
andreiuc: raises 398 to 600
ZodiakGB: folds 
Uncalled bet (398) returned to andreiuc
andreiuc collected 809 from pot
andreiuc: doesn't show hand 
*** SUMMARY ***
Total pot 809 | Rake 0 
Board [Jh Ah 3h]
Seat 1: pedroh2010 folded before Flop (didn't bet)
Seat 2: PANOYRGIAS73 folded before Flop (didn't bet)
Seat 3: ovekas folded before Flop (didn't bet)
Seat 4: ALWAYSBRAVES folded before Flop (didn't bet)
Seat 5: BaDBeaT_AK85 folded before Flop (didn't bet)
Seat 6: kachumban folded before Flop (didn't bet)
Seat 7: ZodiakGB (button) folded on the Flop
Seat 8: MeortheMrs (small blind) folded on the Flop
Seat 9: andreiuc (big blind) collected (809)



PokerStars Hand #157575309950: Tournament #1641817620, $7.50+$7.50+$1.50 USD Hold'em No Limit - Level I (15/30) - 2016/08/21 18:36:34 ET
Table '1641817620 55' 9-max Seat #9 is the button
Seat 1: M Patoine (4745 in chips) 
Seat 3: MaxPips (4860 in chips) 
Seat 4: furia75205 (4920 in chips) 
Seat 5: hoolzky (4830 in chips) 
Seat 6: B.Paulino (4920 in chips) 
Seat 7: xLewie (5620 in chips) 
Seat 8: parmalat4o (5000 in chips) 
Seat 9: igara tigara (5010 in chips) 
M Patoine: posts the ante 5
MaxPips: posts the ante 5
furia75205: posts the ante 5
hoolzky: posts the ante 5
B.Paulino: posts the ante 5
xLewie: posts the ante 5
parmalat4o: posts the ante 5
igara tigara: posts the ante 5
M Patoine: posts small blind 15
MaxPips: posts big blind 30
*** HOLE CARDS ***
furia75205: folds 
hoolzky: folds 
B.Paulino: folds 
xLewie: folds 
parmalat4o: raises 60 to 90
igara tigara: folds 
M Patoine: calls 75
MaxPips: folds 
*** FLOP *** [Kh Jc 4s]
M Patoine: folds 
parmalat4o collected 250 from pot
parmalat4o: doesn't show hand 
*** SUMMARY ***
Total pot 250 | Rake 0 
Board [Kh Jc 4s]
Seat 1: M Patoine (small blind) folded on the Flop
Seat 3: MaxPips (big blind) folded before Flop
Seat 4: furia75205 folded before Flop (didn't bet)
Seat 5: hoolzky folded before Flop (didn't bet)
Seat 6: B.Paulino folded before Flop (didn't bet)
Seat 7: xLewie folded before Flop (didn't bet)
Seat 8: parmalat4o collected (250)
Seat 9: igara tigara (button) folded before Flop (didn't bet)



PokerStars Hand #157575310032: Tournament #1641817620, $7.50+$7.50+$1.50 USD Hold'em No Limit - Level I (15/30) - 2016/08/21 18:36:34 ET
Table '1641817620 12' 9-max Seat #6 is the button
Seat 1: Vlacerda (5114 in chips) 
Seat 2: aiaolinda (4360 in chips) 
Seat 3: faza29 (4881 in chips) 
Seat 4: Gottlieb007 (3457 in chips) 
Seat 5: ALEX-RSN (4915 in chips) 
Seat 6: MANJUS89 (3262 in chips) 
Seat 7: FUR4C40 (4965 in chips) 
Seat 9: FrankLDrex (5740 in chips) 
Vlacerda: posts the ante 5
aiaolinda: posts the ante 5
faza29: posts the ante 5
Gottlieb007: posts the ante 5
ALEX-RSN: posts the ante 5
MANJUS89: posts the ante 5
FUR4C40: posts the ante 5
FrankLDrex: posts the ante 5
FUR4C40: posts small blind 15
FrankLDrex: posts big blind 30
*** HOLE CARDS ***
aiaolinda is disconnected 
Vlacerda: folds 
aiaolinda: raises 60 to 90
faza29: folds 
Gottlieb007: raises 120 to 210
ALEX-RSN: folds 
MANJUS89: folds 
FUR4C40: folds 
FrankLDrex: folds 
aiaolinda: calls 120
*** FLOP *** [9c Qs Jc]
aiaolinda: checks 
Gottlieb007: bets 378
aiaolinda: calls 378
*** TURN *** [9c Qs Jc] [Qh]
aiaolinda: checks 
Gottlieb007: checks 
*** RIVER *** [9c Qs Jc Qh] [7h]
aiaolinda: checks 
Gottlieb007: bets 570
aiaolinda: calls 570
*** SHOW DOWN ***
Gottlieb007: shows [Kd Js] (two pair, Queens and Jacks)
aiaolinda: mucks hand 
Gottlieb007 collected 2401 from pot
*** SUMMARY ***
Total pot 2401 | Rake 0 
Board [9c Qs Jc Qh 7h]
Seat 1: Vlacerda folded before Flop (didn't bet)
Seat 2: aiaolinda mucked
Seat 3: faza29 folded before Flop (didn't bet)
Seat 4: Gottlieb007 showed [Kd Js] and won (2401) with two pair, Queens and Jacks
Seat 5: ALEX-RSN folded before Flop (didn't bet)
Seat 6: MANJUS89 (button) folded before Flop (didn't bet)
Seat 7: FUR4C40 (small blind) folded before Flop
Seat 9: FrankLDrex (big blind) folded before Flop



PokerStars Hand #157575310620: Tournament #1641817620, $7.50+$7.50+$1.50 USD Hold'em No Limit - Level I (15/30) - 2016/08/21 18:36:35 ET
Table '1641817620 18' 9-max Seat #6 is the button
Seat 1: Declan387 (4277 in chips) 
Seat 2: silvina35 (5152 in chips) 
Seat 3: TBP23 (4112 in chips) 
Seat 4: One_Cigar (4930 in chips) 
Seat 5: 111santos (4780 in chips) 
Seat 6: Krauser2589 (5720 in chips) 
Seat 7: shaxmatiist (4945 in chips) 
Seat 9: kokandija (6352 in chips) is sitting out
Declan387: posts the ante 5
silvina35: posts the ante 5
TBP23: posts the ante 5
One_Cigar: posts the ante 5
111santos: posts the ante 5
Krauser2589: posts the ante 5
shaxmatiist: posts the ante 5
kokandija: posts the ante 5
shaxmatiist: posts small blind 15
kokandija: posts big blind 30
*** HOLE CARDS ***
Declan387: folds 
silvina35: raises 60 to 90
TBP23: folds 
One_Cigar: calls 90
111santos: folds 
Krauser2589: calls 90
shaxmatiist: folds 
kokandija: folds 
*** FLOP *** [Ad 5d 2s]
kokandija has returned
silvina35 is disconnected 
silvina35 is connected 
silvina35: bets 177
One_Cigar: folds 
Krauser2589: calls 177
*** TURN *** [Ad 5d 2s] [9h]
silvina35: bets 354
Krauser2589: folds 
Uncalled bet (354) returned to silvina35
silvina35 collected 709 from pot
silvina35: doesn't show hand 
*** SUMMARY ***
Total pot 709 | Rake 0 
Board [Ad 5d 2s 9h]
Seat 1: Declan387 folded before Flop (didn't bet)
Seat 2: silvina35 collected (709)
Seat 3: TBP23 folded before Flop (didn't bet)
Seat 4: One_Cigar folded on the Flop
Seat 5: 111santos folded before Flop (didn't bet)
Seat 6: Krauser2589 (button) folded on the Turn
Seat 7: shaxmatiist (small blind) folded before Flop
Seat 9: kokandija (big blind) folded before Flop



PokerStars Hand #157575311062: Tournament #1641817620, $7.50+$7.50+$1.50 USD Hold'em No Limit - Level I (15/30) - 2016/08/21 18:36:36 ET
Table '1641817620 20' 9-max Seat #4 is the button
Seat 1: Showdown pl (5757 in chips) 
Seat 2: tomus_ero (6826 in chips) 
Seat 3: Tiffany8888 (4775 in chips) 
Seat 4: brainpleaser (3586 in chips) 
Seat 5: msantos0123 (4955 in chips) 
Seat 7: anniczka (6269 in chips) is sitting out
Seat 8: profChaos780 (4463 in chips) 
Seat 9: chezzetcook2 (3714 in chips) 
Showdown pl: posts the ante 5
tomus_ero: posts the ante 5
Tiffany8888: posts the ante 5
brainpleaser: posts the ante 5
msantos0123: posts the ante 5
anniczka: posts the ante 5
profChaos780: posts the ante 5
chezzetcook2: posts the ante 5
msantos0123: posts small blind 15
anniczka: posts big blind 30
*** HOLE CARDS ***
profChaos780: folds 
chezzetcook2: folds 
Showdown pl: raises 37 to 67
tomus_ero: folds 
Tiffany8888: calls 67
brainpleaser: raises 503 to 570
msantos0123: folds 
anniczka: folds 
Showdown pl: folds 
Tiffany8888: folds 
Uncalled bet (503) returned to brainpleaser
brainpleaser collected 286 from pot
brainpleaser: doesn't show hand 
*** SUMMARY ***
Total pot 286 | Rake 0 
Seat 1: Showdown pl folded before Flop
Seat 2: tomus_ero folded before Flop (didn't bet)
Seat 3: Tiffany8888 folded before Flop
Seat 4: brainpleaser (button) collected (286)
Seat 5: msantos0123 (small blind) folded before Flop
Seat 7: anniczka (big blind) folded before Flop
Seat 8: profChaos780 folded before Flop (didn't bet)
Seat 9: chezzetcook2 folded before Flop (didn't bet)



PokerStars Hand #157575311535: Tournament #1641817620, $7.50+$7.50+$1.50 USD Hold'em No Limit - Level I (15/30) - 2016/08/21 18:36:37 ET
Table '1641817620 31' 9-max Seat #7 is the button
Seat 1: JmanRz (5000 in chips) 
Seat 2: Esp2011 (4692 in chips) 
Seat 3: karanikolass (5054 in chips) 
Seat 4: Famzinha10 (5524 in chips) 
Seat 5: jucielitheco (4810 in chips) 
Seat 6: Ant_md (5570 in chips) 
Seat 7: fkamus (4435 in chips) 
Seat 8: RENA79 (4945 in chips) 
JmanRz: posts the ante 5
Esp2011: posts the ante 5
karanikolass: posts the ante 5
Famzinha10: posts the ante 5
jucielitheco: posts the ante 5
Ant_md: posts the ante 5
fkamus: posts the ante 5
RENA79: posts the ante 5
RENA79: posts small blind 15
JmanRz: posts big blind 30
*** HOLE CARDS ***
Esp2011: raises 60 to 90
karanikolass: folds 
Famzinha10: calls 90
jucielitheco: folds 
Ant_md: folds 
fkamus: folds 
RENA79: calls 75
JmanRz: calls 60
*** FLOP *** [5h 6s 4c]
RENA79: checks 
JmanRz: bets 188
Esp2011: raises 271 to 459
Famzinha10: raises 4970 to 5429 and is all-in
RENA79: folds 
JmanRz: folds 
Esp2011: folds 
Uncalled bet (4970) returned to Famzinha10
Famzinha10 collected 1506 from pot
Famzinha10: doesn't show hand 
*** SUMMARY ***
Total pot 1506 | Rake 0 
Board [5h 6s 4c]
Seat 1: JmanRz (big blind) folded on the Flop
Seat 2: Esp2011 folded on the Flop
Seat 3: karanikolass folded before Flop (didn't bet)
Seat 4: Famzinha10 collected (1506)
Seat 5: jucielitheco folded before Flop (didn't bet)
Seat 6: Ant_md folded before Flop (didn't bet)
Seat 7: fkamus (button) folded before Flop (didn't bet)
Seat 8: RENA79 (small blind) folded on the Flop



PokerStars Hand #157575311941: Tournament #1641817620, $7.50+$7.50+$1.50 USD Hold'em No Limit - Level I (15/30) - 2016/08/21 18:36:37 ET
Table '1641817620 50' 9-max Seat #9 is the button
Seat 1: Alpentraum (5196 in chips) 
Seat 2: FrEmpireAk (10227 in chips) 
Seat 3: hat_coates (4920 in chips) 
Seat 4: GiCi40 (4980 in chips) 
Seat 6: 100%flop (4995 in chips) 
Seat 7: Shab26 (4785 in chips) 
Seat 8: thinkfeeldo (4883 in chips) 
Seat 9: ziomekek (5114 in chips) 
Alpentraum: posts the ante 5
FrEmpireAk: posts the ante 5
hat_coates: posts the ante 5
GiCi40: posts the ante 5
100%flop: posts the ante 5
Shab26: posts the ante 5
thinkfeeldo: posts the ante 5
ziomekek: posts the ante 5
Alpentraum: posts small blind 15
FrEmpireAk: posts big blind 30
*** HOLE CARDS ***
hat_coates: folds 
GiCi40: folds 
100%flop: folds 
Shab26: raises 36 to 66
thinkfeeldo: folds 
ziomekek: calls 66
Alpentraum: calls 51
FrEmpireAk: calls 36
*** FLOP *** [Kh 6c Js]
Alpentraum: bets 152
FrEmpireAk: calls 152
Shab26: calls 152
ziomekek: folds 
*** TURN *** [Kh 6c Js] [Kc]
Alpentraum: bets 380
FrEmpireAk: calls 380
Shab26: folds 
*** RIVER *** [Kh 6c Js Kc] [8d]
Alpentraum: bets 760
FrEmpireAk: folds [Jd]
Uncalled bet (760) returned to Alpentraum
Alpentraum collected 1520 from pot
Alpentraum: doesn't show hand 
*** SUMMARY ***
Total pot 1520 | Rake 0 
Board [Kh 6c Js Kc 8d]
Seat 1: Alpentraum (small blind) collected (1520)
Seat 2: FrEmpireAk (big blind) folded on the River
Seat 3: hat_coates folded before Flop (didn't bet)
Seat 4: GiCi40 folded before Flop (didn't bet)
Seat 6: 100%flop folded before Flop (didn't bet)
Seat 7: Shab26 folded on the Turn
Seat 8: thinkfeeldo folded before Flop (didn't bet)
Seat 9: ziomekek (button) folded on the Flop



PokerStars Hand #157575312325: Tournament #1641817620, $7.50+$7.50+$1.50 USD Hold'em No Limit - Level I (15/30) - 2016/08/21 18:36:38 ET
Table '1641817620 46' 9-max Seat #8 is the button
Seat 1: Kotakera (4773 in chips) 
Seat 2: estebangocu (4865 in chips) 
Seat 3: butler992 (4865 in chips) 
Seat 4: ZuzanaM (4925 in chips) 
Seat 5: Koeike (4825 in chips) 
Seat 6: JohnJohnnnnn (4755 in chips) 
Seat 7: clavito691 (5916 in chips) 
Seat 8: Violetarose (10096 in chips) 
Seat 9: TheWhite23 (5000 in chips) out of hand (moved from another table into small blind)
Kotakera: posts the ante 5
estebangocu: posts the ante 5
butler992: posts the ante 5
ZuzanaM: posts the ante 5
Koeike: posts the ante 5
JohnJohnnnnn: posts the ante 5
clavito691: posts the ante 5
Violetarose: posts the ante 5
Kotakera: posts small blind 15
estebangocu: posts big blind 30
*** HOLE CARDS ***
butler992: folds 
ZuzanaM: folds 
Koeike: raises 90 to 120
JohnJohnnnnn: folds 
clavito691: folds 
Violetarose: calls 120
Kotakera: folds 
estebangocu: folds 
*** FLOP *** [9c 3c 9d]
Koeike: checks 
Violetarose: checks 
*** TURN *** [9c 3c 9d] [Jd]
Koeike: bets 120
Violetarose: raises 423 to 543
Koeike: calls 423
*** RIVER *** [9c 3c 9d Jd] [Ad]
Koeike: checks 
Violetarose: bets 9428 and is all-in
Koeike: folds 
Uncalled bet (9428) returned to Violetarose
Violetarose collected 1411 from pot
*** SUMMARY ***
Total pot 1411 | Rake 0 
Board [9c 3c 9d Jd Ad]
Seat 1: Kotakera (small blind) folded before Flop
Seat 2: estebangocu (big blind) folded before Flop
Seat 3: butler992 folded before Flop (didn't bet)
Seat 4: ZuzanaM folded before Flop (didn't bet)
Seat 5: Koeike folded on the River
Seat 6: JohnJohnnnnn folded before Flop (didn't bet)
Seat 7: clavito691 folded before Flop (didn't bet)
Seat 8: Violetarose (button) collected (1411)



PokerStars Hand #157575312448: Tournament #1641817620, $7.50+$7.50+$1.50 USD Hold'em No Limit - Level I (15/30) - 2016/08/21 18:36:38 ET
Table '1641817620 45' 9-max Seat #6 is the button
Seat 1: rocky 7 (4135 in chips) 
Seat 2: ldf58 (6685 in chips) 
Seat 3: LifFtD (4810 in chips) 
Seat 4: Grasquet (6057 in chips) 
Seat 5: Mr.Bob-su (2163 in chips) 
Seat 6: CHIT4 (4930 in chips) 
Seat 7: Wasecase (5000 in chips) out of hand (moved from another table into small blind)
Seat 8: mrbandito27 (4855 in chips) 
Seat 9: Andre Ortega (6385 in chips) 
rocky 7: posts the ante 5
ldf58: posts the ante 5
LifFtD: posts the ante 5
Grasquet: posts the ante 5
Mr.Bob-su: posts the ante 5
CHIT4: posts the ante 5
mrbandito27: posts the ante 5
Andre Ortega: posts the ante 5
mrbandito27: posts small blind 15
Andre Ortega: posts big blind 30
*** HOLE CARDS ***
rocky 7: calls 30
ldf58: folds 
LifFtD: folds 
Grasquet: calls 30
Mr.Bob-su: raises 60 to 90
CHIT4: folds 
mrbandito27: folds 
Andre Ortega: calls 60
rocky 7: calls 60
Grasquet: calls 60
*** FLOP *** [Kc 4h Qc]
Andre Ortega: checks 
rocky 7: bets 210
Grasquet: calls 210
Mr.Bob-su: calls 210
Andre Ortega: folds 
*** TURN *** [Kc 4h Qc] [Kh]
rocky 7: checks 
Grasquet: checks 
Mr.Bob-su: checks 
*** RIVER *** [Kc 4h Qc Kh] [8h]
rocky 7: checks 
Grasquet: checks 
Mr.Bob-su: checks 
*** SHOW DOWN ***
rocky 7: shows [Jc 9c] (a pair of Kings)
Grasquet: shows [Ac 4c] (two pair, Kings and Fours)
Mr.Bob-su: shows [9s 9d] (two pair, Kings and Nines)
Mr.Bob-su collected 1045 from pot
*** SUMMARY ***
Total pot 1045 | Rake 0 
Board [Kc 4h Qc Kh 8h]
Seat 1: rocky 7 showed [Jc 9c] and lost with a pair of Kings
Seat 2: ldf58 folded before Flop (didn't bet)
Seat 3: LifFtD folded before Flop (didn't bet)
Seat 4: Grasquet showed [Ac 4c] and lost with two pair, Kings and Fours
Seat 5: Mr.Bob-su showed [9s 9d] and won (1045) with two pair, Kings and Nines
Seat 6: CHIT4 (button) folded before Flop (didn't bet)
Seat 8: mrbandito27 (small blind) folded before Flop
Seat 9: Andre Ortega (big blind) folded on the Flop



PokerStars Hand #157575312896: Tournament #1641817620, $7.50+$7.50+$1.50 USD Hold'em No Limit - Level I (15/30) - 2016/08/21 18:36:39 ET
Table '1641817620 35' 9-max Seat #8 is the button
Seat 1: CPTRip69 (4960 in chips) 
Seat 2: Diegodel79 (5070 in chips) 
Seat 3: brunoeffect (4740 in chips) 
Seat 4: PPOrphan (5065 in chips) 
Seat 5: WizardOffAz (5315 in chips) 
Seat 6: brett88987 (4980 in chips) 
Seat 7: IcaLm (4710 in chips) 
Seat 8: ximenesb (4920 in chips) 
Seat 9: Cosacoman (5170 in chips) 
CPTRip69: posts the ante 5
Diegodel79: posts the ante 5
brunoeffect: posts the ante 5
PPOrphan: posts the ante 5
WizardOffAz: posts the ante 5
brett88987: posts the ante 5
IcaLm: posts the ante 5
ximenesb: posts the ante 5
Cosacoman: posts the ante 5
Cosacoman: posts small blind 15
CPTRip69: posts big blind 30
*** HOLE CARDS ***
Diegodel79: folds 
brunoeffect: folds 
PPOrphan: folds 
WizardOffAz: folds 
brett88987: raises 60 to 90
IcaLm: folds 
ximenesb: raises 60 to 150
Cosacoman: folds 
CPTRip69: folds 
brett88987: folds 
Uncalled bet (60) returned to ximenesb
ximenesb collected 270 from pot
ximenesb: doesn't show hand 
*** SUMMARY ***
Total pot 270 | Rake 0 
Seat 1: CPTRip69 (big blind) folded before Flop
Seat 2: Diegodel79 folded before Flop (didn't bet)
Seat 3: brunoeffect folded before Flop (didn't bet)
Seat 4: PPOrphan folded before Flop (didn't bet)
Seat 5: WizardOffAz folded before Flop (didn't bet)
Seat 6: brett88987 folded before Flop
Seat 7: IcaLm folded before Flop (didn't bet)
Seat 8: ximenesb (button) collected (270)
Seat 9: Cosacoman (small blind) folded before Flop



PokerStars Hand #157575313478: Tournament #1641817620, $7.50+$7.50+$1.50 USD Hold'em No Limit - Level I (15/30) - 2016/08/21 18:36:40 ET
Table '1641817620 42' 9-max Seat #6 is the button
Seat 1: killa187187 (4765 in chips) 
Seat 2: lmiotto88 (5200 in chips) 
Seat 3: Piiirat (4930 in chips) 
Seat 4: skjørring (5560 in chips) 
Seat 5: AcabeiDeSair (4930 in chips) 
Seat 6: phathead109 (4945 in chips) 
Seat 7: ThirtyTw0 (5240 in chips) 
Seat 8: FeFeFeFeFEDE (4885 in chips) 
Seat 9: radekvv777 (9545 in chips) 
killa187187: posts the ante 5
lmiotto88: posts the ante 5
Piiirat: posts the ante 5
skjørring: posts the ante 5
AcabeiDeSair: posts the ante 5
phathead109: posts the ante 5
ThirtyTw0: posts the ante 5
FeFeFeFeFEDE: posts the ante 5
radekvv777: posts the ante 5
ThirtyTw0: posts small blind 15
FeFeFeFeFEDE: posts big blind 30
*** HOLE CARDS ***
radekvv777: calls 30
killa187187: calls 30
lmiotto88: folds 
Piiirat: folds 
skjørring: calls 30
AcabeiDeSair: folds 
phathead109: folds 
ThirtyTw0: calls 15
FeFeFeFeFEDE: checks 
*** FLOP *** [2c Jc 5s]
ThirtyTw0: checks 
FeFeFeFeFEDE: checks 
radekvv777: checks 
killa187187: checks 
skjørring: checks 
*** TURN *** [2c Jc 5s] [6d]
ThirtyTw0: checks 
FeFeFeFeFEDE: bets 105
radekvv777: calls 105
killa187187: calls 105
skjørring: raises 225 to 330
ThirtyTw0: folds 
FeFeFeFeFEDE: calls 225
radekvv777: folds 
killa187187: calls 225
*** RIVER *** [2c Jc 5s 6d] [Jh]
FeFeFeFeFEDE: checks 
killa187187: checks 
skjørring: bets 390
FeFeFeFeFEDE: calls 390
killa187187: folds 
*** SHOW DOWN ***
skjørring: shows [Ah Ac] (two pair, Aces and Jacks)
FeFeFeFeFEDE: mucks hand 
skjørring collected 2070 from pot
*** SUMMARY ***
Total pot 2070 | Rake 0 
Board [2c Jc 5s 6d Jh]
Seat 1: killa187187 folded on the River
Seat 2: lmiotto88 folded before Flop (didn't bet)
Seat 3: Piiirat folded before Flop (didn't bet)
Seat 4: skjørring showed [Ah Ac] and won (2070) with two pair, Aces and Jacks
Seat 5: AcabeiDeSair folded before Flop (didn't bet)
Seat 6: phathead109 (button) folded before Flop (didn't bet)
Seat 7: ThirtyTw0 (small blind) folded on the Turn
Seat 8: FeFeFeFeFEDE (big blind) mucked
Seat 9: radekvv777 folded on the Turn



PokerStars Hand #157575313867: Tournament #1641817620, $7.50+$7.50+$1.50 USD Hold'em No Limit - Level I (15/30) - 2016/08/21 18:36:40 ET
Table '1641817620 3' 9-max Seat #1 is the button
Seat 1: IwantplayNL (5300 in chips) 
Seat 2: dufino (7096 in chips) 
Seat 3: zIggY-7-rAc3 (5215 in chips) 
Seat 4: gerald0jr (4915 in chips) 
Seat 5: Arkadius1975 (4980 in chips) 
Seat 6: BrunoCastroR (2435 in chips) 
Seat 7: alehirazawa (4915 in chips) 
Seat 8: markosharko (5351 in chips) 
Seat 9: VictorZh14 (4803 in chips) 
IwantplayNL: posts the ante 5
dufino: posts the ante 5
zIggY-7-rAc3: posts the ante 5
gerald0jr: posts the ante 5
Arkadius1975: posts the ante 5
BrunoCastroR: posts the ante 5
alehirazawa: posts the ante 5
markosharko: posts the ante 5
VictorZh14: posts the ante 5
dufino: posts small blind 15
zIggY-7-rAc3: posts big blind 30
*** HOLE CARDS ***
gerald0jr: folds 
Arkadius1975: folds 
BrunoCastroR: folds 
alehirazawa: folds 
markosharko: folds 
VictorZh14: folds 
IwantplayNL: folds 
dufino: raises 30 to 60
zIggY-7-rAc3: calls 30
*** FLOP *** [6s 4h Jc]
dufino: checks 
zIggY-7-rAc3: checks 
*** TURN *** [6s 4h Jc] [Kh]
dufino: bets 90
zIggY-7-rAc3: folds 
Uncalled bet (90) returned to dufino
dufino collected 165 from pot
*** SUMMARY ***
Total pot 165 | Rake 0 
Board [6s 4h Jc Kh]
Seat 1: IwantplayNL (button) folded before Flop (didn't bet)
Seat 2: dufino (small blind) collected (165)
Seat 3: zIggY-7-rAc3 (big blind) folded on the Turn
Seat 4: gerald0jr folded before Flop (didn't bet)
Seat 5: Arkadius1975 folded before Flop (didn't bet)
Seat 6: BrunoCastroR folded before Flop (didn't bet)
Seat 7: alehirazawa folded before Flop (didn't bet)
Seat 8: markosharko folded before Flop (didn't bet)
Seat 9: VictorZh14 folded before Flop (didn't bet)



PokerStars Hand #157575314202: Tournament #1641817620, $7.50+$7.50+$1.50 USD Hold'em No Limit - Level I (15/30) - 2016/08/21 18:36:41 ET
Table '1641817620 11' 9-max Seat #9 is the button
Seat 1: GambleGrill (5020 in chips) 
Seat 2: Dionakabarbi (4950 in chips) 
Seat 3: TriviGn'R (5005 in chips) 
Seat 4: EL BBORRACHO (5000 in chips) 
Seat 5: moitzi82 (5075 in chips) 
Seat 6: buzios38 (5520 in chips) 
Seat 7: Galli181 (4995 in chips) 
Seat 8: luisnrd (4860 in chips) 
Seat 9: kylix42 (5005 in chips) 
GambleGrill: posts the ante 5
Dionakabarbi: posts the ante 5
TriviGn'R: posts the ante 5
EL BBORRACHO: posts the ante 5
moitzi82: posts the ante 5
buzios38: posts the ante 5
Galli181: posts the ante 5
luisnrd: posts the ante 5
kylix42: posts the ante 5
GambleGrill: posts small blind 15
Dionakabarbi: posts big blind 30
*** HOLE CARDS ***
TriviGn'R: folds 
EL BBORRACHO: folds 
moitzi82: folds 
buzios38: folds 
Galli181: folds 
luisnrd: raises 60 to 90
kylix42: calls 90
GambleGrill: folds 
Dionakabarbi: folds 
*** FLOP *** [7d 3c Jc]
luisnrd: checks 
kylix42: checks 
*** TURN *** [7d 3c Jc] [5c]
luisnrd: checks 
kylix42: checks 
*** RIVER *** [7d 3c Jc 5c] [2s]
luisnrd: checks 
kylix42: checks 
*** SHOW DOWN ***
luisnrd: shows [As 8c] (high card Ace)
kylix42: mucks hand 
luisnrd collected 270 from pot
*** SUMMARY ***
Total pot 270 | Rake 0 
Board [7d 3c Jc 5c 2s]
Seat 1: GambleGrill (small blind) folded before Flop
Seat 2: Dionakabarbi (big blind) folded before Flop
Seat 3: TriviGn'R folded before Flop (didn't bet)
Seat 4: EL BBORRACHO folded before Flop (didn't bet)
Seat 5: moitzi82 folded before Flop (didn't bet)
Seat 6: buzios38 folded before Flop (didn't bet)
Seat 7: Galli181 folded before Flop (didn't bet)
Seat 8: luisnrd showed [As 8c] and won (270) with high card Ace
Seat 9: kylix42 (button) mucked



PokerStars Hand #157575316444: Tournament #1641817620, $7.50+$7.50+$1.50 USD Hold'em No Limit - Level I (15/30) - 2016/08/21 18:36:44 ET
Table '1641817620 17' 9-max Seat #2 is the button
Seat 1: guitarist68 (4965 in chips) 
Seat 2: Anton163reg (5475 in chips) 
Seat 3: GoldenBeeM (4825 in chips) 
Seat 4: Vsevolod031 (5000 in chips) 
Seat 5: happyminh (9705 in chips) 
Seat 6: dekota222 (4915 in chips) 
Seat 7: rooney69 (5300 in chips) 
Seat 8: Cechinator (395 in chips) 
Seat 9: Samburger514 (5065 in chips) 
guitarist68: posts the ante 5
Anton163reg: posts the ante 5
GoldenBeeM: posts the ante 5
Vsevolod031: posts the ante 5
happyminh: posts the ante 5
dekota222: posts the ante 5
rooney69: posts the ante 5
Cechinator: posts the ante 5
Samburger514: posts the ante 5
GoldenBeeM: posts small blind 15
Vsevolod031: posts big blind 30
*** HOLE CARDS ***
happyminh: folds 
dekota222: folds 
rooney69: raises 37 to 67
Cechinator: raises 323 to 390 and is all-in
Samburger514 has timed out while disconnected
Samburger514: folds 
Samburger514 is sitting out
guitarist68: folds 
Anton163reg: folds 
GoldenBeeM: folds 
Vsevolod031: calls 360
rooney69: calls 323
*** FLOP *** [3d Ad 4s]
Vsevolod031: bets 4605 and is all-in
rooney69: folds 
Uncalled bet (4605) returned to Vsevolod031
*** TURN *** [3d Ad 4s] [4h]
Samburger514 has returned
*** RIVER *** [3d Ad 4s 4h] [Jc]
*** SHOW DOWN ***
Vsevolod031: shows [3s 4d] (a full house, Fours full of Threes)
Cechinator: shows [6c 9c] (a pair of Fours)
Vsevolod031 collected 1230 from pot
Vsevolod031 wins $3.75 for eliminating Cechinator and their own bounty increases by $3.75 to $11.25
Cechinator finished the tournament in 999999979th place
*** SUMMARY ***
Total pot 1230 | Rake 0 
Board [3d Ad 4s 4h Jc]
Seat 1: guitarist68 folded before Flop (didn't bet)
Seat 2: Anton163reg (button) folded before Flop (didn't bet)
Seat 3: GoldenBeeM (small blind) folded before Flop
Seat 4: Vsevolod031 (big blind) showed [3s 4d] and won (1230) with a full house, Fours full of Threes
Seat 5: happyminh folded before Flop (didn't bet)
Seat 6: dekota222 folded before Flop (didn't bet)
Seat 7: rooney69 folded on the Flop
Seat 8: Cechinator showed [6c 9c] and lost with a pair of Fours
Seat 9: Samburger514 folded before Flop (didn't bet)



PokerStars Hand #157575317520: Tournament #1641817620, $7.50+$7.50+$1.50 USD Hold'em No Limit - Level I (15/30) - 2016/08/21 18:36:46 ET
Table '1641817620 29' 9-max Seat #7 is the button
Seat 1: kidpokerjm89 (4970 in chips) 
Seat 2: niejowicz (4955 in chips) is sitting out
Seat 3: Ofbravetight (4835 in chips) 
Seat 4: Ottel (4145 in chips) 
Seat 5: puntoo (5600 in chips) 
Seat 6: Melady77777 (5990 in chips) 
Seat 7: fishfind000 (5015 in chips) 
Seat 8: AcePheres (4880 in chips) 
Seat 9: LAZO30 (4610 in chips) 
kidpokerjm89: posts the ante 5
niejowicz: posts the ante 5
Ofbravetight: posts the ante 5
Ottel: posts the ante 5
puntoo: posts the ante 5
Melady77777: posts the ante 5
fishfind000: posts the ante 5
AcePheres: posts the ante 5
LAZO30: posts the ante 5
AcePheres: posts small blind 15
LAZO30: posts big blind 30
*** HOLE CARDS ***
kidpokerjm89: folds 
niejowicz: folds 
Ofbravetight: folds 
Ottel: calls 30
puntoo: folds 
Melady77777: raises 60 to 90
fishfind000: raises 120 to 210
AcePheres: folds 
LAZO30: folds 
Ottel: calls 180
Melady77777: calls 120
*** FLOP *** [9c 5c Qs]
Ottel: checks 
Melady77777: checks 
fishfind000: bets 120
Ottel: raises 480 to 600
Melady77777: calls 600
fishfind000: raises 4200 to 4800 and is all-in
Ottel: calls 3330 and is all-in
Melady77777: calls 4200
*** TURN *** [9c 5c Qs] [3s]
*** RIVER *** [9c 5c Qs 3s] [2c]
*** SHOW DOWN ***
Melady77777: shows [As Ah] (a pair of Aces)
fishfind000: shows [Qh Qc] (three of a kind, Queens)
fishfind000 collected 1740 from side pot
Ottel: shows [Kh Ks] (a pair of Kings)
fishfind000 collected 12510 from main pot
fishfind000 wins $3.75 for eliminating Ottel and their own bounty increases by $3.75 to $11.25
Ottel finished the tournament in 999999973rd place
*** SUMMARY ***
Total pot 14250 Main pot 12510. Side pot 1740. | Rake 0 
Board [9c 5c Qs 3s 2c]
Seat 1: kidpokerjm89 folded before Flop (didn't bet)
Seat 2: niejowicz folded before Flop (didn't bet)
Seat 3: Ofbravetight folded before Flop (didn't bet)
Seat 4: Ottel showed [Kh Ks] and lost with a pair of Kings
Seat 5: puntoo folded before Flop (didn't bet)
Seat 6: Melady77777 showed [As Ah] and lost with a pair of Aces
Seat 7: fishfind000 (button) showed [Qh Qc] and won (14250) with three of a kind, Queens
Seat 8: AcePheres (small blind) folded before Flop
Seat 9: LAZO30 (big blind) folded before Flop



PokerStars Hand #157575318450: Tournament #1641817620, $7.50+$7.50+$1.50 USD Hold'em No Limit - Level I (15/30) - 2016/08/21 18:36:48 ET
Table '1641817620 30' 9-max Seat #7 is the button
Seat 1: riginvl (4975 in chips) 
Seat 2: flashesflash (4945 in chips) 
Seat 3: Drogbaaaaaaa (4915 in chips) 
Seat 4: staplesking (1540 in chips) 
Seat 5: islidur99 (7815 in chips) 
Seat 6: jeanjrg1 (4930 in chips) 
Seat 7: GazRaz21 (3960 in chips) 
Seat 8: karlson1986 (6980 in chips) 
Seat 9: YNWA UA (4945 in chips) 
riginvl: posts the ante 5
flashesflash: posts the ante 5
Drogbaaaaaaa: posts the ante 5
staplesking: posts the ante 5
islidur99: posts the ante 5
jeanjrg1: posts the ante 5
GazRaz21: posts the ante 5
karlson1986: posts the ante 5
YNWA UA: posts the ante 5
karlson1986: posts small blind 15
YNWA UA: posts big blind 30
*** HOLE CARDS ***
riginvl: folds 
flashesflash: calls 30
Drogbaaaaaaa: folds 
staplesking: folds 
islidur99: raises 180 to 210
jeanjrg1: folds 
GazRaz21: calls 210
karlson1986: folds 
YNWA UA: calls 180
flashesflash: calls 180
*** FLOP *** [Td 8d 8c]
YNWA UA: checks 
flashesflash: checks 
islidur99: bets 900
GazRaz21: folds 
YNWA UA: folds 
flashesflash: folds 
Uncalled bet (900) returned to islidur99
islidur99 collected 900 from pot
islidur99: doesn't show hand 
*** SUMMARY ***
Total pot 900 | Rake 0 
Board [Td 8d 8c]
Seat 1: riginvl folded before Flop (didn't bet)
Seat 2: flashesflash folded on the Flop
Seat 3: Drogbaaaaaaa folded before Flop (didn't bet)
Seat 4: staplesking folded before Flop (didn't bet)
Seat 5: islidur99 collected (900)
Seat 6: jeanjrg1 folded before Flop (didn't bet)
Seat 7: GazRaz21 (button) folded on the Flop
Seat 8: karlson1986 (small blind) folded before Flop
Seat 9: YNWA UA (big blind) folded on the Flop



PokerStars Hand #157575319256: Tournament #1641817620, $7.50+$7.50+$1.50 USD Hold'em No Limit - Level I (15/30) - 2016/08/21 18:36:49 ET
Table '1641817620 23' 9-max Seat #9 is the button
Seat 1: Cepillo (4880 in chips) 
Seat 2: erfan86 (5095 in chips) 
Seat 3: badjo68 (5000 in chips) 
Seat 4: Carlos11497 (4725 in chips) 
Seat 5: MickJagger86 (10060 in chips) 
Seat 6: wolll888 (4995 in chips) 
Seat 7: jradjo21 (4925 in chips) 
Seat 8: andrecosteau (5000 in chips) 
Seat 9: -MCASLAN7- (5130 in chips) 
Cepillo: posts the ante 5
erfan86: posts the ante 5
badjo68: posts the ante 5
Carlos11497: posts the ante 5
MickJagger86: posts the ante 5
wolll888: posts the ante 5
jradjo21: posts the ante 5
andrecosteau: posts the ante 5
-MCASLAN7-: posts the ante 5
Cepillo: posts small blind 15
erfan86: posts big blind 30
*** HOLE CARDS ***
badjo68: folds 
Carlos11497: folds 
MickJagger86: folds 
wolll888: raises 120 to 150
jradjo21: folds 
andrecosteau: folds 
-MCASLAN7-: folds 
Cepillo: folds 
erfan86: folds 
Uncalled bet (120) returned to wolll888
wolll888 collected 120 from pot
wolll888: doesn't show hand 
*** SUMMARY ***
Total pot 120 | Rake 0 
Seat 1: Cepillo (small blind) folded before Flop
Seat 2: erfan86 (big blind) folded before Flop
Seat 3: badjo68 folded before Flop (didn't bet)
Seat 4: Carlos11497 folded before Flop (didn't bet)
Seat 5: MickJagger86 folded before Flop (didn't bet)
Seat 6: wolll888 collected (120)
Seat 7: jradjo21 folded before Flop (didn't bet)
Seat 8: andrecosteau folded before Flop (didn't bet)
Seat 9: -MCASLAN7- (button) folded before Flop (didn't bet)



PokerStars Hand #157575321121: Tournament #1641817620, $7.50+$7.50+$1.50 USD Hold'em No Limit - Level I (15/30) - 2016/08/21 18:36:52 ET
Table '1641817620 5' 9-max Seat #1 is the button
Seat 1: rirage_87 (4780 in chips) 
Seat 2: jonesfi5sh (6285 in chips) 
Seat 3: PhenomPen1 (5100 in chips) 
Seat 4: GrimJoker77 (4960 in chips) 
Seat 5: Bolfra1 (4815 in chips) 
Seat 6: Javicho9 (4530 in chips) 
Seat 7: pokertepec (4990 in chips) 
Seat 8: sloty27 (4860 in chips) 
Seat 9: chuny dealer (4575 in chips) 
rirage_87: posts the ante 5
jonesfi5sh: posts the ante 5
PhenomPen1: posts the ante 5
GrimJoker77: posts the ante 5
Bolfra1: posts the ante 5
Javicho9: posts the ante 5
pokertepec: posts the ante 5
sloty27: posts the ante 5
chuny dealer: posts the ante 5
jonesfi5sh: posts small blind 15
PhenomPen1: posts big blind 30
*** HOLE CARDS ***
GrimJoker77: calls 30
Bolfra1: folds 
Javicho9: folds 
pokertepec: folds 
sloty27: folds 
chuny dealer: folds 
rirage_87: raises 49 to 79
jonesfi5sh: calls 64
PhenomPen1: calls 49
GrimJoker77: calls 49
*** FLOP *** [9h Jd 4d]
jonesfi5sh: checks 
PhenomPen1: checks 
GrimJoker77: bets 180
rirage_87: calls 180
jonesfi5sh: calls 180
PhenomPen1: calls 180
*** TURN *** [9h Jd 4d] [7c]
jonesfi5sh: checks 
PhenomPen1: checks 
GrimJoker77: checks 
rirage_87: checks 
*** RIVER *** [9h Jd 4d 7c] [Qs]
jonesfi5sh: checks 
PhenomPen1: checks 
GrimJoker77: checks 
rirage_87: bets 691
jonesfi5sh: calls 691
PhenomPen1: calls 691
GrimJoker77: folds 
*** SHOW DOWN ***
rirage_87: shows [Td Ad] (high card Ace)
jonesfi5sh: shows [Qd 6d] (a pair of Queens)
PhenomPen1: shows [Qh Js] (two pair, Queens and Jacks)
PhenomPen1 collected 3154 from pot
*** SUMMARY ***
Total pot 3154 | Rake 0 
Board [9h Jd 4d 7c Qs]
Seat 1: rirage_87 (button) showed [Td Ad] and lost with high card Ace
Seat 2: jonesfi5sh (small blind) showed [Qd 6d] and lost with a pair of Queens
Seat 3: PhenomPen1 (big blind) showed [Qh Js] and won (3154) with two pair, Queens and Jacks
Seat 4: GrimJoker77 folded on the River
Seat 5: Bolfra1 folded before Flop (didn't bet)
Seat 6: Javicho9 folded before Flop (didn't bet)
Seat 7: pokertepec folded before Flop (didn't bet)
Seat 8: sloty27 folded before Flop (didn't bet)
Seat 9: chuny dealer folded before Flop (didn't bet)



PokerStars Hand #157575321580: Tournament #1641817620, $7.50+$7.50+$1.50 USD Hold'em No Limit - Level I (15/30) - 2016/08/21 18:36:52 ET
Table '1641817620 28' 9-max Seat #5 is the button
Seat 1: kidprodigy44 (4980 in chips) 
Seat 3: cairob (4935 in chips) 
Seat 4: NIKOLACG (1593 in chips) 
Seat 5: neckbr4ke (4313 in chips) 
Seat 6: Quaysie (9522 in chips) 
Seat 7: d3ment0r (7985 in chips) 
Seat 8: papan9_p$ (6692 in chips) 
Seat 9: benjicleo (4980 in chips) 
kidprodigy44: posts the ante 5
cairob: posts the ante 5
NIKOLACG: posts the ante 5
neckbr4ke: posts the ante 5
Quaysie: posts the ante 5
d3ment0r: posts the ante 5
papan9_p$: posts the ante 5
benjicleo: posts the ante 5
Quaysie: posts small blind 15
d3ment0r: posts big blind 30
*** HOLE CARDS ***
papan9_p$: folds 
benjicleo: raises 60 to 90
kidprodigy44: folds 
cairob: folds 
NIKOLACG: raises 120 to 210
neckbr4ke: folds 
Quaysie: folds 
d3ment0r: folds 
benjicleo: calls 120
*** FLOP *** [7s 2d 7d]
benjicleo: checks 
NIKOLACG: bets 252
benjicleo: folds 
Uncalled bet (252) returned to NIKOLACG
NIKOLACG collected 505 from pot
*** SUMMARY ***
Total pot 505 | Rake 0 
Board [7s 2d 7d]
Seat 1: kidprodigy44 folded before Flop (didn't bet)
Seat 3: cairob folded before Flop (didn't bet)
Seat 4: NIKOLACG collected (505)
Seat 5: neckbr4ke (button) folded before Flop (didn't bet)
Seat 6: Quaysie (small blind) folded before Flop
Seat 7: d3ment0r (big blind) folded before Flop
Seat 8: papan9_p$ folded before Flop (didn't bet)
Seat 9: benjicleo folded on the Flop



PokerStars Hand #157575321730: Tournament #1641817620, $7.50+$7.50+$1.50 USD Hold'em No Limit - Level I (15/30) - 2016/08/21 18:36:53 ET
Table '1641817620 52' 9-max Seat #9 is the button
Seat 1: DoubleBBle (5430 in chips) 
Seat 2: FelipeMarlon (5190 in chips) 
Seat 3: michalis009 (5448 in chips) 
Seat 4: Daviderevan (4245 in chips) 
Seat 5: Armin2188 (4920 in chips) 
Seat 6: HORSEPOKER28 (5085 in chips) 
Seat 7: tatingo82 (4995 in chips) 
Seat 8: vladvladutz (5182 in chips) 
Seat 9: leothefirm (4930 in chips) 
DoubleBBle: posts the ante 5
FelipeMarlon: posts the ante 5
michalis009: posts the ante 5
Daviderevan: posts the ante 5
Armin2188: posts the ante 5
HORSEPOKER28: posts the ante 5
tatingo82: posts the ante 5
vladvladutz: posts the ante 5
leothefirm: posts the ante 5
DoubleBBle: posts small blind 15
FelipeMarlon: posts big blind 30
*** HOLE CARDS ***
michalis009: folds 
Daviderevan: raises 120 to 150
Armin2188: folds 
HORSEPOKER28: folds 
tatingo82: folds 
vladvladutz: folds 
leothefirm: folds 
DoubleBBle: folds 
FelipeMarlon: folds 
Uncalled bet (120) returned to Daviderevan
Daviderevan collected 120 from pot
Daviderevan: doesn't show hand 
*** SUMMARY ***
Total pot 120 | Rake 0 
Seat 1: DoubleBBle (small blind) folded before Flop
Seat 2: FelipeMarlon (big blind) folded before Flop
Seat 3: michalis009 folded before Flop (didn't bet)
Seat 4: Daviderevan collected (120)
Seat 5: Armin2188 folded before Flop (didn't bet)
Seat 6: HORSEPOKER28 folded before Flop (didn't bet)
Seat 7: tatingo82 folded before Flop (didn't bet)
Seat 8: vladvladutz folded before Flop (didn't bet)
Seat 9: leothefirm (button) folded before Flop (didn't bet)



PokerStars Hand #157575322863: Tournament #1641817620, $7.50+$7.50+$1.50 USD Hold'em No Limit - Level I (15/30) - 2016/08/21 18:36:55 ET
Table '1641817620 25' 9-max Seat #1 is the button
Seat 1: MoW3R (4828 in chips) 
Seat 2: pirus157 (5510 in chips) 
Seat 3: MaxBracht (4795 in chips) 
Seat 4: Rex Nelson (4760 in chips) 
Seat 5: ArKip (4915 in chips) 
Seat 6: REALACID (4693 in chips) 
Seat 7: AAnaKKonda (5245 in chips) 
Seat 8: Mad Dionysus (5005 in chips) 
Seat 9: IwillCall3 (5264 in chips) 
MoW3R: posts the ante 5
pirus157: posts the ante 5
MaxBracht: posts the ante 5
Rex Nelson: posts the ante 5
ArKip: posts the ante 5
REALACID: posts the ante 5
AAnaKKonda: posts the ante 5
Mad Dionysus: posts the ante 5
IwillCall3: posts the ante 5
pirus157: posts small blind 15
MaxBracht: posts big blind 30
*** HOLE CARDS ***
Rex Nelson: folds 
ArKip: folds 
REALACID: raises 36 to 66
AAnaKKonda: folds 
Mad Dionysus: folds 
IwillCall3: raises 36 to 102
MoW3R: calls 102
pirus157: calls 87
MaxBracht: folds 
REALACID: calls 36
*** FLOP *** [Kd 5c 8s]
pirus157: checks 
REALACID: checks 
IwillCall3: checks 
MoW3R: checks 
*** TURN *** [Kd 5c 8s] [Qd]
pirus157: checks 
REALACID: checks 
IwillCall3: checks 
MoW3R: checks 
*** RIVER *** [Kd 5c 8s Qd] [9h]
pirus157: checks 
REALACID: checks 
IwillCall3: checks 
MoW3R: checks 
*** SHOW DOWN ***
pirus157: shows [As 3s] (high card Ace)
REALACID: shows [Ah 3h] (high card Ace)
IwillCall3: shows [Ac 8c] (a pair of Eights)
MoW3R: mucks hand 
IwillCall3 collected 483 from pot
*** SUMMARY ***
Total pot 483 | Rake 0 
Board [Kd 5c 8s Qd 9h]
Seat 1: MoW3R (button) mucked
Seat 2: pirus157 (small blind) showed [As 3s] and lost with high card Ace
Seat 3: MaxBracht (big blind) folded before Flop
Seat 4: Rex Nelson folded before Flop (didn't bet)
Seat 5: ArKip folded before Flop (didn't bet)
Seat 6: REALACID showed [Ah 3h] and lost with high card Ace
Seat 7: AAnaKKonda folded before Flop (didn't bet)
Seat 8: Mad Dionysus folded before Flop (didn't bet)
Seat 9: IwillCall3 showed [Ac 8c] and won (483) with a pair of Eights



PokerStars Hand #157575323056: Tournament #1641817620, $7.50+$7.50+$1.50 USD Hold'em No Limit - Level I (15/30) - 2016/08/21 18:36:55 ET
Table '1641817620 48' 9-max Seat #8 is the button
Seat 2: getatore (5205 in chips) 
Seat 3: Serg2407 (4835 in chips) 
Seat 4: Zareta (4865 in chips) 
Seat 5: NSStefan (4925 in chips) 
Seat 6: ATE13 (7440 in chips) 
Seat 7: RipNuts (5000 in chips) 
Seat 8: howtown (2201 in chips) 
Seat 9: qcouest (5768 in chips) 
getatore: posts the ante 5
Serg2407: posts the ante 5
Zareta: posts the ante 5
NSStefan: posts the ante 5
ATE13: posts the ante 5
RipNuts: posts the ante 5
howtown: posts the ante 5
qcouest: posts the ante 5
qcouest: posts small blind 15
getatore: posts big blind 30
*** HOLE CARDS ***
Serg2407: folds 
Zareta: raises 60 to 90
NSStefan: folds 
ATE13: folds 
RipNuts: folds 
howtown: folds 
qcouest: folds 
getatore: calls 60
*** FLOP *** [7s Qc Js]
getatore: checks 
Zareta: bets 135
getatore: folds 
Uncalled bet (135) returned to Zareta
Zareta collected 235 from pot
Zareta: doesn't show hand 
*** SUMMARY ***
Total pot 235 | Rake 0 
Board [7s Qc Js]
Seat 2: getatore (big blind) folded on the Flop
Seat 3: Serg2407 folded before Flop (didn't bet)
Seat 4: Zareta collected (235)
Seat 5: NSStefan folded before Flop (didn't bet)
Seat 6: ATE13 folded before Flop (didn't bet)
Seat 7: RipNuts folded before Flop (didn't bet)
Seat 8: howtown (button) folded before Flop (didn't bet)
Seat 9: qcouest (small blind) folded before Flop



PokerStars Hand #157575323704: Tournament #1641817620, $7.50+$7.50+$1.50 USD Hold'em No Limit - Level I (15/30) - 2016/08/21 18:36:56 ET
Table '1641817620 13' 9-max Seat #8 is the button
Seat 2: nicka501 (10528 in chips) 
Seat 3: POG_Q4 (7193 in chips) 
Seat 4: sutherland43 (4925 in chips) 
Seat 5: LarikkadoAA (5045 in chips) 
Seat 6: MicroStaker5 (4433 in chips) 
Seat 7: MrMalaLeche (4920 in chips) 
Seat 8: EdsonPecly (4929 in chips) 
Seat 9: wantuirpoker (4804 in chips) 
nicka501: posts the ante 5
POG_Q4: posts the ante 5
sutherland43: posts the ante 5
LarikkadoAA: posts the ante 5
MicroStaker5: posts the ante 5
MrMalaLeche: posts the ante 5
EdsonPecly: posts the ante 5
wantuirpoker: posts the ante 5
wantuirpoker: posts small blind 15
nicka501: posts big blind 30
*** HOLE CARDS ***
POG_Q4: folds 
sutherland43: folds 
LarikkadoAA: raises 45 to 75
MicroStaker5: folds 
MrMalaLeche: folds 
EdsonPecly: folds 
wantuirpoker: folds 
nicka501: calls 45
*** FLOP *** [5s Qh 2d]
nicka501: checks 
LarikkadoAA: bets 102
nicka501: folds 
Uncalled bet (102) returned to LarikkadoAA
LarikkadoAA collected 205 from pot
*** SUMMARY ***
Total pot 205 | Rake 0 
Board [5s Qh 2d]
Seat 2: nicka501 (big blind) folded on the Flop
Seat 3: POG_Q4 folded before Flop (didn't bet)
Seat 4: sutherland43 folded before Flop (didn't bet)
Seat 5: LarikkadoAA collected (205)
Seat 6: MicroStaker5 folded before Flop (didn't bet)
Seat 7: MrMalaLeche folded before Flop (didn't bet)
Seat 8: EdsonPecly (button) folded before Flop (didn't bet)
Seat 9: wantuirpoker (small blind) folded before Flop



PokerStars Hand #157575324056: Tournament #1641817620, $7.50+$7.50+$1.50 USD Hold'em No Limit - Level I (15/30) - 2016/08/21 18:36:56 ET
Table '1641817620 58' 9-max Seat #7 is the button
Seat 1: bld66 (4645 in chips) 
Seat 2: FACEBUHH (7195 in chips) 
Seat 3: CFgabriel (4930 in chips) 
Seat 4: nejirose (4930 in chips) 
Seat 5: pokercr7721 (5045 in chips) 
Seat 6: Douglas Leme (5000 in chips) 
Seat 7: I_R0B0T_90 (5015 in chips) 
Seat 8: lovebigpairs (2755 in chips) 
bld66: posts the ante 5
FACEBUHH: posts the ante 5
CFgabriel: posts the ante 5
nejirose: posts the ante 5
pokercr7721: posts the ante 5
Douglas Leme: posts the ante 5
I_R0B0T_90: posts the ante 5
lovebigpairs: posts the ante 5
lovebigpairs: posts small blind 15
bld66: posts big blind 30
*** HOLE CARDS ***
FACEBUHH: calls 30
CFgabriel: calls 30
nejirose: folds 
pokercr7721: calls 30
Douglas Leme: folds 
I_R0B0T_90: folds 
lovebigpairs: folds 
bld66: checks 
*** FLOP *** [Jd Th 7h]
bld66: checks 
FACEBUHH: checks 
CFgabriel: bets 87
pokercr7721: folds 
bld66: folds 
FACEBUHH: folds 
Uncalled bet (87) returned to CFgabriel
CFgabriel collected 175 from pot
CFgabriel: doesn't show hand 
*** SUMMARY ***
Total pot 175 | Rake 0 
Board [Jd Th 7h]
Seat 1: bld66 (big blind) folded on the Flop
Seat 2: FACEBUHH folded on the Flop
Seat 3: CFgabriel collected (175)
Seat 4: nejirose folded before Flop (didn't bet)
Seat 5: pokercr7721 folded on the Flop
Seat 6: Douglas Leme folded before Flop (didn't bet)
Seat 7: I_R0B0T_90 (button) folded before Flop (didn't bet)
Seat 8: lovebigpairs (small blind) folded before Flop



PokerStars Hand #157575325673: Tournament #1641817620, $7.50+$7.50+$1.50 USD Hold'em No Limit - Level I (15/30) - 2016/08/21 18:36:59 ET
Table '1641817620 4' 9-max Seat #7 is the button
Seat 2: Velho Sábio (4467 in chips) 
Seat 3: manukk2 (5485 in chips) 
Seat 4: slk55amg (4092 in chips) 
Seat 5: sica26 (5277 in chips) 
Seat 6: tamarak297 (5000 in chips) 
Seat 7: AleksZy (4867 in chips) 
Seat 8: petersonmach (4897 in chips) 
Seat 9: DagobertQuad (5098 in chips) 
Velho Sábio: posts the ante 5
manukk2: posts the ante 5
slk55amg: posts the ante 5
sica26: posts the ante 5
tamarak297: posts the ante 5
AleksZy: posts the ante 5
petersonmach: posts the ante 5
DagobertQuad: posts the ante 5
petersonmach: posts small blind 15
DagobertQuad: posts big blind 30
*** HOLE CARDS ***
Velho Sábio: folds 
manukk2: folds 
slk55amg: raises 60 to 90
sica26: folds 
tamarak297: calls 90
AleksZy: calls 90
petersonmach: folds 
DagobertQuad: folds 
*** FLOP *** [Qc Ac Ts]
slk55amg: bets 355
tamarak297: calls 355
AleksZy: folds 
*** TURN *** [Qc Ac Ts] [Js]
slk55amg: checks 
tamarak297: bets 532
slk55amg: folds 
Uncalled bet (532) returned to tamarak297
tamarak297 collected 1065 from pot
tamarak297: doesn't show hand 
*** SUMMARY ***
Total pot 1065 | Rake 0 
Board [Qc Ac Ts Js]
Seat 2: Velho Sábio folded before Flop (didn't bet)
Seat 3: manukk2 folded before Flop (didn't bet)
Seat 4: slk55amg folded on the Turn
Seat 5: sica26 folded before Flop (didn't bet)
Seat 6: tamarak297 collected (1065)
Seat 7: AleksZy (button) folded on the Flop
Seat 8: petersonmach (small blind) folded before Flop
Seat 9: DagobertQuad (big blind) folded before Flop



PokerStars Hand #157575325815: Tournament #1641817620, $7.50+$7.50+$1.50 USD Hold'em No Limit - Level I (15/30) - 2016/08/21 18:36:59 ET
Table '1641817620 44' 9-max Seat #2 is the button
Seat 2: moisesgosu (4576 in chips) 
Seat 3: kduwork (5097 in chips) 
Seat 4: starkstud (5090 in chips) 
Seat 5: rbcowboy27 (7082 in chips) 
Seat 6: lesley hu (4910 in chips) is sitting out
Seat 7: ongggg (4883 in chips) 
Seat 8: heynow21 (2982 in chips) 
Seat 9: Pro_Tunis (5660 in chips) 
moisesgosu: posts the ante 5
kduwork: posts the ante 5
starkstud: posts the ante 5
rbcowboy27: posts the ante 5
lesley hu: posts the ante 5
ongggg: posts the ante 5
heynow21: posts the ante 5
Pro_Tunis: posts the ante 5
kduwork: posts small blind 15
starkstud: posts big blind 30
*** HOLE CARDS ***
rbcowboy27: folds 
lesley hu: folds 
ongggg: folds 
heynow21: folds 
Pro_Tunis: folds 
moisesgosu: folds 
kduwork: folds 
Uncalled bet (15) returned to starkstud
starkstud collected 70 from pot
starkstud: doesn't show hand 
*** SUMMARY ***
Total pot 70 | Rake 0 
Seat 2: moisesgosu (button) folded before Flop (didn't bet)
Seat 3: kduwork (small blind) folded before Flop
Seat 4: starkstud (big blind) collected (70)
Seat 5: rbcowboy27 folded before Flop (didn't bet)
Seat 6: lesley hu folded before Flop (didn't bet)
Seat 7: ongggg folded before Flop (didn't bet)
Seat 8: heynow21 folded before Flop (didn't bet)
Seat 9: Pro_Tunis folded before Flop (didn't bet)



PokerStars Hand #157575326239: Tournament #1641817620, $7.50+$7.50+$1.50 USD Hold'em No Limit - Level I (15/30) - 2016/08/21 18:37:00 ET
Table '1641817620 61' 9-max Seat #9 is the button
Seat 1: talga421 (4248 in chips) 
Seat 2: efkinis24 (5000 in chips) 
Seat 3: ElliNelly (11312 in chips) 
Seat 5: sasha.yush (4920 in chips) 
Seat 6: houtenboog (4830 in chips) 
Seat 7: setarcos1234 (4920 in chips) 
Seat 8: mcgcork (5010 in chips) 
Seat 9: LocoSanDiego (5080 in chips) 
talga421: posts the ante 5
efkinis24: posts the ante 5
ElliNelly: posts the ante 5
sasha.yush: posts the ante 5
houtenboog: posts the ante 5
setarcos1234: posts the ante 5
mcgcork: posts the ante 5
LocoSanDiego: posts the ante 5
talga421: posts small blind 15
efkinis24: posts big blind 30
*** HOLE CARDS ***
ElliNelly: folds 
sasha.yush: folds 
houtenboog: raises 115 to 145
setarcos1234: folds 
mcgcork: folds 
LocoSanDiego: folds 
talga421: calls 130
efkinis24: folds 
*** FLOP *** [8c Tc 8s]
talga421: checks 
houtenboog: checks 
*** TURN *** [8c Tc 8s] [6s]
talga421: bets 180
houtenboog: folds 
Uncalled bet (180) returned to talga421
talga421 collected 360 from pot
talga421: doesn't show hand 
*** SUMMARY ***
Total pot 360 | Rake 0 
Board [8c Tc 8s 6s]
Seat 1: talga421 (small blind) collected (360)
Seat 2: efkinis24 (big blind) folded before Flop
Seat 3: ElliNelly folded before Flop (didn't bet)
Seat 5: sasha.yush folded before Flop (didn't bet)
Seat 6: houtenboog folded on the Turn
Seat 7: setarcos1234 folded before Flop (didn't bet)
Seat 8: mcgcork folded before Flop (didn't bet)
Seat 9: LocoSanDiego (button) folded before Flop (didn't bet)



PokerStars Hand #157575327077: Tournament #1641817620, $7.50+$7.50+$1.50 USD Hold'em No Limit - Level I (15/30) - 2016/08/21 18:37:01 ET
Table '1641817620 21' 9-max Seat #8 is the button
Seat 2: ukr_durrrr (4830 in chips) 
Seat 3: ultgamb (4920 in chips) 
Seat 4: fishin1981 (4785 in chips) 
Seat 5: jeroma123 (4875 in chips) 
Seat 6: olleggi (4500 in chips) 
Seat 7: BurrGrylls (4835 in chips) 
Seat 8: pokerist2692 (4751 in chips) 
Seat 9: Ferrazz (5344 in chips) 
ukr_durrrr: posts the ante 5
ultgamb: posts the ante 5
fishin1981: posts the ante 5
jeroma123: posts the ante 5
olleggi: posts the ante 5
BurrGrylls: posts the ante 5
pokerist2692: posts the ante 5
Ferrazz: posts the ante 5
Ferrazz: posts small blind 15
ukr_durrrr: posts big blind 30
*** HOLE CARDS ***
ultgamb: folds 
fishin1981: folds 
jeroma123: folds 
olleggi: folds 
BurrGrylls: folds 
pokerist2692: folds 
Ferrazz: raises 60 to 90
ukr_durrrr: folds 
Uncalled bet (60) returned to Ferrazz
Ferrazz collected 100 from pot
Ferrazz: doesn't show hand 
*** SUMMARY ***
Total pot 100 | Rake 0 
Seat 2: ukr_durrrr (big blind) folded before Flop
Seat 3: ultgamb folded before Flop (didn't bet)
Seat 4: fishin1981 folded before Flop (didn't bet)
Seat 5: jeroma123 folded before Flop (didn't bet)
Seat 6: olleggi folded before Flop (didn't bet)
Seat 7: BurrGrylls folded before Flop (didn't bet)
Seat 8: pokerist2692 (button) folded before Flop (didn't bet)
Seat 9: Ferrazz (small blind) collected (100)



PokerStars Hand #157575327155: Tournament #1641817620, $7.50+$7.50+$1.50 USD Hold'em No Limit - Level I (15/30) - 2016/08/21 18:37:01 ET
Table '1641817620 15' 9-max Seat #9 is the button
Seat 1: WRussia (4640 in chips) 
Seat 2: miche1301 (6010 in chips) 
Seat 3: tsolias87 (5010 in chips) 
Seat 4: daveholden4 (4985 in chips) 
Seat 5: mdf92 (4520 in chips) 
Seat 6: aramio29 (4924 in chips) 
Seat 7: Yokiro (4655 in chips) 
Seat 8: Rob.nl (3104 in chips) 
Seat 9: mfalmeidacs (6932 in chips) 
WRussia: posts the ante 5
miche1301: posts the ante 5
tsolias87: posts the ante 5
daveholden4: posts the ante 5
mdf92: posts the ante 5
aramio29: posts the ante 5
Yokiro: posts the ante 5
Rob.nl: posts the ante 5
mfalmeidacs: posts the ante 5
WRussia: posts small blind 15
miche1301: posts big blind 30
*** HOLE CARDS ***
tsolias87: folds 
daveholden4: raises 60 to 90
mdf92: folds 
aramio29: folds 
Yokiro: folds 
Rob.nl: calls 90
mfalmeidacs: folds 
WRussia: calls 75
miche1301: folds 
*** FLOP *** [Qd 4c Jh]
WRussia: checks 
daveholden4: bets 90
Rob.nl: folds 
WRussia: calls 90
*** TURN *** [Qd 4c Jh] [6h]
WRussia: checks 
daveholden4: checks 
*** RIVER *** [Qd 4c Jh 6h] [2d]
WRussia: bets 240
daveholden4: folds 
Uncalled bet (240) returned to WRussia
WRussia collected 525 from pot
WRussia: doesn't show hand 
*** SUMMARY ***
Total pot 525 | Rake 0 
Board [Qd 4c Jh 6h 2d]
Seat 1: WRussia (small blind) collected (525)
Seat 2: miche1301 (big blind) folded before Flop
Seat 3: tsolias87 folded before Flop (didn't bet)
Seat 4: daveholden4 folded on the River
Seat 5: mdf92 folded before Flop (didn't bet)
Seat 6: aramio29 folded before Flop (didn't bet)
Seat 7: Yokiro folded before Flop (didn't bet)
Seat 8: Rob.nl folded on the Flop
Seat 9: mfalmeidacs (button) folded before Flop (didn't bet)



